State Code,District Code,Area Name,Total/ Rural/ Urban,Adolescent and youth categories,Total Population - Persons,Total Population - Males,Total Population - Females,Scheduled Caste - Persons,Scheduled Tribe - Persons,Scheduled Tribe - Males,Illiiterates - Total - Persons,Illiiterates - Total - Males,Illiiterates - Total - Females,Main Worker - Agricultural labourers - Persons
0,0,INDIA,Total,All Ages,1210854977,623270258,587584719,201378372,104545716,52547215,447216165,188506636,258709529,86168706
0,0,INDIA,Total,10-14,132709212,69418835,63290377,23456295,12729223,6503374,11745768,5389155,6356613,1108998
0,0,INDIA,Total,15-19,120526449,63982396,56544053,20903396,10544207,5388101,13457548,5635187,7822361,6170041
0,0,INDIA,Total,20-24,111424222,57584693,53839529,18828886,9382986,4621520,18679492,6467026,12212466,10521664
0,0,INDIA,Total,Adolescent (10-19),253235661,133401231,119834430,44359691,23273430,11891475,25203316,11024342,14178974,7279039
0,0,INDIA,Total,Youth (15-24),231950671,121567089,110383582,39732282,19927193,10009621,32137040,12102213,20034827,16691705
0,0,INDIA,Rural,All Ages,833748852,427781058,405967794,153850848,94083844,47263733,350955017,146419684,204535333,80960135
0,0,INDIA,Rural,10-14,96804494,50488158,46316336,18464173,11530030,5888480,9297640,4166798,5130842,1062856
0,0,INDIA,Rural,15-19,83902472,44570557,39331915,15824418,9371963,4788803,10677042,4280811,6396231,5873813
0,0,INDIA,Rural,20-24,73835046,38138662,35696384,13803393,8279625,4076029,15077525,4963696,10113829,9982153
0,0,INDIA,Rural,Adolescent (10-19),180706966,95058715,85648251,34288591,20901993,10677283,19974682,8447609,11527073,6936669
0,0,INDIA,Rural,Youth (15-24),157737518,82709219,75028299,29627811,17651588,8864832,25754567,9244507,16510060,15855966
0,0,INDIA,Urban,All Ages,377106125,195489200,181616925,47527524,10461872,5283482,96261148,42086952,54174196,5208571
0,0,INDIA,Urban,10-14,35904718,18930677,16974041,4992122,1199193,614894,2448128,1222357,1225771,46142
0,0,INDIA,Urban,15-19,36623977,19411839,17212138,5078978,1172244,599298,2780506,1354376,1426130,296228
0,0,INDIA,Urban,20-24,37589176,19446031,18143145,5025493,1103361,545491,3601967,1503330,2098637,539511
0,0,INDIA,Urban,Adolescent (10-19),72528695,38342516,34186179,10071100,2371437,1214192,5228634,2576733,2651901,342370
0,0,INDIA,Urban,Youth (15-24),74213153,38857870,35355283,10104471,2275605,1144789,6382473,2857706,3524767,835739
1,0,State - JAMMU & KASHMIR (01),Total,All Ages,12541302,6640662,5900640,924991,1493299,776257,5474069,2375991,3098078,159519
1,0,State - JAMMU & KASHMIR (01),Total,10-14,1413853,744855,668998,101117,198643,104192,170793,71946,98847,1968
1,0,State - JAMMU & KASHMIR (01),Total,15-19,1237462,640362,597100,97563,146774,77298,167302,55411,111891,8144
1,0,State - JAMMU & KASHMIR (01),Total,20-24,1160913,603578,557335,92420,122840,62228,236770,74478,162292,17716
1,0,State - JAMMU & KASHMIR (01),Total,Adolescent (10-19),2651315,1385217,1266098,198680,345417,181490,338095,127357,210738,10112
1,0,State - JAMMU & KASHMIR (01),Total,Youth (15-24),2398375,1243940,1154435,189983,269614,139526,404072,129889,274183,25860
1,0,State - JAMMU & KASHMIR (01),Rural,All Ages,9108060,4774477,4333583,751026,1406833,730075,4360110,1882728,2477382,141304
1,0,State - JAMMU & KASHMIR (01),Rural,10-14,1097236,575511,521725,84272,188653,98780,143105,58549,84556,1841
1,0,State - JAMMU & KASHMIR (01),Rural,15-19,926108,477098,449010,79402,137486,72375,141092,44012,97080,7426
1,0,State - JAMMU & KASHMIR (01),Rural,20-24,827361,423292,404069,73987,114631,57863,197423,59389,138034,16001
1,0,State - JAMMU & KASHMIR (01),Rural,Adolescent (10-19),2023344,1052609,970735,163674,326139,171155,284197,102561,181636,9267
1,0,State - JAMMU & KASHMIR (01),Rural,Youth (15-24),1753469,900390,853079,153389,252117,130238,338515,103401,235114,23427
1,0,State - JAMMU & KASHMIR (01),Urban,All Ages,3433242,1866185,1567057,173965,86466,46182,1113959,493263,620696,18215
1,0,State - JAMMU & KASHMIR (01),Urban,10-14,316617,169344,147273,16845,9990,5412,27688,13397,14291,127
1,0,State - JAMMU & KASHMIR (01),Urban,15-19,311354,163264,148090,18161,9288,4923,26210,11399,14811,718
1,0,State - JAMMU & KASHMIR (01),Urban,20-24,333552,180286,153266,18433,8209,4365,39347,15089,24258,1715
1,0,State - JAMMU & KASHMIR (01),Urban,Adolescent (10-19),627971,332608,295363,35006,19278,10335,53898,24796,29102,845
1,0,State - JAMMU & KASHMIR (01),Urban,Youth (15-24),644906,343550,301356,36594,17497,9288,65557,26488,39069,2433
1,1,District - Kupwara (01),Total,All Ages,870354,474190,396164,1048,70352,36913,430700,191367,239333,9834
1,1,District - Kupwara (01),Total,10-14,118673,62428,56245,4,10059,5226,18800,8155,10645,131
1,1,District - Kupwara (01),Total,15-19,81849,41873,39976,2,6029,3193,12310,3705,8605,434
1,1,District - Kupwara (01),Total,20-24,70692,38505,32187,192,4672,2395,16016,4610,11406,956
1,1,District - Kupwara (01),Total,Adolescent (10-19),200522,104301,96221,6,16088,8419,31110,11860,19250,565
1,1,District - Kupwara (01),Total,Youth (15-24),152541,80378,72163,194,10701,5588,28326,8315,20011,1390
1,1,District - Kupwara (01),Rural,All Ages,765625,412038,353587,872,68491,35855,390627,173253,217374,9135
1,1,District - Kupwara (01),Rural,10-14,103802,54249,49553,4,9778,5068,16947,7292,9655,130
1,1,District - Kupwara (01),Rural,15-19,72665,36874,35791,1,5771,3018,11418,3340,8078,419
1,1,District - Kupwara (01),Rural,20-24,62591,33731,28860,173,4536,2322,14888,4212,10676,903
1,1,District - Kupwara (01),Rural,Adolescent (10-19),176467,91123,85344,5,15549,8086,28365,10632,17733,549
1,1,District - Kupwara (01),Rural,Youth (15-24),135256,70605,64651,174,10307,5340,26306,7552,18754,1322
1,1,District - Kupwara (01),Urban,All Ages,104729,62152,42577,176,1861,1058,40073,18114,21959,699
1,1,District - Kupwara (01),Urban,10-14,14871,8179,6692,0,281,158,1853,863,990,1
1,1,District - Kupwara (01),Urban,15-19,9184,4999,4185,1,258,175,892,365,527,15
1,1,District - Kupwara (01),Urban,20-24,8101,4774,3327,19,136,73,1128,398,730,53
1,1,District - Kupwara (01),Urban,Adolescent (10-19),24055,13178,10877,1,539,333,2745,1228,1517,16
1,1,District - Kupwara (01),Urban,Youth (15-24),17285,9773,7512,20,394,248,2020,763,1257,68
1,2,District - Badgam (02),Total,All Ages,753745,398041,355704,368,23912,12383,418096,190300,227796,11560
1,2,District - Badgam (02),Total,10-14,94819,49723,45096,4,3818,1967,18102,8305,9797,170
1,2,District - Badgam (02),Total,15-19,75536,38254,37282,4,2287,1192,14136,4915,9221,599
1,2,District - Badgam (02),Total,20-24,64695,33951,30744,67,1310,715,18091,5821,12270,1258
1,2,District - Badgam (02),Total,Adolescent (10-19),170355,87977,82378,8,6105,3159,32238,13220,19018,769
1,2,District - Badgam (02),Total,Youth (15-24),140231,72205,68026,71,3597,1907,32227,10736,21491,1857
1,2,District - Badgam (02),Rural,All Ages,655833,343385,312448,86,23293,12025,377568,172744,204824,10635
1,2,District - Badgam (02),Rural,10-14,85186,44698,40488,1,3775,1955,16967,7749,9218,166
1,2,District - Badgam (02),Rural,15-19,66518,33674,32844,3,2244,1176,13369,4612,8757,570
1,2,District - Badgam (02),Rural,20-24,54796,28237,26559,8,1250,669,16777,5411,11366,1193
1,2,District - Badgam (02),Rural,Adolescent (10-19),151704,78372,73332,4,6019,3131,30336,12361,17975,736
1,2,District - Badgam (02),Rural,Youth (15-24),121314,61911,59403,11,3494,1845,30146,10023,20123,1763
1,2,District - Badgam (02),Urban,All Ages,97912,54656,43256,282,619,358,40528,17556,22972,925
1,2,District - Badgam (02),Urban,10-14,9633,5025,4608,3,43,12,1135,556,579,4
1,2,District - Badgam (02),Urban,15-19,9018,4580,4438,1,43,16,767,303,464,29
1,2,District - Badgam (02),Urban,20-24,9899,5714,4185,59,60,46,1314,410,904,65
1,2,District - Badgam (02),Urban,Adolescent (10-19),18651,9605,9046,4,86,28,1902,859,1043,33
1,2,District - Badgam (02),Urban,Youth (15-24),18917,10294,8623,60,103,62,2081,713,1368,94
1,3,District - Leh(Ladakh) (03),Total,All Ages,133487,78971,54516,488,95857,47543,39717,16137,23580,593
1,3,District - Leh(Ladakh) (03),Total,10-14,10053,5188,4865,10,8840,4522,454,239,215,4
1,3,District - Leh(Ladakh) (03),Total,15-19,10245,5179,5066,12,8975,4471,395,156,239,22
1,3,District - Leh(Ladakh) (03),Total,20-24,14428,9031,5397,100,8864,4188,957,338,619,41
1,3,District - Leh(Ladakh) (03),Total,Adolescent (10-19),20298,10367,9931,22,17815,8993,849,395,454,26
1,3,District - Leh(Ladakh) (03),Total,Youth (15-24),24673,14210,10463,112,17839,8659,1352,494,858,63
1,3,District - Leh(Ladakh) (03),Rural,All Ages,87816,48411,39405,108,73789,36318,31027,12349,18678,462
1,3,District - Leh(Ladakh) (03),Rural,10-14,7212,3706,3506,4,6749,3437,355,182,173,4
1,3,District - Leh(Ladakh) (03),Rural,15-19,7388,3664,3724,6,6934,3413,322,115,207,20
1,3,District - Leh(Ladakh) (03),Rural,20-24,8822,4918,3904,12,6923,3242,751,235,516,34
1,3,District - Leh(Ladakh) (03),Rural,Adolescent (10-19),14600,7370,7230,10,13683,6850,677,297,380,24
1,3,District - Leh(Ladakh) (03),Rural,Youth (15-24),16210,8582,7628,18,13857,6655,1073,350,723,54
1,3,District - Leh(Ladakh) (03),Urban,All Ages,45671,30560,15111,380,22068,11225,8690,3788,4902,131
1,3,District - Leh(Ladakh) (03),Urban,10-14,2841,1482,1359,6,2091,1085,99,57,42,0
1,3,District - Leh(Ladakh) (03),Urban,15-19,2857,1515,1342,6,2041,1058,73,41,32,2
1,3,District - Leh(Ladakh) (03),Urban,20-24,5606,4113,1493,88,1941,946,206,103,103,7
1,3,District - Leh(Ladakh) (03),Urban,Adolescent (10-19),5698,2997,2701,12,4132,2143,172,98,74,2
1,3,District - Leh(Ladakh) (03),Urban,Youth (15-24),8463,5628,2835,94,3982,2004,279,144,135,9
1,4,District - Kargil (04),Total,All Ages,140802,77785,63017,18,122336,62652,54566,21484,33082,524
1,4,District - Kargil (04),Total,10-14,14554,7630,6924,1,13893,7274,921,397,524,9
1,4,District - Kargil (04),Total,15-19,13918,6975,6943,0,13264,6644,1046,219,827,13
1,4,District - Kargil (04),Total,20-24,15109,8212,6897,1,12699,6141,2023,417,1606,42
1,4,District - Kargil (04),Total,Adolescent (10-19),28472,14605,13867,1,27157,13918,1967,616,1351,22
1,4,District - Kargil (04),Total,Youth (15-24),29027,15187,13840,1,25963,12785,3069,636,2433,55
1,4,District - Kargil (04),Rural,All Ages,124464,67703,56761,10,110840,56693,50568,20029,30539,504
1,4,District - Kargil (04),Rural,10-14,13309,6928,6381,1,12762,6635,881,377,504,9
1,4,District - Kargil (04),Rural,15-19,12489,6264,6225,0,11958,5993,996,206,790,13
1,4,District - Kargil (04),Rural,20-24,13256,7044,6212,1,11471,5547,1942,392,1550,42
1,4,District - Kargil (04),Rural,Adolescent (10-19),25798,13192,12606,1,24720,12628,1877,583,1294,22
1,4,District - Kargil (04),Rural,Youth (15-24),25745,13308,12437,1,23429,11540,2938,598,2340,55
1,4,District - Kargil (04),Urban,All Ages,16338,10082,6256,8,11496,5959,3998,1455,2543,20
1,4,District - Kargil (04),Urban,10-14,1245,702,543,0,1131,639,40,20,20,0
1,4,District - Kargil (04),Urban,15-19,1429,711,718,0,1306,651,50,13,37,0
1,4,District - Kargil (04),Urban,20-24,1853,1168,685,0,1228,594,81,25,56,0
1,4,District - Kargil (04),Urban,Adolescent (10-19),2674,1413,1261,0,2437,1290,90,33,57,0
1,4,District - Kargil (04),Urban,Youth (15-24),3282,1879,1403,0,2534,1245,131,38,93,0
1,5,District - Punch (05),Total,All Ages,476835,251899,224936,556,176101,90274,215111,88566,126545,5917
1,5,District - Punch (05),Total,10-14,59990,31410,28580,24,24578,13002,5707,2029,3678,48
1,5,District - Punch (05),Total,15-19,46812,24654,22158,32,17402,9352,6614,1582,5032,258
1,5,District - Punch (05),Total,20-24,40067,20913,19154,55,13988,6816,9751,2313,7438,665
1,5,District - Punch (05),Total,Adolescent (10-19),106802,56064,50738,56,41980,22354,12321,3611,8710,306
1,5,District - Punch (05),Total,Youth (15-24),86879,45567,41312,87,31390,16168,16365,3895,12470,923
1,5,District - Punch (05),Rural,All Ages,438205,229774,208431,278,171011,87542,206664,85058,121606,5596
1,5,District - Punch (05),Rural,10-14,55907,29133,26774,7,23673,12472,5637,2001,3636,46
1,5,District - Punch (05),Rural,15-19,43330,22841,20489,10,16865,9064,6528,1561,4967,244
1,5,District - Punch (05),Rural,20-24,36483,18698,17785,21,13603,6611,9577,2264,7313,630
1,5,District - Punch (05),Rural,Adolescent (10-19),99237,51974,47263,17,40538,21536,12165,3562,8603,290
1,5,District - Punch (05),Rural,Youth (15-24),79813,41539,38274,31,30468,15675,16105,3825,12280,874
1,5,District - Punch (05),Urban,All Ages,38630,22125,16505,278,5090,2732,8447,3508,4939,321
1,5,District - Punch (05),Urban,10-14,4083,2277,1806,17,905,530,70,28,42,2
1,5,District - Punch (05),Urban,15-19,3482,1813,1669,22,537,288,86,21,65,14
1,5,District - Punch (05),Urban,20-24,3584,2215,1369,34,385,205,174,49,125,35
1,5,District - Punch (05),Urban,Adolescent (10-19),7565,4090,3475,39,1442,818,156,49,107,16
1,5,District - Punch (05),Urban,Youth (15-24),7066,4028,3038,56,922,493,260,70,190,49
1,6,District - Rajouri (06),Total,All Ages,642415,345351,297064,48157,232815,121374,278306,120882,157424,6148
1,6,District - Rajouri (06),Total,10-14,75860,39974,35886,5527,31547,16373,8744,3373,5371,149
1,6,District - Rajouri (06),Total,15-19,62417,33566,28851,4936,23354,12677,9154,2888,6266,383
1,6,District - Rajouri (06),Total,20-24,57680,30997,26683,4568,19168,9893,12908,4021,8887,837
1,6,District - Rajouri (06),Total,Adolescent (10-19),138277,73540,64737,10463,54901,29050,17898,6261,11637,532
1,6,District - Rajouri (06),Total,Youth (15-24),120097,64563,55534,9504,42522,22570,22062,6909,15153,1220
1,6,District - Rajouri (06),Rural,All Ages,590101,310748,279353,46141,229692,119658,268891,116635,152256,5941
1,6,District - Rajouri (06),Rural,10-14,72095,37918,34177,5371,31130,16163,8565,3295,5270,149
1,6,District - Rajouri (06),Rural,15-19,58635,31487,27148,4757,22975,12463,8985,2818,6167,371
1,6,District - Rajouri (06),Rural,20-24,51898,26884,25014,4336,18892,9733,12647,3923,8724,821
1,6,District - Rajouri (06),Rural,Adolescent (10-19),130730,69405,61325,10128,54105,28626,17550,6113,11437,520
1,6,District - Rajouri (06),Rural,Youth (15-24),110533,58371,52162,9093,41867,22196,21632,6741,14891,1192
1,6,District - Rajouri (06),Urban,All Ages,52314,34603,17711,2016,3123,1716,9415,4247,5168,207
1,6,District - Rajouri (06),Urban,10-14,3765,2056,1709,156,417,210,179,78,101,0
1,6,District - Rajouri (06),Urban,15-19,3782,2079,1703,179,379,214,169,70,99,12
1,6,District - Rajouri (06),Urban,20-24,5782,4113,1669,232,276,160,261,98,163,16
1,6,District - Rajouri (06),Urban,Adolescent (10-19),7547,4135,3412,335,796,424,348,148,200,12
1,6,District - Rajouri (06),Urban,Youth (15-24),9564,6192,3372,411,655,374,430,168,262,28
1,7,District - Kathua (07),Total,All Ages,616435,326109,290326,141224,53307,27693,227231,97610,129621,10152
1,7,District - Kathua (07),Total,10-14,66061,35924,30137,16010,7161,3721,4992,1867,3125,78
1,7,District - Kathua (07),Total,15-19,60347,32775,27572,15103,5663,2989,5666,1922,3744,452
1,7,District - Kathua (07),Total,20-24,57528,29538,27990,13979,4773,2483,8294,2661,5633,1189
1,7,District - Kathua (07),Total,Adolescent (10-19),126408,68699,57709,31113,12824,6710,10658,3789,6869,530
1,7,District - Kathua (07),Total,Youth (15-24),117875,62313,55562,29082,10436,5472,13960,4583,9377,1641
1,7,District - Kathua (07),Rural,All Ages,526722,278126,248596,119693,52019,27022,206358,88251,118107,9363
1,7,District - Kathua (07),Rural,10-14,57977,31419,26558,13674,7010,3645,4697,1723,2974,71
1,7,District - Kathua (07),Rural,15-19,51948,28035,23913,12655,5512,2905,5361,1766,3595,432
1,7,District - Kathua (07),Rural,20-24,48897,25066,23831,11732,4651,2421,7821,2472,5349,1126
1,7,District - Kathua (07),Rural,Adolescent (10-19),109925,59454,50471,26329,12522,6550,10058,3489,6569,503
1,7,District - Kathua (07),Rural,Youth (15-24),100845,53101,47744,24387,10163,5326,13182,4238,8944,1558
1,7,District - Kathua (07),Urban,All Ages,89713,47983,41730,21531,1288,671,20873,9359,11514,789
1,7,District - Kathua (07),Urban,10-14,8084,4505,3579,2336,151,76,295,144,151,7
1,7,District - Kathua (07),Urban,15-19,8399,4740,3659,2448,151,84,305,156,149,20
1,7,District - Kathua (07),Urban,20-24,8631,4472,4159,2247,122,62,473,189,284,63
1,7,District - Kathua (07),Urban,Adolescent (10-19),16483,9245,7238,4784,302,160,600,300,300,27
1,7,District - Kathua (07),Urban,Youth (15-24),17030,9212,7818,4695,273,146,778,345,433,83
1,8,District - Baramula (08),Total,All Ages,1008039,534733,473306,1476,37705,20237,462890,197563,265327,19159
1,8,District - Baramula (08),Total,10-14,117753,60849,56904,11,4704,2402,12618,5074,7544,191
1,8,District - Baramula (08),Total,15-19,106269,53309,52960,7,3595,1954,13399,3941,9458,858
1,8,District - Baramula (08),Total,20-24,94755,49821,44934,165,2818,1540,19643,5601,14042,1829
1,8,District - Baramula (08),Total,Adolescent (10-19),224022,114158,109864,18,8299,4356,26017,9015,17002,1049
1,8,District - Baramula (08),Total,Youth (15-24),201024,103130,97894,172,6413,3494,33042,9542,23500,2687
1,8,District - Baramula (08),Rural,All Ages,825539,432399,393140,323,36169,19147,402346,171519,230827,17784
1,8,District - Baramula (08),Rural,10-14,101359,52467,48892,3,4584,2345,10975,4252,6723,184
1,8,District - Baramula (08),Rural,15-19,89303,44788,44515,4,3491,1897,12057,3326,8731,816
1,8,District - Baramula (08),Rural,20-24,75914,39078,36836,29,2606,1369,17630,4860,12770,1709
1,8,District - Baramula (08),Rural,Adolescent (10-19),190662,97255,93407,7,8075,4242,23032,7578,15454,1000
1,8,District - Baramula (08),Rural,Youth (15-24),165217,83866,81351,33,6097,3266,29687,8186,21501,2525
1,8,District - Baramula (08),Urban,All Ages,182500,102334,80166,1153,1536,1090,60544,26044,34500,1375
1,8,District - Baramula (08),Urban,10-14,16394,8382,8012,8,120,57,1643,822,821,7
1,8,District - Baramula (08),Urban,15-19,16966,8521,8445,3,104,57,1342,615,727,42
1,8,District - Baramula (08),Urban,20-24,18841,10743,8098,136,212,171,2013,741,1272,120
1,8,District - Baramula (08),Urban,Adolescent (10-19),33360,16903,16457,11,224,114,2985,1437,1548,49
1,8,District - Baramula (08),Urban,Youth (15-24),35807,19264,16543,139,316,228,3355,1356,1999,162
1,9,District - Bandipore (09),Total,All Ages,392232,207680,184552,392,75374,39398,206253,90622,115631,9423
1,9,District - Bandipore (09),Total,10-14,49106,25767,23339,6,10314,5379,9103,3746,5357,344
1,9,District - Bandipore (09),Total,15-19,44926,22798,22128,3,7676,3971,10616,3496,7120,761
1,9,District - Bandipore (09),Total,20-24,37627,19637,17990,36,5994,3096,12763,4349,8414,1137
1,9,District - Bandipore (09),Total,Adolescent (10-19),94032,48565,45467,9,17990,9350,19719,7242,12477,1105
1,9,District - Bandipore (09),Total,Youth (15-24),82553,42435,40118,39,13670,7067,23379,7845,15534,1898
1,9,District - Bandipore (09),Rural,All Ages,326871,172263,154608,105,74515,38899,178684,79030,99654,8584
1,9,District - Bandipore (09),Rural,10-14,41594,21591,20003,0,10254,5346,8211,3362,4849,337
1,9,District - Bandipore (09),Rural,15-19,37502,18966,18536,1,7588,3930,9463,3104,6359,721
1,9,District - Bandipore (09),Rural,20-24,30859,16042,14817,11,5901,3046,11151,3823,7328,1068
1,9,District - Bandipore (09),Rural,Adolescent (10-19),79096,40557,38539,1,17842,9276,17674,6466,11208,1058
1,9,District - Bandipore (09),Rural,Youth (15-24),68361,35008,33353,12,13489,6976,20614,6927,13687,1789
1,9,District - Bandipore (09),Urban,All Ages,65361,35417,29944,287,859,499,27569,11592,15977,839
1,9,District - Bandipore (09),Urban,10-14,7512,4176,3336,6,60,33,892,384,508,7
1,9,District - Bandipore (09),Urban,15-19,7424,3832,3592,2,88,41,1153,392,761,40
1,9,District - Bandipore (09),Urban,20-24,6768,3595,3173,25,93,50,1612,526,1086,69
1,9,District - Bandipore (09),Urban,Adolescent (10-19),14936,8008,6928,8,148,74,2045,776,1269,47
1,9,District - Bandipore (09),Urban,Youth (15-24),14192,7427,6765,27,181,91,2765,918,1847,109
1,10,District - Srinagar (10),Total,All Ages,1236829,651124,585705,1068,8935,5021,488245,219378,268867,6513
1,10,District - Srinagar (10),Total,10-14,112683,58784,53899,7,1157,664,12322,5991,6331,78
1,10,District - Srinagar (10),Total,15-19,117071,59947,57124,16,1065,551,13671,6064,7607,339
1,10,District - Srinagar (10),Total,20-24,121447,63034,58413,76,787,449,20353,8256,12097,693
1,10,District - Srinagar (10),Total,Adolescent (10-19),229754,118731,111023,23,2222,1215,25993,12055,13938,417
1,10,District - Srinagar (10),Total,Youth (15-24),238518,122981,115537,92,1852,1000,34024,14320,19704,1032
1,10,District - Srinagar (10),Rural,All Ages,17313,8916,8397,0,3104,1637,9385,4104,5281,270
1,10,District - Srinagar (10),Rural,10-14,1920,1010,910,0,459,256,185,68,117,2
1,10,District - Srinagar (10),Rural,15-19,2081,1036,1045,0,381,195,394,133,261,7
1,10,District - Srinagar (10),Rural,20-24,1743,908,835,0,219,110,577,193,384,23
1,10,District - Srinagar (10),Rural,Adolescent (10-19),4001,2046,1955,0,840,451,579,201,378,9
1,10,District - Srinagar (10),Rural,Youth (15-24),3824,1944,1880,0,600,305,971,326,645,30
1,10,District - Srinagar (10),Urban,All Ages,1219516,642208,577308,1068,5831,3384,478860,215274,263586,6243
1,10,District - Srinagar (10),Urban,10-14,110763,57774,52989,7,698,408,12137,5923,6214,76
1,10,District - Srinagar (10),Urban,15-19,114990,58911,56079,16,684,356,13277,5931,7346,332
1,10,District - Srinagar (10),Urban,20-24,119704,62126,57578,76,568,339,19776,8063,11713,670
1,10,District - Srinagar (10),Urban,Adolescent (10-19),225753,116685,109068,23,1382,764,25414,11854,13560,408
1,10,District - Srinagar (10),Urban,Youth (15-24),234694,121037,113657,92,1252,695,33053,13994,19059,1002
1,11,District - Ganderbal (11),Total,All Ages,297446,158720,138726,117,61070,32554,154170,68139,86031,5539
1,11,District - Ganderbal (11),Total,10-14,36979,19495,17484,5,9110,4803,6950,3205,3745,53
1,11,District - Ganderbal (11),Total,15-19,32094,16594,15500,3,6094,3307,5897,2069,3828,296
1,11,District - Ganderbal (11),Total,20-24,27794,14653,13141,11,4674,2525,7623,2430,5193,607
1,11,District - Ganderbal (11),Total,Adolescent (10-19),69073,36089,32984,8,15204,8110,12847,5274,7573,349
1,11,District - Ganderbal (11),Total,Youth (15-24),59888,31247,28641,14,10768,5832,13520,4499,9021,903
1,11,District - Ganderbal (11),Rural,All Ages,250407,133715,116692,85,60275,32104,132927,58831,74096,5010
1,11,District - Ganderbal (11),Rural,10-14,31437,16549,14888,5,8990,4738,6325,2905,3420,51
1,11,District - Ganderbal (11),Rural,15-19,27331,14164,13167,3,5985,3246,5404,1913,3491,276
1,11,District - Ganderbal (11),Rural,20-24,23449,12529,10920,9,4589,2476,6819,2204,4615,552
1,11,District - Ganderbal (11),Rural,Adolescent (10-19),58768,30713,28055,8,14975,7984,11729,4818,6911,327
1,11,District - Ganderbal (11),Rural,Youth (15-24),50780,26693,24087,12,10574,5722,12223,4117,8106,828
1,11,District - Ganderbal (11),Urban,All Ages,47039,25005,22034,32,795,450,21243,9308,11935,529
1,11,District - Ganderbal (11),Urban,10-14,5542,2946,2596,0,120,65,625,300,325,2
1,11,District - Ganderbal (11),Urban,15-19,4763,2430,2333,0,109,61,493,156,337,20
1,11,District - Ganderbal (11),Urban,20-24,4345,2124,2221,2,85,49,804,226,578,55
1,11,District - Ganderbal (11),Urban,Adolescent (10-19),10305,5376,4929,0,229,126,1118,456,662,22
1,11,District - Ganderbal (11),Urban,Youth (15-24),9108,4554,4554,2,194,110,1297,382,915,75
1,12,District - Pulwama (12),Total,All Ages,560440,293064,267376,402,22607,11837,266482,114738,151744,6992
1,12,District - Pulwama (12),Total,10-14,55643,28869,26774,2,2962,1525,6455,2910,3545,64
1,12,District - Pulwama (12),Total,15-19,55325,27359,27966,0,1949,989,5940,1999,3941,306
1,12,District - Pulwama (12),Total,20-24,54308,27160,27148,46,1584,810,10112,3013,7099,734
1,12,District - Pulwama (12),Total,Adolescent (10-19),110968,56228,54740,2,4911,2514,12395,4909,7486,370
1,12,District - Pulwama (12),Total,Youth (15-24),109633,54519,55114,46,3533,1799,16052,5012,11040,1040
1,12,District - Pulwama (12),Rural,All Ages,479978,248096,231882,52,22189,11528,234799,100867,133932,6532
1,12,District - Pulwama (12),Rural,10-14,48838,25312,23526,1,2931,1513,5802,2629,3173,63
1,12,District - Pulwama (12),Rural,15-19,48586,23962,24624,0,1936,983,5352,1744,3608,286
1,12,District - Pulwama (12),Rural,20-24,46617,22936,23681,6,1539,770,9155,2642,6513,687
1,12,District - Pulwama (12),Rural,Adolescent (10-19),97424,49274,48150,1,4867,2496,11154,4373,6781,349
1,12,District - Pulwama (12),Rural,Youth (15-24),95203,46898,48305,6,3475,1753,14507,4386,10121,973
1,12,District - Pulwama (12),Urban,All Ages,80462,44968,35494,350,418,309,31683,13871,17812,460
1,12,District - Pulwama (12),Urban,10-14,6805,3557,3248,1,31,12,653,281,372,1
1,12,District - Pulwama (12),Urban,15-19,6739,3397,3342,0,13,6,588,255,333,20
1,12,District - Pulwama (12),Urban,20-24,7691,4224,3467,40,45,40,957,371,586,47
1,12,District - Pulwama (12),Urban,Adolescent (10-19),13544,6954,6590,1,44,18,1241,536,705,21
1,12,District - Pulwama (12),Urban,Youth (15-24),14430,7621,6809,40,58,46,1545,626,919,67
1,13,District - Shupiyan (13),Total,All Ages,266215,136480,129735,43,21820,11311,129715,56125,73590,3761
1,13,District - Shupiyan (13),Total,10-14,31592,15975,15617,0,3218,1680,3424,1431,1993,40
1,13,District - Shupiyan (13),Total,15-19,31313,15433,15880,0,2111,1100,3832,1229,2603,220
1,13,District - Shupiyan (13),Total,20-24,26737,13021,13716,5,1381,716,6153,1738,4415,423
1,13,District - Shupiyan (13),Total,Adolescent (10-19),62905,31408,31497,0,5329,2780,7256,2660,4596,260
1,13,District - Shupiyan (13),Total,Youth (15-24),58050,28454,29596,5,3492,1816,9985,2967,7018,643
1,13,District - Shupiyan (13),Rural,All Ages,249855,127161,122694,5,21798,11296,124599,53895,70704,3658
1,13,District - Shupiyan (13),Rural,10-14,30369,15385,14984,0,3216,1679,3319,1383,1936,40
1,13,District - Shupiyan (13),Rural,15-19,29949,14771,15178,0,2111,1100,3772,1194,2578,220
1,13,District - Shupiyan (13),Rural,20-24,25108,12097,13011,2,1379,714,6046,1693,4353,415
1,13,District - Shupiyan (13),Rural,Adolescent (10-19),60318,30156,30162,0,5327,2779,7091,2577,4514,260
1,13,District - Shupiyan (13),Rural,Youth (15-24),55057,26868,28189,2,3490,1814,9818,2887,6931,635
1,13,District - Shupiyan (13),Urban,All Ages,16360,9319,7041,38,22,15,5116,2230,2886,103
1,13,District - Shupiyan (13),Urban,10-14,1223,590,633,0,2,1,105,48,57,0
1,13,District - Shupiyan (13),Urban,15-19,1364,662,702,0,0,0,60,35,25,0
1,13,District - Shupiyan (13),Urban,20-24,1629,924,705,3,2,2,107,45,62,8
1,13,District - Shupiyan (13),Urban,Adolescent (10-19),2587,1252,1335,0,2,1,165,83,82,0
1,13,District - Shupiyan (13),Urban,Youth (15-24),2993,1586,1407,3,2,2,167,80,87,8
1,14,District - Anantnag (14),Total,All Ages,1078692,559767,518925,1826,116006,60990,533160,235350,297810,19664
1,14,District - Anantnag (14),Total,10-14,135721,70923,64798,2,16945,8970,19047,8467,10580,264
1,14,District - Anantnag (14),Total,15-19,105248,53368,51880,6,10317,5424,15743,5604,10139,1026
1,14,District - Anantnag (14),Total,20-24,93874,46732,47142,172,7497,3860,22070,6828,15242,2169
1,14,District - Anantnag (14),Total,Adolescent (10-19),240969,124291,116678,8,27262,14394,34790,14071,20719,1290
1,14,District - Anantnag (14),Total,Youth (15-24),199122,100100,99022,178,17814,9284,37813,12432,25381,3195
1,14,District - Anantnag (14),Rural,All Ages,795805,411012,384793,1383,113575,59636,419946,185999,233947,17556
1,14,District - Anantnag (14),Rural,10-14,103466,53882,49584,1,16651,8807,16109,7043,9066,256
1,14,District - Anantnag (14),Rural,15-19,78972,39838,39134,4,10102,5324,13485,4731,8754,950
1,14,District - Anantnag (14),Rural,20-24,68303,33730,34573,146,7316,3754,18465,5672,12793,1979
1,14,District - Anantnag (14),Rural,Adolescent (10-19),182438,93720,88718,5,26753,14131,29594,11774,17820,1206
1,14,District - Anantnag (14),Rural,Youth (15-24),147275,73568,73707,150,17418,9078,31950,10403,21547,2929
1,14,District - Anantnag (14),Urban,All Ages,282887,148755,134132,443,2431,1354,113214,49351,63863,2108
1,14,District - Anantnag (14),Urban,10-14,32255,17041,15214,1,294,163,2938,1424,1514,8
1,14,District - Anantnag (14),Urban,15-19,26276,13530,12746,2,215,100,2258,873,1385,76
1,14,District - Anantnag (14),Urban,20-24,25571,13002,12569,26,181,106,3605,1156,2449,190
1,14,District - Anantnag (14),Urban,Adolescent (10-19),58531,30571,27960,3,509,263,5196,2297,2899,84
1,14,District - Anantnag (14),Urban,Youth (15-24),51847,26532,25315,28,396,206,5863,2029,3834,266
1,15,District - Kulgam (15),Total,All Ages,424483,217620,206863,21,26525,13888,215398,92568,122830,8830
1,15,District - Kulgam (15),Total,10-14,49228,25177,24051,3,3572,1852,6557,2853,3704,74
1,15,District - Kulgam (15),Total,15-19,44153,21986,22167,1,2309,1234,6072,1987,4085,440
1,15,District - Kulgam (15),Total,20-24,41190,20010,21180,2,1723,830,10033,2855,7178,923
1,15,District - Kulgam (15),Total,Adolescent (10-19),93381,47163,46218,4,5881,3086,12629,4840,7789,514
1,15,District - Kulgam (15),Total,Youth (15-24),85343,41996,43347,3,4032,2064,16105,4842,11263,1363
1,15,District - Kulgam (15),Rural,All Ages,343870,175574,168296,18,25802,13520,180758,78331,102427,7954
1,15,District - Kulgam (15),Rural,10-14,40651,20759,19892,3,3462,1803,5805,2533,3272,70
1,15,District - Kulgam (15),Rural,15-19,35906,17869,18037,1,2235,1195,5392,1759,3633,412
1,15,District - Kulgam (15),Rural,20-24,33044,15919,17125,1,1674,800,8790,2525,6265,855
1,15,District - Kulgam (15),Rural,Adolescent (10-19),76557,38628,37929,4,5697,2998,11197,4292,6905,482
1,15,District - Kulgam (15),Rural,Youth (15-24),68950,33788,35162,2,3909,1995,14182,4284,9898,1267
1,15,District - Kulgam (15),Urban,All Ages,80613,42046,38567,3,723,368,34640,14237,20403,876
1,15,District - Kulgam (15),Urban,10-14,8577,4418,4159,0,110,49,752,320,432,4
1,15,District - Kulgam (15),Urban,15-19,8247,4117,4130,0,74,39,680,228,452,28
1,15,District - Kulgam (15),Urban,20-24,8146,4091,4055,1,49,30,1243,330,913,68
1,15,District - Kulgam (15),Urban,Adolescent (10-19),16824,8535,8289,0,184,88,1432,548,884,32
1,15,District - Kulgam (15),Urban,Youth (15-24),16393,8208,8185,1,123,69,1923,558,1365,96
1,16,District - Doda (16),Total,All Ages,409936,213641,196295,53408,39216,20377,190853,75021,115832,3938
1,16,District - Doda (16),Total,10-14,50588,26174,24414,6696,5462,2927,4768,1553,3215,29
1,16,District - Doda (16),Total,15-19,40541,21092,19449,5421,3949,2064,6434,1465,4969,200
1,16,District - Doda (16),Total,20-24,38242,19607,18635,5103,3377,1688,10133,2367,7766,598
1,16,District - Doda (16),Total,Adolescent (10-19),91129,47266,43863,12117,9411,4991,11202,3018,8184,229
1,16,District - Doda (16),Total,Youth (15-24),78783,40699,38084,10524,7326,3752,16567,3832,12735,798
1,16,District - Doda (16),Rural,All Ages,377247,195430,181817,52339,38601,20016,182697,71611,111086,3905
1,16,District - Doda (16),Rural,10-14,47045,24173,22872,6584,5316,2828,4674,1507,3167,29
1,16,District - Doda (16),Rural,15-19,37280,19244,18036,5301,3833,1989,6270,1399,4871,200
1,16,District - Doda (16),Rural,20-24,35216,17952,17264,5001,3341,1671,9880,2290,7590,595
1,16,District - Doda (16),Rural,Adolescent (10-19),84325,43417,40908,11885,9149,4817,10944,2906,8038,229
1,16,District - Doda (16),Rural,Youth (15-24),72496,37196,35300,10302,7174,3660,16150,3689,12461,795
1,16,District - Doda (16),Urban,All Ages,32689,18211,14478,1069,615,361,8156,3410,4746,33
1,16,District - Doda (16),Urban,10-14,3543,2001,1542,112,146,99,94,46,48,0
1,16,District - Doda (16),Urban,15-19,3261,1848,1413,120,116,75,164,66,98,0
1,16,District - Doda (16),Urban,20-24,3026,1655,1371,102,36,17,253,77,176,3
1,16,District - Doda (16),Urban,Adolescent (10-19),6804,3849,2955,232,262,174,258,112,146,0
1,16,District - Doda (16),Urban,Youth (15-24),6287,3503,2784,222,152,92,417,143,274,3
1,17,District - Ramban (17),Total,All Ages,283713,149132,134581,13920,39772,20940,159648,66194,93454,3410
1,17,District - Ramban (17),Total,10-14,36437,18801,17636,1880,5359,2820,7035,2215,4820,29
1,17,District - Ramban (17),Total,15-19,28230,14432,13798,1417,3623,1947,8722,2240,6482,167
1,17,District - Ramban (17),Total,20-24,25136,13006,12130,1231,3368,1754,10385,3091,7294,450
1,17,District - Ramban (17),Total,Adolescent (10-19),64667,33233,31434,3297,8982,4767,15757,4455,11302,196
1,17,District - Ramban (17),Total,Youth (15-24),53366,27438,25928,2648,6991,3701,19107,5331,13776,617
1,17,District - Ramban (17),Rural,All Ages,271902,142317,129585,13402,39583,20839,156708,64965,91743,3363
1,17,District - Ramban (17),Rural,10-14,35431,18284,17147,1822,5334,2808,6996,2194,4802,29
1,17,District - Ramban (17),Rural,15-19,27262,13917,13345,1359,3603,1935,8669,2218,6451,166
1,17,District - Ramban (17),Rural,20-24,24046,12384,11662,1192,3351,1744,10295,3054,7241,445
1,17,District - Ramban (17),Rural,Adolescent (10-19),62693,32201,30492,3181,8937,4743,15665,4412,11253,195
1,17,District - Ramban (17),Rural,Youth (15-24),51308,26301,25007,2551,6954,3679,18964,5272,13692,611
1,17,District - Ramban (17),Urban,All Ages,11811,6815,4996,518,189,101,2940,1229,1711,47
1,17,District - Ramban (17),Urban,10-14,1006,517,489,58,25,12,39,21,18,0
1,17,District - Ramban (17),Urban,15-19,968,515,453,58,20,12,53,22,31,1
1,17,District - Ramban (17),Urban,20-24,1090,622,468,39,17,10,90,37,53,5
1,17,District - Ramban (17),Urban,Adolescent (10-19),1974,1032,942,116,45,24,92,43,49,1
1,17,District - Ramban (17),Urban,Youth (15-24),2058,1137,921,97,37,22,143,59,84,6
1,18,District - Kishtwar (18),Total,All Ages,230696,120165,110531,14307,38149,19889,123190,51465,71725,3583
1,18,District - Kishtwar (18),Total,10-14,28897,14959,13938,1896,5333,2890,4898,1758,3140,47
1,18,District - Kishtwar (18),Total,15-19,22349,11653,10696,1482,3089,1621,5408,1637,3771,220
1,18,District - Kishtwar (18),Total,20-24,19734,10014,9720,1317,2965,1458,7367,2196,5171,475
1,18,District - Kishtwar (18),Total,Adolescent (10-19),51246,26612,24634,3378,8422,4511,10306,3395,6911,267
1,18,District - Kishtwar (18),Total,Youth (15-24),42083,21667,20416,2799,6054,3079,12775,3833,8942,695
1,18,District - Kishtwar (18),Rural,All Ages,215831,111986,103845,14020,38069,19840,119719,50052,69667,3566
1,18,District - Kishtwar (18),Rural,10-14,27466,14184,13282,1864,5323,2886,4821,1729,3092,47
1,18,District - Kishtwar (18),Rural,15-19,21010,10926,10084,1457,3081,1617,5327,1596,3731,217
1,18,District - Kishtwar (18),Rural,20-24,18353,9273,9080,1292,2960,1454,7301,2177,5124,475
1,18,District - Kishtwar (18),Rural,Adolescent (10-19),48476,25110,23366,3321,8404,4503,10148,3325,6823,264
1,18,District - Kishtwar (18),Rural,Youth (15-24),39363,20199,19164,2749,6041,3071,12628,3773,8855,692
1,18,District - Kishtwar (18),Urban,All Ages,14865,8179,6686,287,80,49,3471,1413,2058,17
1,18,District - Kishtwar (18),Urban,10-14,1431,775,656,32,10,4,77,29,48,0
1,18,District - Kishtwar (18),Urban,15-19,1339,727,612,25,8,4,81,41,40,3
1,18,District - Kishtwar (18),Urban,20-24,1381,741,640,25,5,4,66,19,47,0
1,18,District - Kishtwar (18),Urban,Adolescent (10-19),2770,1502,1268,57,18,8,158,70,88,3
1,18,District - Kishtwar (18),Urban,Youth (15-24),2720,1468,1252,50,13,8,147,60,87,3
1,19,District - Udhampur (19),Total,All Ages,554985,296784,258201,138569,56309,29142,232631,99241,133390,3858
1,19,District - Udhampur (19),Total,10-14,61318,32328,28990,17118,7359,3811,5754,2169,3585,46
1,19,District - Udhampur (19),Total,15-19,53339,27990,25349,14385,5955,2994,7381,2526,4855,335
1,19,District - Udhampur (19),Total,20-24,53165,28547,24618,12838,5207,2625,11676,3932,7744,646
1,19,District - Udhampur (19),Total,Adolescent (10-19),114657,60318,54339,31503,13314,6805,13135,4695,8440,381
1,19,District - Udhampur (19),Total,Youth (15-24),106504,56537,49967,27223,11162,5619,19057,6458,12599,981
1,19,District - Udhampur (19),Rural,All Ages,446777,232974,213803,122742,53636,27736,209895,88908,120987,3521
1,19,District - Udhampur (19),Rural,10-14,52710,27645,25065,15278,7055,3661,5364,1973,3391,45
1,19,District - Udhampur (19),Rural,15-19,45169,23545,21624,12690,5674,2868,6984,2363,4621,330
1,19,District - Udhampur (19),Rural,20-24,42145,21921,20224,11284,4906,2462,10956,3607,7349,590
1,19,District - Udhampur (19),Rural,Adolescent (10-19),97879,51190,46689,27968,12729,6529,12348,4336,8012,375
1,19,District - Udhampur (19),Rural,Youth (15-24),87314,45466,41848,23974,10580,5330,17940,5970,11970,920
1,19,District - Udhampur (19),Urban,All Ages,108208,63810,44398,15827,2673,1406,22736,10333,12403,337
1,19,District - Udhampur (19),Urban,10-14,8608,4683,3925,1840,304,150,390,196,194,1
1,19,District - Udhampur (19),Urban,15-19,8170,4445,3725,1695,281,126,397,163,234,5
1,19,District - Udhampur (19),Urban,20-24,11020,6626,4394,1554,301,163,720,325,395,56
1,19,District - Udhampur (19),Urban,Adolescent (10-19),16778,9128,7650,3535,585,276,787,359,428,6
1,19,District - Udhampur (19),Urban,Youth (15-24),19190,11071,8119,3249,582,289,1117,488,629,61
1,20,District - Reasi (20),Total,All Ages,314667,166461,148206,37757,88365,46330,164125,72524,91601,1293
1,20,District - Reasi (20),Total,10-14,39726,20892,18834,4389,12276,6466,6433,2397,4036,20
1,20,District - Reasi (20),Total,15-19,29882,15791,14091,3861,8187,4403,7137,2287,4850,131
1,20,District - Reasi (20),Total,20-24,29169,15391,13778,3869,7559,3937,9649,3433,6216,243
1,20,District - Reasi (20),Total,Adolescent (10-19),69608,36683,32925,8250,20463,10869,13570,4684,8886,151
1,20,District - Reasi (20),Total,Youth (15-24),59051,31182,27869,7730,15746,8340,16786,5720,11066,374
1,20,District - Reasi (20),Rural,All Ages,287671,151481,136190,33232,86608,45441,156343,68979,87364,1178
1,20,District - Reasi (20),Rural,10-14,37337,19601,17736,3914,12039,6357,6265,2320,3945,18
1,20,District - Reasi (20),Rural,15-19,27536,14538,12998,3397,8007,4313,6936,2196,4740,115
1,20,District - Reasi (20),Rural,20-24,26588,13992,12596,3404,7403,3855,9342,3313,6029,222
1,20,District - Reasi (20),Rural,Adolescent (10-19),64873,34139,30734,7311,20046,10670,13201,4516,8685,133
1,20,District - Reasi (20),Rural,Youth (15-24),54124,28530,25594,6801,15410,8168,16278,5509,10769,337
1,20,District - Reasi (20),Urban,All Ages,26996,14980,12016,4525,1757,889,7782,3545,4237,115
1,20,District - Reasi (20),Urban,10-14,2389,1291,1098,475,237,109,168,77,91,2
1,20,District - Reasi (20),Urban,15-19,2346,1253,1093,464,180,90,201,91,110,16
1,20,District - Reasi (20),Urban,20-24,2581,1399,1182,465,156,82,307,120,187,21
1,20,District - Reasi (20),Urban,Adolescent (10-19),4735,2544,2191,939,417,199,369,168,201,18
1,20,District - Reasi (20),Urban,Youth (15-24),4927,2652,2275,929,336,172,508,211,297,37
1,21,District - Jammu (21),Total,All Ages,1529958,813821,716137,377991,69193,36323,392823,171905,220918,16414
1,21,District - Jammu (21),Total,10-14,137646,76454,61192,38137,8923,4774,6521,3223,3298,70
1,21,District - Jammu (21),Total,15-19,144526,78526,66000,41172,7963,4236,6419,2926,3493,614
1,21,District - Jammu (21),Total,20-24,147093,76482,70611,39207,6666,3445,9011,3558,5453,1583
1,21,District - Jammu (21),Total,Adolescent (10-19),282172,154980,127192,79309,16886,9010,12940,6149,6791,684
1,21,District - Jammu (21),Total,Youth (15-24),291619,155008,136611,80379,14629,7681,15430,6484,8946,2197
1,21,District - Jammu (21),Rural,All Ages,764945,401603,363342,268098,47138,24647,240064,103403,136661,14538
1,21,District - Jammu (21),Rural,10-14,76189,42091,34098,27634,6197,3288,3162,1520,1642,65
1,21,District - Jammu (21),Rural,15-19,79006,42531,36475,29517,5377,2821,3462,1439,2023,575
1,21,District - Jammu (21),Rural,20-24,74016,37400,36616,27448,4448,2278,5039,1867,3172,1432
1,21,District - Jammu (21),Rural,Adolescent (10-19),155195,84622,70573,57151,11574,6109,6624,2959,3665,640
1,21,District - Jammu (21),Rural,Youth (15-24),153022,79931,73091,56965,9825,5099,8501,3306,5195,2007
1,21,District - Jammu (21),Urban,All Ages,765013,412218,352795,109893,22055,11676,152759,68502,84257,1876
1,21,District - Jammu (21),Urban,10-14,61457,34363,27094,10503,2726,1486,3359,1703,1656,5
1,21,District - Jammu (21),Urban,15-19,65520,35995,29525,11655,2586,1415,2957,1487,1470,39
1,21,District - Jammu (21),Urban,20-24,73077,39082,33995,11759,2218,1167,3972,1691,2281,151
1,21,District - Jammu (21),Urban,Adolescent (10-19),126977,70358,56619,22158,5312,2901,6316,3190,3126,44
1,21,District - Jammu (21),Urban,Youth (15-24),138597,75077,63520,23414,4804,2582,6929,3178,3751,190
1,22,District - Samba (22),Total,All Ages,318898,169124,149774,91835,17573,9188,90759,38812,51947,2414
1,22,District - Samba (22),Total,10-14,30526,17131,13395,9385,2053,1144,1188,589,599,30
1,22,District - Samba (22),Total,15-19,31072,16808,14264,9700,1918,985,1310,554,756,70
1,22,District - Samba (22),Total,20-24,30443,15316,15127,9380,1766,864,1759,650,1109,218
1,22,District - Samba (22),Total,Adolescent (10-19),61598,33939,27659,19085,3971,2129,2498,1143,1355,100
1,22,District - Samba (22),Total,Youth (15-24),61515,32124,29391,19080,3684,1849,3069,1204,1865,288
1,22,District - Samba (22),Rural,All Ages,265283,139365,125918,78034,16636,8676,79537,33915,45622,2249
1,22,District - Samba (22),Rural,10-14,25936,14527,11409,8101,1965,1090,1043,512,531,30
1,22,District - Samba (22),Rural,15-19,26242,14164,12078,8236,1823,930,1146,479,667,66
1,22,District - Samba (22),Rural,20-24,25217,12553,12664,7879,1673,815,1574,560,1014,205
1,22,District - Samba (22),Rural,Adolescent (10-19),52178,28691,23487,16337,3788,2020,2189,991,1198,96
1,22,District - Samba (22),Rural,Youth (15-24),51459,26717,24742,16115,3496,1745,2720,1039,1681,271
1,22,District - Samba (22),Urban,All Ages,53615,29759,23856,13801,937,512,11222,4897,6325,165
1,22,District - Samba (22),Urban,10-14,4590,2604,1986,1284,88,54,145,77,68,0
1,22,District - Samba (22),Urban,15-19,4830,2644,2186,1464,95,55,164,75,89,4
1,22,District - Samba (22),Urban,20-24,5226,2763,2463,1501,93,49,185,90,95,13
1,22,District - Samba (22),Urban,Adolescent (10-19),9420,5248,4172,2748,183,109,309,152,157,4
1,22,District - Samba (22),Urban,Youth (15-24),10056,5407,4649,2965,188,104,349,165,184,17
2,0,State - HIMACHAL PRADESH (02),Total,All Ages,6864602,3481873,3382729,1729252,392126,196118,1824866,729283,1095583,68668
2,0,State - HIMACHAL PRADESH (02),Total,10-14,639224,338240,300984,173444,39451,20426,17760,8568,9192,948
2,0,State - HIMACHAL PRADESH (02),Total,15-19,640461,336729,303732,169010,38640,19557,17551,8402,9149,4002
2,0,State - HIMACHAL PRADESH (02),Total,20-24,643866,323720,320146,167486,37419,18233,28529,11258,17271,8824
2,0,State - HIMACHAL PRADESH (02),Total,Adolescent (10-19),1279685,674969,604716,342454,78091,39983,35311,16970,18341,4950
2,0,State - HIMACHAL PRADESH (02),Total,Youth (15-24),1284327,660449,623878,336496,76059,37790,46080,19660,26420,12826
2,0,State - HIMACHAL PRADESH (02),Rural,All Ages,6176050,3110345,3065705,1606535,374392,186896,1704314,672524,1031790,66318
2,0,State - HIMACHAL PRADESH (02),Rural,10-14,580265,305500,274765,162038,37830,19485,15761,7518,8243,932
2,0,State - HIMACHAL PRADESH (02),Rural,15-19,575991,300554,275437,156577,36645,18534,15203,6952,8251,3877
2,0,State - HIMACHAL PRADESH (02),Rural,20-24,573439,285167,288272,154321,35411,17211,24885,9331,15554,8523
2,0,State - HIMACHAL PRADESH (02),Rural,Adolescent (10-19),1156256,606054,550202,318615,74475,38019,30964,14470,16494,4809
2,0,State - HIMACHAL PRADESH (02),Rural,Youth (15-24),1149430,585721,563709,310898,72056,35745,40088,16283,23805,12400
2,0,State - HIMACHAL PRADESH (02),Urban,All Ages,688552,371528,317024,122717,17734,9222,120552,56759,63793,2350
2,0,State - HIMACHAL PRADESH (02),Urban,10-14,58959,32740,26219,11406,1621,941,1999,1050,949,16
2,0,State - HIMACHAL PRADESH (02),Urban,15-19,64470,36175,28295,12433,1995,1023,2348,1450,898,125
2,0,State - HIMACHAL PRADESH (02),Urban,20-24,70427,38553,31874,13165,2008,1022,3644,1927,1717,301
2,0,State - HIMACHAL PRADESH (02),Urban,Adolescent (10-19),123429,68915,54514,23839,3616,1964,4347,2500,1847,141
2,0,State - HIMACHAL PRADESH (02),Urban,Youth (15-24),134897,74728,60169,25598,4003,2045,5992,3377,2615,426
2,23,District - Chamba (01),Total,All Ages,519080,261320,257760,111690,135500,67900,195238,75256,119982,2650
2,23,District - Chamba (01),Total,10-14,56293,28743,27550,12624,15130,7798,2552,992,1560,143
2,23,District - Chamba (01),Total,15-19,52835,26822,26013,11543,14339,7142,3064,1024,2040,223
2,23,District - Chamba (01),Total,20-24,51043,25190,25853,11257,13428,6483,5074,1244,3830,375
2,23,District - Chamba (01),Total,Adolescent (10-19),109128,55565,53563,24167,29469,14940,5616,2016,3600,366
2,23,District - Chamba (01),Total,Youth (15-24),103878,52012,51866,22800,27767,13625,8138,2268,5870,598
2,23,District - Chamba (01),Rural,All Ages,482972,241963,241009,105635,132907,66589,189289,72692,116597,2629
2,23,District - Chamba (01),Rural,10-14,52566,26710,25856,12055,14882,7656,2493,956,1537,143
2,23,District - Chamba (01),Rural,15-19,49669,25143,24526,10967,14060,6994,3010,991,2019,222
2,23,District - Chamba (01),Rural,20-24,47776,23405,24371,10653,13144,6352,4983,1207,3776,374
2,23,District - Chamba (01),Rural,Adolescent (10-19),102235,51853,50382,23022,28942,14650,5503,1947,3556,365
2,23,District - Chamba (01),Rural,Youth (15-24),97445,48548,48897,21620,27204,13346,7993,2198,5795,596
2,23,District - Chamba (01),Urban,All Ages,36108,19357,16751,6055,2593,1311,5949,2564,3385,21
2,23,District - Chamba (01),Urban,10-14,3727,2033,1694,569,248,142,59,36,23,0
2,23,District - Chamba (01),Urban,15-19,3166,1679,1487,576,279,148,54,33,21,1
2,23,District - Chamba (01),Urban,20-24,3267,1785,1482,604,284,131,91,37,54,1
2,23,District - Chamba (01),Urban,Adolescent (10-19),6893,3712,3181,1145,527,290,113,69,44,1
2,23,District - Chamba (01),Urban,Youth (15-24),6433,3464,2969,1180,563,279,145,70,75,2
2,24,District - Kangra (02),Total,All Ages,1510075,750591,759484,319385,84564,41745,357435,144148,213287,11122
2,24,District - Kangra (02),Total,10-14,134434,73181,61253,30271,8191,4286,3194,1579,1615,50
2,24,District - Kangra (02),Total,15-19,136480,72217,64263,30352,8748,4466,2507,1232,1275,273
2,24,District - Kangra (02),Total,20-24,132145,63164,68981,29185,8287,3882,3524,1435,2089,1014
2,24,District - Kangra (02),Total,Adolescent (10-19),270914,145398,125516,60623,16939,8752,5701,2811,2890,323
2,24,District - Kangra (02),Total,Youth (15-24),268625,135381,133244,59537,17035,8348,6031,2667,3364,1287
2,24,District - Kangra (02),Rural,All Ages,1423794,705365,718429,304802,80234,39498,341352,136801,204551,10817
2,24,District - Kangra (02),Rural,10-14,126737,68994,57743,28865,7811,4078,2923,1446,1477,49
2,24,District - Kangra (02),Rural,15-19,128698,68007,60691,28931,8312,4243,2258,1098,1160,269
2,24,District - Kangra (02),Rural,20-24,124341,59128,65213,27771,7837,3658,3194,1293,1901,971
2,24,District - Kangra (02),Rural,Adolescent (10-19),255435,137001,118434,57796,16123,8321,5181,2544,2637,318
2,24,District - Kangra (02),Rural,Youth (15-24),253039,127135,125904,56702,16149,7901,5452,2391,3061,1240
2,24,District - Kangra (02),Urban,All Ages,86281,45226,41055,14583,4330,2247,16083,7347,8736,305
2,24,District - Kangra (02),Urban,10-14,7697,4187,3510,1406,380,208,271,133,138,1
2,24,District - Kangra (02),Urban,15-19,7782,4210,3572,1421,436,223,249,134,115,4
2,24,District - Kangra (02),Urban,20-24,7804,4036,3768,1414,450,224,330,142,188,43
2,24,District - Kangra (02),Urban,Adolescent (10-19),15479,8397,7082,2827,816,431,520,267,253,5
2,24,District - Kangra (02),Urban,Youth (15-24),15586,8246,7340,2835,886,447,579,276,303,47
2,25,District - Lahul & Spiti (03),Total,All Ages,31564,16588,14976,2235,25707,12748,9719,3691,6028,263
2,25,District - Lahul & Spiti (03),Total,10-14,2632,1292,1340,162,2280,1123,87,57,30,9
2,25,District - Lahul & Spiti (03),Total,15-19,2709,1460,1249,194,2195,1120,176,143,33,55
2,25,District - Lahul & Spiti (03),Total,20-24,2989,1672,1317,230,2096,1036,230,138,92,27
2,25,District - Lahul & Spiti (03),Total,Adolescent (10-19),5341,2752,2589,356,4475,2243,263,200,63,64
2,25,District - Lahul & Spiti (03),Total,Youth (15-24),5698,3132,2566,424,4291,2156,406,281,125,82
2,25,District - Lahul & Spiti (03),Rural,All Ages,31564,16588,14976,2235,25707,12748,9719,3691,6028,263
2,25,District - Lahul & Spiti (03),Rural,10-14,2632,1292,1340,162,2280,1123,87,57,30,9
2,25,District - Lahul & Spiti (03),Rural,15-19,2709,1460,1249,194,2195,1120,176,143,33,55
2,25,District - Lahul & Spiti (03),Rural,20-24,2989,1672,1317,230,2096,1036,230,138,92,27
2,25,District - Lahul & Spiti (03),Rural,Adolescent (10-19),5341,2752,2589,356,4475,2243,263,200,63,64
2,25,District - Lahul & Spiti (03),Rural,Youth (15-24),5698,3132,2566,424,4291,2156,406,281,125,82
2,25,District - Lahul & Spiti (03),Urban,All Ages,0,0,0,0,0,0,0,0,0,0
2,25,District - Lahul & Spiti (03),Urban,10-14,0,0,0,0,0,0,0,0,0,0
2,25,District - Lahul & Spiti (03),Urban,15-19,0,0,0,0,0,0,0,0,0,0
2,25,District - Lahul & Spiti (03),Urban,20-24,0,0,0,0,0,0,0,0,0,0
2,25,District - Lahul & Spiti (03),Urban,Adolescent (10-19),0,0,0,0,0,0,0,0,0,0
2,25,District - Lahul & Spiti (03),Urban,Youth (15-24),0,0,0,0,0,0,0,0,0,0
2,26,District - Kullu (04),Total,All Ages,437903,225452,212451,122659,16822,8493,130231,50902,79329,7172
2,26,District - Kullu (04),Total,10-14,42519,21770,20749,13034,1400,755,1150,590,560,78
2,26,District - Kullu (04),Total,15-19,43817,22757,21060,13097,1487,753,1334,660,674,512
2,26,District - Kullu (04),Total,20-24,45039,23183,21856,13158,1515,788,2202,842,1360,1022
2,26,District - Kullu (04),Total,Adolescent (10-19),86336,44527,41809,26131,2887,1508,2484,1250,1234,590
2,26,District - Kullu (04),Total,Youth (15-24),88856,45940,42916,26255,3002,1541,3536,1502,2034,1534
2,26,District - Kullu (04),Rural,All Ages,396512,203269,193243,115514,12463,6320,121771,47002,74769,6881
2,26,District - Kullu (04),Rural,10-14,39130,19935,19195,12340,1072,572,986,501,485,76
2,26,District - Kullu (04),Rural,15-19,40210,20765,19445,12363,1131,570,1147,552,595,496
2,26,District - Kullu (04),Rural,20-24,40967,20912,20055,12359,1145,594,1927,692,1235,976
2,26,District - Kullu (04),Rural,Adolescent (10-19),79340,40700,38640,24703,2203,1142,2133,1053,1080,572
2,26,District - Kullu (04),Rural,Youth (15-24),81177,41677,39500,24722,2276,1164,3074,1244,1830,1472
2,26,District - Kullu (04),Urban,All Ages,41391,22183,19208,7145,4359,2173,8460,3900,4560,291
2,26,District - Kullu (04),Urban,10-14,3389,1835,1554,694,328,183,164,89,75,2
2,26,District - Kullu (04),Urban,15-19,3607,1992,1615,734,356,183,187,108,79,16
2,26,District - Kullu (04),Urban,20-24,4072,2271,1801,799,370,194,275,150,125,46
2,26,District - Kullu (04),Urban,Adolescent (10-19),6996,3827,3169,1428,684,366,351,197,154,18
2,26,District - Kullu (04),Urban,Youth (15-24),7679,4263,3416,1533,726,377,462,258,204,62
2,27,District - Mandi (05),Total,All Ages,999777,498065,501712,293739,12787,6345,276030,104396,171634,4809
2,27,District - Mandi (05),Total,10-14,93888,48938,44950,29660,1297,675,2057,1047,1010,41
2,27,District - Mandi (05),Total,15-19,92282,47780,44502,28395,1183,596,2127,1008,1119,234
2,27,District - Mandi (05),Total,20-24,89945,44215,45730,27611,1244,603,3341,1344,1997,563
2,27,District - Mandi (05),Total,Adolescent (10-19),186170,96718,89452,58055,2480,1271,4184,2055,2129,275
2,27,District - Mandi (05),Total,Youth (15-24),182227,91995,90232,56006,2427,1199,5468,2352,3116,797
2,27,District - Mandi (05),Rural,All Ages,937140,466050,471090,280580,12359,6114,265552,99655,165897,4713
2,27,District - Mandi (05),Rural,10-14,88934,46208,42726,28524,1255,650,1909,967,942,41
2,27,District - Mandi (05),Rural,15-19,86718,44732,41986,27099,1141,570,1975,925,1050,232
2,27,District - Mandi (05),Rural,20-24,84728,41592,43136,26376,1194,574,3102,1221,1881,556
2,27,District - Mandi (05),Rural,Adolescent (10-19),175652,90940,84712,55623,2396,1220,3884,1892,1992,273
2,27,District - Mandi (05),Rural,Youth (15-24),171446,86324,85122,53475,2335,1144,5077,2146,2931,788
2,27,District - Mandi (05),Urban,All Ages,62637,32015,30622,13159,428,231,10478,4741,5737,96
2,27,District - Mandi (05),Urban,10-14,4954,2730,2224,1136,42,25,148,80,68,0
2,27,District - Mandi (05),Urban,15-19,5564,3048,2516,1296,42,26,152,83,69,2
2,27,District - Mandi (05),Urban,20-24,5217,2623,2594,1235,50,29,239,123,116,7
2,27,District - Mandi (05),Urban,Adolescent (10-19),10518,5778,4740,2432,84,51,300,163,137,2
2,27,District - Mandi (05),Urban,Youth (15-24),10781,5671,5110,2531,92,55,391,206,185,9
2,28,District - Hamirpur (06),Total,All Ages,454768,217070,237698,109256,3044,1531,96677,36515,60162,3475
2,28,District - Hamirpur (06),Total,10-14,40162,21861,18301,10005,301,177,664,329,335,83
2,28,District - Hamirpur (06),Total,15-19,40886,21724,19162,9954,335,185,595,300,295,163
2,28,District - Hamirpur (06),Total,20-24,37659,17117,20542,9420,288,133,785,362,423,321
2,28,District - Hamirpur (06),Total,Adolescent (10-19),81048,43585,37463,19959,636,362,1259,629,630,246
2,28,District - Hamirpur (06),Total,Youth (15-24),78545,38841,39704,19374,623,318,1380,662,718,484
2,28,District - Hamirpur (06),Rural,All Ages,423338,200748,222590,103541,2801,1396,91619,34265,57354,3429
2,28,District - Hamirpur (06),Rural,10-14,37272,20072,17200,9452,258,141,584,287,297,83
2,28,District - Hamirpur (06),Rural,15-19,37506,19778,17728,9350,273,154,487,245,242,158
2,28,District - Hamirpur (06),Rural,20-24,35058,15821,19237,8871,264,126,661,304,357,318
2,28,District - Hamirpur (06),Rural,Adolescent (10-19),74778,39850,34928,18802,531,295,1071,532,539,241
2,28,District - Hamirpur (06),Rural,Youth (15-24),72564,35599,36965,18221,537,280,1148,549,599,476
2,28,District - Hamirpur (06),Urban,All Ages,31430,16322,15108,5715,243,135,5058,2250,2808,46
2,28,District - Hamirpur (06),Urban,10-14,2890,1789,1101,553,43,36,80,42,38,0
2,28,District - Hamirpur (06),Urban,15-19,3380,1946,1434,604,62,31,108,55,53,5
2,28,District - Hamirpur (06),Urban,20-24,2601,1296,1305,549,24,7,124,58,66,3
2,28,District - Hamirpur (06),Urban,Adolescent (10-19),6270,3735,2535,1157,105,67,188,97,91,5
2,28,District - Hamirpur (06),Urban,Youth (15-24),5981,3242,2739,1153,86,38,232,113,119,8
2,29,District - Una (07),Total,All Ages,521173,263692,257481,115491,8601,4445,121458,50411,71047,7052
2,29,District - Una (07),Total,10-14,48681,26613,22068,11483,940,488,1755,848,907,96
2,29,District - Una (07),Total,15-19,49373,26407,22966,11394,932,513,1589,892,697,406
2,29,District - Una (07),Total,20-24,46311,23077,23234,10750,809,400,1879,924,955,852
2,29,District - Una (07),Total,Adolescent (10-19),98054,53020,45034,22877,1872,1001,3344,1740,1604,502
2,29,District - Una (07),Total,Youth (15-24),95684,49484,46200,22144,1741,913,3468,1816,1652,1258
2,29,District - Una (07),Rural,All Ages,476260,240254,236006,108046,8452,4366,111279,45778,65501,6559
2,29,District - Una (07),Rural,10-14,44692,24406,20286,10779,928,482,1439,682,757,86
2,29,District - Una (07),Rural,15-19,45044,23889,21155,10628,912,500,1242,675,567,377
2,29,District - Una (07),Rural,20-24,42057,20818,21239,9976,796,393,1475,717,758,811
2,29,District - Una (07),Rural,Adolescent (10-19),89736,48295,41441,21407,1840,982,2681,1357,1324,463
2,29,District - Una (07),Rural,Youth (15-24),87101,44707,42394,20604,1708,893,2717,1392,1325,1188
2,29,District - Una (07),Urban,All Ages,44913,23438,21475,7445,149,79,10179,4633,5546,493
2,29,District - Una (07),Urban,10-14,3989,2207,1782,704,12,6,316,166,150,10
2,29,District - Una (07),Urban,15-19,4329,2518,1811,766,20,13,347,217,130,29
2,29,District - Una (07),Urban,20-24,4254,2259,1995,774,13,7,404,207,197,41
2,29,District - Una (07),Urban,Adolescent (10-19),8318,4725,3593,1470,32,19,663,383,280,39
2,29,District - Una (07),Urban,Youth (15-24),8583,4777,3806,1540,33,20,751,424,327,70
2,30,District - Bilaspur (08),Total,All Ages,381956,192764,189192,98989,10693,5485,94336,37165,57171,1163
2,30,District - Bilaspur (08),Total,10-14,33496,17808,15688,8871,1026,534,963,507,456,9
2,30,District - Bilaspur (08),Total,15-19,33328,17451,15877,8832,1067,568,409,209,200,35
2,30,District - Bilaspur (08),Total,20-24,34729,17468,17261,9469,1099,578,678,310,368,125
2,30,District - Bilaspur (08),Total,Adolescent (10-19),66824,35259,31565,17703,2093,1102,1372,716,656,44
2,30,District - Bilaspur (08),Total,Youth (15-24),68057,34919,33138,18301,2166,1146,1087,519,568,160
2,30,District - Bilaspur (08),Rural,All Ages,356827,179653,177174,93678,10334,5290,90011,35166,54845,1136
2,30,District - Bilaspur (08),Rural,10-14,31223,16571,14652,8346,983,510,903,482,421,9
2,30,District - Bilaspur (08),Rural,15-19,30969,16133,14836,8318,1022,542,365,181,184,35
2,30,District - Bilaspur (08),Rural,20-24,32474,16293,16181,8952,1076,566,576,258,318,122
2,30,District - Bilaspur (08),Rural,Adolescent (10-19),62192,32704,29488,16664,2005,1052,1268,663,605,44
2,30,District - Bilaspur (08),Rural,Youth (15-24),63443,32426,31017,17270,2098,1108,941,439,502,157
2,30,District - Bilaspur (08),Urban,All Ages,25129,13111,12018,5311,359,195,4325,1999,2326,27
2,30,District - Bilaspur (08),Urban,10-14,2273,1237,1036,525,43,24,60,25,35,0
2,30,District - Bilaspur (08),Urban,15-19,2359,1318,1041,514,45,26,44,28,16,0
2,30,District - Bilaspur (08),Urban,20-24,2255,1175,1080,517,23,12,102,52,50,3
2,30,District - Bilaspur (08),Urban,Adolescent (10-19),4632,2555,2077,1039,88,50,104,53,51,0
2,30,District - Bilaspur (08),Urban,Youth (15-24),4614,2493,2121,1031,68,38,146,80,66,3
2,31,District - Solan (09),Total,All Ages,580320,308754,271566,164536,25645,13351,151742,64382,87360,5764
2,31,District - Solan (09),Total,10-14,53078,28311,24767,16073,2576,1379,1873,975,898,72
2,31,District - Solan (09),Total,15-19,53921,29253,24668,15835,2491,1313,1905,1045,860,326
2,31,District - Solan (09),Total,20-24,60096,33160,26936,16668,2619,1326,3073,1492,1581,738
2,31,District - Solan (09),Total,Adolescent (10-19),106999,57564,49435,31908,5067,2692,3778,2020,1758,398
2,31,District - Solan (09),Total,Youth (15-24),114017,62413,51604,32503,5110,2639,4978,2537,2441,1064
2,31,District - Solan (09),Rural,All Ages,478173,249736,228437,148800,24075,12469,132099,54525,77574,5594
2,31,District - Solan (09),Rural,10-14,44988,23755,21233,14659,2412,1289,1461,752,709,72
2,31,District - Solan (09),Rural,15-19,44820,23710,21110,14284,2328,1224,1374,696,678,314
2,31,District - Solan (09),Rural,20-24,47488,25219,22269,14810,2394,1188,2285,1028,1257,717
2,31,District - Solan (09),Rural,Adolescent (10-19),89808,47465,42343,28943,4740,2513,2835,1448,1387,386
2,31,District - Solan (09),Rural,Youth (15-24),92308,48929,43379,29094,4722,2412,3659,1724,1935,1031
2,31,District - Solan (09),Urban,All Ages,102147,59018,43129,15736,1570,882,19643,9857,9786,170
2,31,District - Solan (09),Urban,10-14,8090,4556,3534,1414,164,90,412,223,189,0
2,31,District - Solan (09),Urban,15-19,9101,5543,3558,1551,163,89,531,349,182,12
2,31,District - Solan (09),Urban,20-24,12608,7941,4667,1858,225,138,788,464,324,21
2,31,District - Solan (09),Urban,Adolescent (10-19),17191,10099,7092,2965,327,179,943,572,371,12
2,31,District - Solan (09),Urban,Youth (15-24),21709,13484,8225,3409,388,227,1319,813,506,33
2,32,District - Sirmaur (10),Total,All Ages,529855,276289,253566,160745,11262,5912,167210,70672,96538,5953
2,32,District - Sirmaur (10),Total,10-14,55407,28822,26585,18282,1290,707,1642,751,891,89
2,32,District - Sirmaur (10),Total,15-19,54407,28555,25852,16763,1163,605,1595,701,894,418
2,32,District - Sirmaur (10),Total,20-24,53262,27702,25560,15894,1090,568,3020,1075,1945,880
2,32,District - Sirmaur (10),Total,Adolescent (10-19),109814,57377,52437,35045,2453,1312,3237,1452,1785,507
2,32,District - Sirmaur (10),Total,Youth (15-24),107669,56257,51412,32657,2253,1173,4615,1776,2839,1298
2,32,District - Sirmaur (10),Rural,All Ages,472690,246175,226515,149719,10915,5702,156254,65564,90690,5751
2,32,District - Sirmaur (10),Rural,10-14,50383,26076,24307,17169,1256,684,1497,669,828,87
2,32,District - Sirmaur (10),Rural,15-19,49193,25661,23532,15645,1131,587,1434,594,840,400
2,32,District - Sirmaur (10),Rural,20-24,47838,24905,22933,14761,1051,544,2749,939,1810,859
2,32,District - Sirmaur (10),Rural,Adolescent (10-19),99576,51737,47839,32814,2387,1271,2931,1263,1668,487
2,32,District - Sirmaur (10),Rural,Youth (15-24),97031,50566,46465,30406,2182,1131,4183,1533,2650,1259
2,32,District - Sirmaur (10),Urban,All Ages,57165,30114,27051,11026,347,210,10956,5108,5848,202
2,32,District - Sirmaur (10),Urban,10-14,5024,2746,2278,1113,34,23,145,82,63,2
2,32,District - Sirmaur (10),Urban,15-19,5214,2894,2320,1118,32,18,161,107,54,18
2,32,District - Sirmaur (10),Urban,20-24,5424,2797,2627,1133,39,24,271,136,135,21
2,32,District - Sirmaur (10),Urban,Adolescent (10-19),10238,5640,4598,2231,66,41,306,189,117,20
2,32,District - Sirmaur (10),Urban,Youth (15-24),10638,5691,4947,2251,71,42,432,243,189,39
2,33,District - Shimla (11),Total,All Ages,814010,425039,388971,215777,8755,4554,201368,82193,119175,17486
2,33,District - Shimla (11),Total,10-14,71938,37625,34313,21484,1012,577,1714,842,872,249
2,33,District - Shimla (11),Total,15-19,74252,39067,35185,21321,1121,563,2039,1063,976,1210
2,33,District - Shimla (11),Total,20-24,82123,42625,39498,22443,1063,516,4081,1695,2386,2611
2,33,District - Shimla (11),Total,Adolescent (10-19),146190,76692,69498,42805,2133,1140,3753,1905,1848,1459
2,33,District - Shimla (11),Total,Youth (15-24),156375,81692,74683,43764,2184,1079,6120,2758,3362,3821
2,33,District - Shimla (11),Rural,All Ages,612659,314295,298364,179235,5399,2795,171947,67833,104114,16787
2,33,District - Shimla (11),Rural,10-14,55012,28205,26807,18192,685,373,1370,668,702,248
2,33,District - Shimla (11),Rural,15-19,54284,28040,26244,17468,561,297,1524,727,797,1172
2,33,District - Shimla (11),Rural,20-24,59198,30255,28943,18161,533,260,3061,1137,1924,2496
2,33,District - Shimla (11),Rural,Adolescent (10-19),109296,56245,53051,35660,1246,670,2894,1395,1499,1420
2,33,District - Shimla (11),Rural,Youth (15-24),113482,58295,55187,35629,1094,557,4585,1864,2721,3668
2,33,District - Shimla (11),Urban,All Ages,201351,110744,90607,36542,3356,1759,29421,14360,15061,699
2,33,District - Shimla (11),Urban,10-14,16926,9420,7506,3292,327,204,344,174,170,1
2,33,District - Shimla (11),Urban,15-19,19968,11027,8941,3853,560,266,515,336,179,38
2,33,District - Shimla (11),Urban,20-24,22925,12370,10555,4282,530,256,1020,558,462,115
2,33,District - Shimla (11),Urban,Adolescent (10-19),36894,20447,16447,7145,887,470,859,510,349,39
2,33,District - Shimla (11),Urban,Youth (15-24),42893,23397,19496,8135,1090,522,1535,894,641,153
2,34,District - Kinnaur (12),Total,All Ages,84121,46249,37872,14750,48746,23609,23422,9552,13870,1759
2,34,District - Kinnaur (12),Total,10-14,6696,3276,3420,1495,4008,1927,109,51,58,29
2,34,District - Kinnaur (12),Total,15-19,6171,3236,2935,1330,3579,1733,211,125,86,147
2,34,District - Kinnaur (12),Total,20-24,8525,5147,3378,1401,3881,1920,642,397,245,296
2,34,District - Kinnaur (12),Total,Adolescent (10-19),12867,6512,6355,2825,7587,3660,320,176,144,176
2,34,District - Kinnaur (12),Total,Youth (15-24),14696,8383,6313,2731,7460,3653,853,522,331,443
2,34,District - Kinnaur (12),Rural,All Ages,84121,46249,37872,14750,48746,23609,23422,9552,13870,1759
2,34,District - Kinnaur (12),Rural,10-14,6696,3276,3420,1495,4008,1927,109,51,58,29
2,34,District - Kinnaur (12),Rural,15-19,6171,3236,2935,1330,3579,1733,211,125,86,147
2,34,District - Kinnaur (12),Rural,20-24,8525,5147,3378,1401,3881,1920,642,397,245,296
2,34,District - Kinnaur (12),Rural,Adolescent (10-19),12867,6512,6355,2825,7587,3660,320,176,144,176
2,34,District - Kinnaur (12),Rural,Youth (15-24),14696,8383,6313,2731,7460,3653,853,522,331,443
2,34,District - Kinnaur (12),Urban,All Ages,0,0,0,0,0,0,0,0,0,0
2,34,District - Kinnaur (12),Urban,10-14,0,0,0,0,0,0,0,0,0,0
2,34,District - Kinnaur (12),Urban,15-19,0,0,0,0,0,0,0,0,0,0
2,34,District - Kinnaur (12),Urban,20-24,0,0,0,0,0,0,0,0,0,0
2,34,District - Kinnaur (12),Urban,Adolescent (10-19),0,0,0,0,0,0,0,0,0,0
2,34,District - Kinnaur (12),Urban,Youth (15-24),0,0,0,0,0,0,0,0,0,0
3,0,State - PUNJAB (03),Total,All Ages,27743338,14639465,13103873,8860179,0,0,9036201,4203409,4832792,1168021
3,0,State - PUNJAB (03),Total,10-14,2583402,1445530,1137872,952527,0,0,182800,96306,86494,15999
3,0,State - PUNJAB (03),Total,15-19,2817683,1570180,1247503,995782,0,0,243692,133100,110592,95226
3,0,State - PUNJAB (03),Total,20-24,2776636,1465531,1311105,909405,0,0,329468,157025,172443,151421
3,0,State - PUNJAB (03),Total,Adolescent (10-19),5401085,3015710,2385375,1948309,0,0,426492,229406,197086,111225
3,0,State - PUNJAB (03),Total,Youth (15-24),5594319,3035711,2558608,1905187,0,0,573160,290125,283035,246647
3,0,State - PUNJAB (03),Rural,All Ages,17344192,9093476,8250716,6496986,0,0,6346535,2934669,3411866,1078849
3,0,State - PUNJAB (03),Rural,10-14,1668828,931366,737462,713303,0,0,113178,59042,54136,14952
3,0,State - PUNJAB (03),Rural,15-19,1814427,1003831,810596,731302,0,0,158980,84975,74005,88936
3,0,State - PUNJAB (03),Rural,20-24,1706833,888739,818094,649733,0,0,220918,103744,117174,140667
3,0,State - PUNJAB (03),Rural,Adolescent (10-19),3483255,1935197,1548058,1444605,0,0,272158,144017,128141,103888
3,0,State - PUNJAB (03),Rural,Youth (15-24),3521260,1892570,1628690,1381035,0,0,379898,188719,191179,229603
3,0,State - PUNJAB (03),Urban,All Ages,10399146,5545989,4853157,2363193,0,0,2689666,1268740,1420926,89172
3,0,State - PUNJAB (03),Urban,10-14,914574,514164,400410,239224,0,0,69622,37264,32358,1047
3,0,State - PUNJAB (03),Urban,15-19,1003256,566349,436907,264480,0,0,84712,48125,36587,6290
3,0,State - PUNJAB (03),Urban,20-24,1069803,576792,493011,259672,0,0,108550,53281,55269,10754
3,0,State - PUNJAB (03),Urban,Adolescent (10-19),1917830,1080513,837317,503704,0,0,154334,85389,68945,7337
3,0,State - PUNJAB (03),Urban,Youth (15-24),2073059,1143141,929918,524152,0,0,193262,101406,91856,17044
3,35,District - Gurdaspur (01),Total,All Ages,2298323,1212617,1085706,580576,0,0,663604,304957,358647,70767
3,35,District - Gurdaspur (01),Total,10-14,216513,122057,94456,61417,0,0,10320,5492,4828,721
3,35,District - Gurdaspur (01),Total,15-19,238781,132502,106279,65935,0,0,13755,7224,6531,4418
3,35,District - Gurdaspur (01),Total,20-24,228261,118828,109433,60115,0,0,18839,8722,10117,8488
3,35,District - Gurdaspur (01),Total,Adolescent (10-19),455294,254559,200735,127352,0,0,24075,12716,11359,5139
3,35,District - Gurdaspur (01),Total,Youth (15-24),467042,251330,215712,126050,0,0,32594,15946,16648,12906
3,35,District - Gurdaspur (01),Rural,All Ages,1639004,855784,783220,435930,0,0,522467,238932,283535,65654
3,35,District - Gurdaspur (01),Rural,10-14,161673,90702,70971,47535,0,0,8075,4242,3833,676
3,35,District - Gurdaspur (01),Rural,15-19,176551,97722,78829,49763,0,0,10799,5542,5257,4208
3,35,District - Gurdaspur (01),Rural,20-24,159557,81323,78234,44173,0,0,14944,6648,8296,7977
3,35,District - Gurdaspur (01),Rural,Adolescent (10-19),338224,188424,149800,97298,0,0,18874,9784,9090,4884
3,35,District - Gurdaspur (01),Rural,Youth (15-24),336108,179045,157063,93936,0,0,25743,12190,13553,12185
3,35,District - Gurdaspur (01),Urban,All Ages,659319,356833,302486,144646,0,0,141137,66025,75112,5113
3,35,District - Gurdaspur (01),Urban,10-14,54840,31355,23485,13882,0,0,2245,1250,995,45
3,35,District - Gurdaspur (01),Urban,15-19,62230,34780,27450,16172,0,0,2956,1682,1274,210
3,35,District - Gurdaspur (01),Urban,20-24,68704,37505,31199,15942,0,0,3895,2074,1821,511
3,35,District - Gurdaspur (01),Urban,Adolescent (10-19),117070,66135,50935,30054,0,0,5201,2932,2269,255
3,35,District - Gurdaspur (01),Urban,Youth (15-24),130934,72285,58649,32114,0,0,6851,3756,3095,721
3,36,District - Kapurthala (02),Total,All Ages,815168,426311,388857,276707,0,0,238601,110057,128544,32888
3,36,District - Kapurthala (02),Total,10-14,76090,42973,33117,29106,0,0,4109,2229,1880,486
3,36,District - Kapurthala (02),Total,15-19,82963,46375,36588,30764,0,0,4996,2788,2208,2758
3,36,District - Kapurthala (02),Total,20-24,78513,40779,37734,28155,0,0,6949,3387,3562,4034
3,36,District - Kapurthala (02),Total,Adolescent (10-19),159053,89348,69705,59870,0,0,9105,5017,4088,3244
3,36,District - Kapurthala (02),Total,Youth (15-24),161476,87154,74322,58919,0,0,11945,6175,5770,6792
3,36,District - Kapurthala (02),Rural,All Ages,532706,275932,256774,212013,0,0,171930,79013,92917,30070
3,36,District - Kapurthala (02),Rural,10-14,51232,28808,22424,22838,0,0,2558,1378,1180,439
3,36,District - Kapurthala (02),Rural,15-19,55578,30875,24703,23642,0,0,3252,1778,1474,2554
3,36,District - Kapurthala (02),Rural,20-24,50596,25781,24815,21108,0,0,4588,2224,2364,3703
3,36,District - Kapurthala (02),Rural,Adolescent (10-19),106810,59683,47127,46480,0,0,5810,3156,2654,2993
3,36,District - Kapurthala (02),Rural,Youth (15-24),106174,56656,49518,44750,0,0,7840,4002,3838,6257
3,36,District - Kapurthala (02),Urban,All Ages,282462,150379,132083,64694,0,0,66671,31044,35627,2818
3,36,District - Kapurthala (02),Urban,10-14,24858,14165,10693,6268,0,0,1551,851,700,47
3,36,District - Kapurthala (02),Urban,15-19,27385,15500,11885,7122,0,0,1744,1010,734,204
3,36,District - Kapurthala (02),Urban,20-24,27917,14998,12919,7047,0,0,2361,1163,1198,331
3,36,District - Kapurthala (02),Urban,Adolescent (10-19),52243,29665,22578,13390,0,0,3295,1861,1434,251
3,36,District - Kapurthala (02),Urban,Youth (15-24),55302,30498,24804,14169,0,0,4105,2173,1932,535
3,37,District - Jalandhar (03),Total,All Ages,2193590,1145211,1048379,854444,0,0,571053,262630,308423,52371
3,37,District - Jalandhar (03),Total,10-14,193885,108015,85870,82627,0,0,10278,5525,4753,701
3,37,District - Jalandhar (03),Total,15-19,214709,118410,96299,91874,0,0,12436,7122,5314,3992
3,37,District - Jalandhar (03),Total,20-24,219034,115162,103872,89526,0,0,16869,8441,8428,6200
3,37,District - Jalandhar (03),Total,Adolescent (10-19),408594,226425,182169,174501,0,0,22714,12647,10067,4693
3,37,District - Jalandhar (03),Total,Youth (15-24),433743,233572,200171,181400,0,0,29305,15563,13742,10192
3,37,District - Jalandhar (03),Rural,All Ages,1032419,528790,503629,515342,0,0,304285,135923,168362,46344
3,37,District - Jalandhar (03),Rural,10-14,95389,52849,42540,51532,0,0,4140,2254,1886,582
3,37,District - Jalandhar (03),Rural,15-19,105319,57080,48239,56252,0,0,5073,2809,2264,3589
3,37,District - Jalandhar (03),Rural,20-24,99802,50875,48927,52338,0,0,7106,3462,3644,5495
3,37,District - Jalandhar (03),Rural,Adolescent (10-19),200708,109929,90779,107784,0,0,9213,5063,4150,4171
3,37,District - Jalandhar (03),Rural,Youth (15-24),205121,107955,97166,108590,0,0,12179,6271,5908,9084
3,37,District - Jalandhar (03),Urban,All Ages,1161171,616421,544750,339102,0,0,266768,126707,140061,6027
3,37,District - Jalandhar (03),Urban,10-14,98496,55166,43330,31095,0,0,6138,3271,2867,119
3,37,District - Jalandhar (03),Urban,15-19,109390,61330,48060,35622,0,0,7363,4313,3050,403
3,37,District - Jalandhar (03),Urban,20-24,119232,64287,54945,37188,0,0,9763,4979,4784,705
3,37,District - Jalandhar (03),Urban,Adolescent (10-19),207886,116496,91390,66717,0,0,13501,7584,5917,522
3,37,District - Jalandhar (03),Urban,Youth (15-24),228622,125617,103005,72810,0,0,17126,9292,7834,1108
3,38,District - Hoshiarpur (04),Total,All Ages,1586625,809057,777568,557504,0,0,386926,171130,215796,49487
3,38,District - Hoshiarpur (04),Total,10-14,143934,79682,64252,54496,0,0,7296,3783,3513,801
3,38,District - Hoshiarpur (04),Total,15-19,159379,86586,72793,61346,0,0,8054,4346,3708,3388
3,38,District - Hoshiarpur (04),Total,20-24,150142,75478,74664,56540,0,0,8727,4277,4450,5683
3,38,District - Hoshiarpur (04),Total,Adolescent (10-19),303313,166268,137045,115842,0,0,15350,8129,7221,4189
3,38,District - Hoshiarpur (04),Total,Youth (15-24),309521,162064,147457,117886,0,0,16781,8623,8158,9071
3,38,District - Hoshiarpur (04),Rural,All Ages,1251656,634470,617186,465037,0,0,315821,137838,177983,46941
3,38,District - Hoshiarpur (04),Rural,10-14,115955,64194,51761,46040,0,0,5680,2931,2749,770
3,38,District - Hoshiarpur (04),Rural,15-19,127690,68826,58864,51715,0,0,6188,3249,2939,3222
3,38,District - Hoshiarpur (04),Rural,20-24,116900,58054,58846,46774,0,0,6472,3133,3339,5397
3,38,District - Hoshiarpur (04),Rural,Adolescent (10-19),243645,133020,110625,97755,0,0,11868,6180,5688,3992
3,38,District - Hoshiarpur (04),Rural,Youth (15-24),244590,126880,117710,98489,0,0,12660,6382,6278,8619
3,38,District - Hoshiarpur (04),Urban,All Ages,334969,174587,160382,92467,0,0,71105,33292,37813,2546
3,38,District - Hoshiarpur (04),Urban,10-14,27979,15488,12491,8456,0,0,1616,852,764,31
3,38,District - Hoshiarpur (04),Urban,15-19,31689,17760,13929,9631,0,0,1866,1097,769,166
3,38,District - Hoshiarpur (04),Urban,20-24,33242,17424,15818,9766,0,0,2255,1144,1111,286
3,38,District - Hoshiarpur (04),Urban,Adolescent (10-19),59668,33248,26420,18087,0,0,3482,1949,1533,197
3,38,District - Hoshiarpur (04),Urban,Youth (15-24),64931,35184,29747,19397,0,0,4121,2241,1880,452
3,39,District - Shahid Bhagat Singh Nagar (05),Total,All Ages,612310,313291,299019,260284,0,0,173851,74136,99715,16556
3,39,District - Shahid Bhagat Singh Nagar (05),Total,10-14,54662,30288,24374,25052,0,0,2648,1360,1288,168
3,39,District - Shahid Bhagat Singh Nagar (05),Total,15-19,61179,33081,28098,28300,0,0,2776,1568,1208,1013
3,39,District - Shahid Bhagat Singh Nagar (05),Total,20-24,59848,30444,29404,26978,0,0,3614,1789,1825,1982
3,39,District - Shahid Bhagat Singh Nagar (05),Total,Adolescent (10-19),115841,63369,52472,53352,0,0,5424,2928,2496,1181
3,39,District - Shahid Bhagat Singh Nagar (05),Total,Youth (15-24),121027,63525,57502,55278,0,0,6390,3357,3033,2995
3,39,District - Shahid Bhagat Singh Nagar (05),Rural,All Ages,486894,248118,238776,212889,0,0,141299,59506,81793,15191
3,39,District - Shahid Bhagat Singh Nagar (05),Rural,10-14,43367,24009,19358,20518,0,0,1760,893,867,160
3,39,District - Shahid Bhagat Singh Nagar (05),Rural,15-19,48816,26249,22567,23225,0,0,1878,1034,844,917
3,39,District - Shahid Bhagat Singh Nagar (05),Rural,20-24,47144,23851,23293,21928,0,0,2518,1259,1259,1837
3,39,District - Shahid Bhagat Singh Nagar (05),Rural,Adolescent (10-19),92183,50258,41925,43743,0,0,3638,1927,1711,1077
3,39,District - Shahid Bhagat Singh Nagar (05),Rural,Youth (15-24),95960,50100,45860,45153,0,0,4396,2293,2103,2754
3,39,District - Shahid Bhagat Singh Nagar (05),Urban,All Ages,125416,65173,60243,47395,0,0,32552,14630,17922,1365
3,39,District - Shahid Bhagat Singh Nagar (05),Urban,10-14,11295,6279,5016,4534,0,0,888,467,421,8
3,39,District - Shahid Bhagat Singh Nagar (05),Urban,15-19,12363,6832,5531,5075,0,0,898,534,364,96
3,39,District - Shahid Bhagat Singh Nagar (05),Urban,20-24,12704,6593,6111,5050,0,0,1096,530,566,145
3,39,District - Shahid Bhagat Singh Nagar (05),Urban,Adolescent (10-19),23658,13111,10547,9609,0,0,1786,1001,785,104
3,39,District - Shahid Bhagat Singh Nagar (05),Urban,Youth (15-24),25067,13425,11642,10125,0,0,1994,1064,930,241
3,40,District - Fatehgarh Sahib (06),Total,All Ages,600163,320795,279368,192493,0,0,174130,82099,92031,17633
3,40,District - Fatehgarh Sahib (06),Total,10-14,52731,29984,22747,19414,0,0,2726,1463,1263,128
3,40,District - Fatehgarh Sahib (06),Total,15-19,59446,33707,25739,21398,0,0,3227,1940,1287,1045
3,40,District - Fatehgarh Sahib (06),Total,20-24,61146,32752,28394,20470,0,0,4739,2470,2269,2058
3,40,District - Fatehgarh Sahib (06),Total,Adolescent (10-19),112177,63691,48486,40812,0,0,5953,3403,2550,1173
3,40,District - Fatehgarh Sahib (06),Total,Youth (15-24),120592,66459,54133,41868,0,0,7966,4410,3556,3103
3,40,District - Fatehgarh Sahib (06),Rural,All Ages,414681,220050,194631,154570,0,0,126341,59128,67213,16390
3,40,District - Fatehgarh Sahib (06),Rural,10-14,36436,20762,15674,15694,0,0,1601,889,712,121
3,40,District - Fatehgarh Sahib (06),Rural,15-19,41627,23311,18316,17167,0,0,1897,1117,780,968
3,40,District - Fatehgarh Sahib (06),Rural,20-24,41524,21808,19716,16221,0,0,2765,1415,1350,1903
3,40,District - Fatehgarh Sahib (06),Rural,Adolescent (10-19),78063,44073,33990,32861,0,0,3498,2006,1492,1089
3,40,District - Fatehgarh Sahib (06),Rural,Youth (15-24),83151,45119,38032,33388,0,0,4662,2532,2130,2871
3,40,District - Fatehgarh Sahib (06),Urban,All Ages,185482,100745,84737,37923,0,0,47789,22971,24818,1243
3,40,District - Fatehgarh Sahib (06),Urban,10-14,16295,9222,7073,3720,0,0,1125,574,551,7
3,40,District - Fatehgarh Sahib (06),Urban,15-19,17819,10396,7423,4231,0,0,1330,823,507,77
3,40,District - Fatehgarh Sahib (06),Urban,20-24,19622,10944,8678,4249,0,0,1974,1055,919,155
3,40,District - Fatehgarh Sahib (06),Urban,Adolescent (10-19),34114,19618,14496,7951,0,0,2455,1397,1058,84
3,40,District - Fatehgarh Sahib (06),Urban,Youth (15-24),37441,21340,16101,8480,0,0,3304,1878,1426,232
3,41,District - Ludhiana (07),Total,All Ages,3498739,1867816,1630923,923358,0,0,938514,439468,499046,79561
3,41,District - Ludhiana (07),Total,10-14,317941,177002,140939,95156,0,0,22081,11577,10504,850
3,41,District - Ludhiana (07),Total,15-19,342041,193736,148305,103051,0,0,24835,13937,10898,5355
3,41,District - Ludhiana (07),Total,20-24,351563,190246,161317,98052,0,0,33294,15881,17413,9501
3,41,District - Ludhiana (07),Total,Adolescent (10-19),659982,370738,289244,198207,0,0,46916,25514,21402,6205
3,41,District - Ludhiana (07),Total,Youth (15-24),693604,383982,309622,201103,0,0,58129,29818,28311,14856
3,41,District - Ludhiana (07),Rural,All Ages,1429031,753444,675587,559471,0,0,426962,196148,230814,69073
3,41,District - Ludhiana (07),Rural,10-14,130856,72492,58364,58780,0,0,6743,3596,3147,733
3,41,District - Ludhiana (07),Rural,15-19,143483,79427,64056,62295,0,0,8440,4617,3823,4715
3,41,District - Ludhiana (07),Rural,20-24,140009,74181,65828,57141,0,0,11914,5722,6192,8322
3,41,District - Ludhiana (07),Rural,Adolescent (10-19),274339,151919,122420,121075,0,0,15183,8213,6970,5448
3,41,District - Ludhiana (07),Rural,Youth (15-24),283492,153608,129884,119436,0,0,20354,10339,10015,13037
3,41,District - Ludhiana (07),Urban,All Ages,2069708,1114372,955336,363887,0,0,511552,243320,268232,10488
3,41,District - Ludhiana (07),Urban,10-14,187085,104510,82575,36376,0,0,15338,7981,7357,117
3,41,District - Ludhiana (07),Urban,15-19,198558,114309,84249,40756,0,0,16395,9320,7075,640
3,41,District - Ludhiana (07),Urban,20-24,211554,116065,95489,40911,0,0,21380,10159,11221,1179
3,41,District - Ludhiana (07),Urban,Adolescent (10-19),385643,218819,166824,77132,0,0,31733,17301,14432,757
3,41,District - Ludhiana (07),Urban,Youth (15-24),410112,230374,179738,81667,0,0,37775,19479,18296,1819
3,42,District - Moga (08),Total,All Ages,995746,525920,469826,363417,0,0,367857,177371,190486,64215
3,42,District - Moga (08),Total,10-14,92877,51215,41662,40600,0,0,8245,4465,3780,929
3,42,District - Moga (08),Total,15-19,99887,55421,44466,40307,0,0,10943,6365,4578,5255
3,42,District - Moga (08),Total,20-24,98637,52954,45683,36306,0,0,14601,7543,7058,8753
3,42,District - Moga (08),Total,Adolescent (10-19),192764,106636,86128,80907,0,0,19188,10830,8358,6184
3,42,District - Moga (08),Total,Youth (15-24),198524,108375,90149,76613,0,0,25544,13908,11636,14008
3,42,District - Moga (08),Rural,All Ages,768500,405704,362796,307098,0,0,300497,144979,155518,60830
3,42,District - Moga (08),Rural,10-14,72307,39688,32619,34352,0,0,6051,3289,2762,886
3,42,District - Moga (08),Rural,15-19,77829,43069,34760,33834,0,0,8365,4884,3481,4972
3,42,District - Moga (08),Rural,20-24,75554,40517,35037,30314,0,0,11555,5993,5562,8321
3,42,District - Moga (08),Rural,Adolescent (10-19),150136,82757,67379,68186,0,0,14416,8173,6243,5858
3,42,District - Moga (08),Rural,Youth (15-24),153383,83586,69797,64148,0,0,19920,10877,9043,13293
3,42,District - Moga (08),Urban,All Ages,227246,120216,107030,56319,0,0,67360,32392,34968,3385
3,42,District - Moga (08),Urban,10-14,20570,11527,9043,6248,0,0,2194,1176,1018,43
3,42,District - Moga (08),Urban,15-19,22058,12352,9706,6473,0,0,2578,1481,1097,283
3,42,District - Moga (08),Urban,20-24,23083,12437,10646,5992,0,0,3046,1550,1496,432
3,42,District - Moga (08),Urban,Adolescent (10-19),42628,23879,18749,12721,0,0,4772,2657,2115,326
3,42,District - Moga (08),Urban,Youth (15-24),45141,24789,20352,12465,0,0,5624,3031,2593,715
3,43,District - Firozpur (09),Total,All Ages,2029074,1071637,957437,855726,0,0,801563,364567,436996,153627
3,43,District - Firozpur (09),Total,10-14,206136,113794,92342,100694,0,0,18536,9485,9051,2373
3,43,District - Firozpur (09),Total,15-19,218494,119774,98720,99408,0,0,26841,13359,13482,14486
3,43,District - Firozpur (09),Total,20-24,206863,108332,98531,86126,0,0,36262,15247,21015,21481
3,43,District - Firozpur (09),Total,Adolescent (10-19),424630,233568,191062,200102,0,0,45377,22844,22533,16859
3,43,District - Firozpur (09),Total,Youth (15-24),425357,228106,197251,185534,0,0,63103,28606,34497,35967
3,43,District - Firozpur (09),Rural,All Ages,1476518,776208,700310,709922,0,0,635698,286746,348952,147827
3,43,District - Firozpur (09),Rural,10-14,155251,85426,69825,84410,0,0,13336,6666,6670,2309
3,43,District - Firozpur (09),Rural,15-19,162467,88572,73895,82117,0,0,20130,9647,10483,13974
3,43,District - Firozpur (09),Rural,20-24,148357,76854,71503,70089,0,0,28314,11434,16880,20718
3,43,District - Firozpur (09),Rural,Adolescent (10-19),317718,173998,143720,166527,0,0,33466,16313,17153,16283
3,43,District - Firozpur (09),Rural,Youth (15-24),310824,165426,145398,152206,0,0,48444,21081,27363,34692
3,43,District - Firozpur (09),Urban,All Ages,552556,295429,257127,145804,0,0,165865,77821,88044,5800
3,43,District - Firozpur (09),Urban,10-14,50885,28368,22517,16284,0,0,5200,2819,2381,64
3,43,District - Firozpur (09),Urban,15-19,56027,31202,24825,17291,0,0,6711,3712,2999,512
3,43,District - Firozpur (09),Urban,20-24,58506,31478,27028,16037,0,0,7948,3813,4135,763
3,43,District - Firozpur (09),Urban,Adolescent (10-19),106912,59570,47342,33575,0,0,11911,6531,5380,576
3,43,District - Firozpur (09),Urban,Youth (15-24),114533,62680,51853,33328,0,0,14659,7525,7134,1275
3,44,District - Muktsar (10),Total,All Ages,901896,475622,426274,381554,0,0,377048,175221,201827,85122
3,44,District - Muktsar (10),Total,10-14,85966,47677,38289,43173,0,0,9061,4781,4280,1287
3,44,District - Muktsar (10),Total,15-19,91197,51375,39822,41363,0,0,12935,7208,5727,7994
3,44,District - Muktsar (10),Total,20-24,88213,46755,41458,37376,0,0,17174,8218,8956,11331
3,44,District - Muktsar (10),Total,Adolescent (10-19),177163,99052,78111,84536,0,0,21996,11989,10007,9281
3,44,District - Muktsar (10),Total,Youth (15-24),179410,98130,81280,78739,0,0,30109,15426,14683,19325
3,44,District - Muktsar (10),Rural,All Ages,649705,342202,307503,295179,0,0,294544,137269,157275,80798
3,44,District - Muktsar (10),Rural,10-14,62648,34721,27927,33858,0,0,6682,3500,3182,1238
3,44,District - Muktsar (10),Rural,15-19,65896,37115,28781,31764,0,0,9892,5512,4380,7580
3,44,District - Muktsar (10),Rural,20-24,62383,32735,29648,27991,0,0,13307,6375,6932,10681
3,44,District - Muktsar (10),Rural,Adolescent (10-19),128544,71836,56708,65622,0,0,16574,9012,7562,8818
3,44,District - Muktsar (10),Rural,Youth (15-24),128279,69850,58429,59755,0,0,23199,11887,11312,18261
3,44,District - Muktsar (10),Urban,All Ages,252191,133420,118771,86375,0,0,82504,37952,44552,4324
3,44,District - Muktsar (10),Urban,10-14,23318,12956,10362,9315,0,0,2379,1281,1098,49
3,44,District - Muktsar (10),Urban,15-19,25301,14260,11041,9599,0,0,3043,1696,1347,414
3,44,District - Muktsar (10),Urban,20-24,25830,14020,11810,9385,0,0,3867,1843,2024,650
3,44,District - Muktsar (10),Urban,Adolescent (10-19),48619,27216,21403,18914,0,0,5422,2977,2445,463
3,44,District - Muktsar (10),Urban,Youth (15-24),51131,28280,22851,18984,0,0,6910,3539,3371,1064
3,45,District - Faridkot (11),Total,All Ages,617508,326671,290837,240328,0,0,236223,110904,125319,41066
3,45,District - Faridkot (11),Total,10-14,57049,31721,25328,26357,0,0,4578,2473,2105,504
3,45,District - Faridkot (11),Total,15-19,62545,34889,27656,27082,0,0,6529,3691,2838,3719
3,45,District - Faridkot (11),Total,20-24,61641,32820,28821,24574,0,0,9397,4531,4866,5724
3,45,District - Faridkot (11),Total,Adolescent (10-19),119594,66610,52984,53439,0,0,11107,6164,4943,4223
3,45,District - Faridkot (11),Total,Youth (15-24),124186,67709,56477,51656,0,0,15926,8222,7704,9443
3,45,District - Faridkot (11),Rural,All Ages,400457,210782,189675,171199,0,0,170658,80482,90176,38432
3,45,District - Faridkot (11),Rural,10-14,37707,20965,16742,18933,0,0,2932,1588,1344,475
3,45,District - Faridkot (11),Rural,15-19,41264,23038,18226,19183,0,0,4382,2506,1876,3514
3,45,District - Faridkot (11),Rural,20-24,39002,20597,18405,17013,0,0,6639,3171,3468,5393
3,45,District - Faridkot (11),Rural,Adolescent (10-19),78971,44003,34968,38116,0,0,7314,4094,3220,3989
3,45,District - Faridkot (11),Rural,Youth (15-24),80266,43635,36631,36196,0,0,11021,5677,5344,8907
3,45,District - Faridkot (11),Urban,All Ages,217051,115889,101162,69129,0,0,65565,30422,35143,2634
3,45,District - Faridkot (11),Urban,10-14,19342,10756,8586,7424,0,0,1646,885,761,29
3,45,District - Faridkot (11),Urban,15-19,21281,11851,9430,7899,0,0,2147,1185,962,205
3,45,District - Faridkot (11),Urban,20-24,22639,12223,10416,7561,0,0,2758,1360,1398,331
3,45,District - Faridkot (11),Urban,Adolescent (10-19),40623,22607,18016,15323,0,0,3793,2070,1723,234
3,45,District - Faridkot (11),Urban,Youth (15-24),43920,24074,19846,15460,0,0,4905,2545,2360,536
3,46,District - Bathinda (12),Total,All Ages,1388525,743197,645328,450473,0,0,543657,254936,288721,91364
3,46,District - Bathinda (12),Total,10-14,124640,69858,54782,49129,0,0,10338,5502,4836,1237
3,46,District - Bathinda (12),Total,15-19,137819,77637,60182,50887,0,0,15553,8837,6716,8160
3,46,District - Bathinda (12),Total,20-24,145158,79265,65893,46869,0,0,22603,11321,11282,12548
3,46,District - Bathinda (12),Total,Adolescent (10-19),262459,147495,114964,100016,0,0,25891,14339,11552,9397
3,46,District - Bathinda (12),Total,Youth (15-24),282977,156902,126075,97756,0,0,38156,20158,17998,20708
3,46,District - Bathinda (12),Rural,All Ages,889308,474484,414824,321533,0,0,396116,186952,209164,84907
3,46,District - Bathinda (12),Rural,10-14,81739,45604,36135,35702,0,0,6547,3512,3035,1183
3,46,District - Bathinda (12),Rural,15-19,90954,51101,39853,36412,0,0,10766,6169,4597,7657
3,46,District - Bathinda (12),Rural,20-24,92559,50698,41861,32442,0,0,16520,8423,8097,11624
3,46,District - Bathinda (12),Rural,Adolescent (10-19),172693,96705,75988,72114,0,0,17313,9681,7632,8840
3,46,District - Bathinda (12),Rural,Youth (15-24),183513,101799,81714,68854,0,0,27286,14592,12694,19281
3,46,District - Bathinda (12),Urban,All Ages,499217,268713,230504,128940,0,0,147541,67984,79557,6457
3,46,District - Bathinda (12),Urban,10-14,42901,24254,18647,13427,0,0,3791,1990,1801,54
3,46,District - Bathinda (12),Urban,15-19,46865,26536,20329,14475,0,0,4787,2668,2119,503
3,46,District - Bathinda (12),Urban,20-24,52599,28567,24032,14427,0,0,6083,2898,3185,924
3,46,District - Bathinda (12),Urban,Adolescent (10-19),89766,50790,38976,27902,0,0,8578,4658,3920,557
3,46,District - Bathinda (12),Urban,Youth (15-24),99464,55103,44361,28902,0,0,10870,5566,5304,1427
3,47,District - Mansa (13),Total,All Ages,769751,408732,361019,258878,0,0,346191,164695,181496,59308
3,47,District - Mansa (13),Total,10-14,75036,42052,32984,29859,0,0,6531,3503,3028,878
3,47,District - Mansa (13),Total,15-19,81166,45410,35756,29980,0,0,10162,5775,4387,5571
3,47,District - Mansa (13),Total,20-24,76191,40670,35521,24811,0,0,14498,7379,7119,8214
3,47,District - Mansa (13),Total,Adolescent (10-19),156202,87462,68740,59839,0,0,16693,9278,7415,6449
3,47,District - Mansa (13),Total,Youth (15-24),157357,86080,71277,54791,0,0,24660,13154,11506,13785
3,47,District - Mansa (13),Rural,All Ages,606147,322184,283963,217553,0,0,292903,140081,152822,56472
3,47,District - Mansa (13),Rural,10-14,59828,33388,26440,25293,0,0,5134,2746,2388,843
3,47,District - Mansa (13),Rural,15-19,64392,35959,28433,25038,0,0,8272,4689,3583,5321
3,47,District - Mansa (13),Rural,20-24,59341,31663,27678,20570,0,0,12193,6222,5971,7885
3,47,District - Mansa (13),Rural,Adolescent (10-19),124220,69347,54873,50331,0,0,13406,7435,5971,6164
3,47,District - Mansa (13),Rural,Youth (15-24),123733,67622,56111,45608,0,0,20465,10911,9554,13206
3,47,District - Mansa (13),Urban,All Ages,163604,86548,77056,41325,0,0,53288,24614,28674,2836
3,47,District - Mansa (13),Urban,10-14,15208,8664,6544,4566,0,0,1397,757,640,35
3,47,District - Mansa (13),Urban,15-19,16774,9451,7323,4942,0,0,1890,1086,804,250
3,47,District - Mansa (13),Urban,20-24,16850,9007,7843,4241,0,0,2305,1157,1148,329
3,47,District - Mansa (13),Urban,Adolescent (10-19),31982,18115,13867,9508,0,0,3287,1843,1444,285
3,47,District - Mansa (13),Urban,Youth (15-24),33624,18458,15166,9183,0,0,4195,2243,1952,579
3,48,District - Patiala (14),Total,All Ages,1895686,1002522,893164,465359,0,0,628895,291470,337425,65505
3,48,District - Patiala (14),Total,10-14,171978,97428,74550,49931,0,0,10437,5524,4913,575
3,48,District - Patiala (14),Total,15-19,189841,105967,83874,51099,0,0,14198,7471,6727,4302
3,48,District - Patiala (14),Total,20-24,196371,102221,94150,48814,0,0,20766,9367,11399,7982
3,48,District - Patiala (14),Total,Adolescent (10-19),361819,203395,158424,101030,0,0,24635,12995,11640,4877
3,48,District - Patiala (14),Total,Youth (15-24),386212,208188,178024,99913,0,0,34964,16838,18126,12284
3,48,District - Patiala (14),Rural,All Ages,1132406,598800,533606,348587,0,0,443568,205360,238208,61655
3,48,District - Patiala (14),Rural,10-14,107861,61307,46554,37860,0,0,6247,3282,2965,538
3,48,District - Patiala (14),Rural,15-19,116719,65181,51538,37975,0,0,9025,4619,4406,4096
3,48,District - Patiala (14),Rural,20-24,115572,59770,55802,35728,0,0,13961,6079,7882,7624
3,48,District - Patiala (14),Rural,Adolescent (10-19),224580,126488,98092,75835,0,0,15272,7901,7371,4634
3,48,District - Patiala (14),Rural,Youth (15-24),232291,124951,107340,73703,0,0,22986,10698,12288,11720
3,48,District - Patiala (14),Urban,All Ages,763280,403722,359558,116772,0,0,185327,86110,99217,3850
3,48,District - Patiala (14),Urban,10-14,64117,36121,27996,12071,0,0,4190,2242,1948,37
3,48,District - Patiala (14),Urban,15-19,73122,40786,32336,13124,0,0,5173,2852,2321,206
3,48,District - Patiala (14),Urban,20-24,80799,42451,38348,13086,0,0,6805,3288,3517,358
3,48,District - Patiala (14),Urban,Adolescent (10-19),137239,76907,60332,25195,0,0,9363,5094,4269,243
3,48,District - Patiala (14),Urban,Youth (15-24),153921,83237,70684,26210,0,0,11978,6140,5838,564
3,49,District - Amritsar (15),Total,All Ages,2490656,1318408,1172248,770864,0,0,805886,385427,420459,91248
3,49,District - Amritsar (15),Total,10-14,236189,132916,103273,86773,0,0,21336,10944,10392,1965
3,49,District - Amritsar (15),Total,15-19,260943,146027,114916,91755,0,0,29004,15436,13568,8334
3,49,District - Amritsar (15),Total,20-24,252233,133665,118568,80972,0,0,35732,16929,18803,11975
3,49,District - Amritsar (15),Total,Adolescent (10-19),497132,278943,218189,178528,0,0,50340,26380,23960,10299
3,49,District - Amritsar (15),Total,Youth (15-24),513176,279692,233484,172727,0,0,64736,32365,32371,20309
3,49,District - Amritsar (15),Rural,All Ages,1156045,607266,548779,464984,0,0,466598,221231,245367,79836
3,49,District - Amritsar (15),Rural,10-14,119740,66853,52887,55251,0,0,12489,6083,6406,1771
3,49,District - Amritsar (15),Rural,15-19,128826,71421,57405,55121,0,0,17053,8599,8454,7543
3,49,District - Amritsar (15),Rural,20-24,114351,59247,55104,46415,0,0,21005,9549,11456,10637
3,49,District - Amritsar (15),Rural,Adolescent (10-19),248566,138274,110292,110372,0,0,29542,14682,14860,9314
3,49,District - Amritsar (15),Rural,Youth (15-24),243177,130668,112509,101536,0,0,38058,18148,19910,18180
3,49,District - Amritsar (15),Urban,All Ages,1334611,711142,623469,305880,0,0,339288,164196,175092,11412
3,49,District - Amritsar (15),Urban,10-14,116449,66063,50386,31522,0,0,8847,4861,3986,194
3,49,District - Amritsar (15),Urban,15-19,132117,74606,57511,36634,0,0,11951,6837,5114,791
3,49,District - Amritsar (15),Urban,20-24,137882,74418,63464,34557,0,0,14727,7380,7347,1338
3,49,District - Amritsar (15),Urban,Adolescent (10-19),248566,140669,107897,68156,0,0,20798,11698,9100,985
3,49,District - Amritsar (15),Urban,Youth (15-24),269999,149024,120975,71191,0,0,26678,14217,12461,2129
3,50,District - Tarn Taran (16),Total,All Ages,1119627,589369,530258,377468,0,0,453465,212942,240523,61212
3,50,District - Tarn Taran (16),Total,10-14,116563,65814,50749,45886,0,0,12039,6219,5820,1074
3,50,District - Tarn Taran (16),Total,15-19,124038,69694,54344,43941,0,0,17111,9001,8110,5727
3,50,District - Tarn Taran (16),Total,20-24,108149,56296,51853,35929,0,0,21043,9713,11330,8114
3,50,District - Tarn Taran (16),Total,Adolescent (10-19),240601,135508,105093,89827,0,0,29150,15220,13930,6801
3,50,District - Tarn Taran (16),Total,Youth (15-24),232187,125990,106197,79870,0,0,38154,18714,19440,13841
3,50,District - Tarn Taran (16),Rural,All Ages,977832,514322,463510,339558,0,0,407719,191157,216562,58411
3,50,District - Tarn Taran (16),Rural,10-14,102745,57992,44753,41443,0,0,10418,5348,5070,1045
3,50,District - Tarn Taran (16),Rural,15-19,109309,61465,47844,39620,0,0,15178,7937,7241,5506
3,50,District - Tarn Taran (16),Rural,20-24,93862,48856,45006,32006,0,0,18801,8679,10122,7746
3,50,District - Tarn Taran (16),Rural,Adolescent (10-19),212054,119457,92597,81063,0,0,25596,13285,12311,6551
3,50,District - Tarn Taran (16),Rural,Youth (15-24),203171,110321,92850,71626,0,0,33979,16616,17363,13252
3,50,District - Tarn Taran (16),Urban,All Ages,141795,75047,66748,37910,0,0,45746,21785,23961,2801
3,50,District - Tarn Taran (16),Urban,10-14,13818,7822,5996,4443,0,0,1621,871,750,29
3,50,District - Tarn Taran (16),Urban,15-19,14729,8229,6500,4321,0,0,1933,1064,869,221
3,50,District - Tarn Taran (16),Urban,20-24,14287,7440,6847,3923,0,0,2242,1034,1208,368
3,50,District - Tarn Taran (16),Urban,Adolescent (10-19),28547,16051,12496,8764,0,0,3554,1935,1619,250
3,50,District - Tarn Taran (16),Urban,Youth (15-24),29016,15669,13347,8244,0,0,4175,2098,2077,589
3,51,District - Rupnagar (17),Total,All Ages,684627,357485,327142,180905,0,0,181896,78951,102945,14965
3,51,District - Rupnagar (17),Total,10-14,62896,35108,27788,18244,0,0,3118,1551,1567,108
3,51,District - Rupnagar (17),Total,15-19,69688,38097,31591,20088,0,0,3501,1778,1723,769
3,51,District - Rupnagar (17),Total,20-24,67606,34964,32642,19025,0,0,4324,1953,2371,1641
3,51,District - Rupnagar (17),Total,Adolescent (10-19),132584,73205,59379,38332,0,0,6619,3329,3290,877
3,51,District - Rupnagar (17),Total,Youth (15-24),137294,73061,64233,39113,0,0,7825,3731,4094,2410
3,51,District - Rupnagar (17),Rural,All Ages,506820,264089,242731,138597,0,0,141898,60713,81185,14212
3,51,District - Rupnagar (17),Rural,10-14,47141,26255,20886,14203,0,0,2094,1030,1064,105
3,51,District - Rupnagar (17),Rural,15-19,51885,28170,23715,15434,0,0,2289,1125,1164,731
3,51,District - Rupnagar (17),Rural,20-24,49315,25341,23974,14283,0,0,2828,1258,1570,1578
3,51,District - Rupnagar (17),Rural,Adolescent (10-19),99026,54425,44601,29637,0,0,4383,2155,2228,836
3,51,District - Rupnagar (17),Rural,Youth (15-24),101200,53511,47689,29717,0,0,5117,2383,2734,2309
3,51,District - Rupnagar (17),Urban,All Ages,177807,93396,84411,42308,0,0,39998,18238,21760,753
3,51,District - Rupnagar (17),Urban,10-14,15755,8853,6902,4041,0,0,1024,521,503,3
3,51,District - Rupnagar (17),Urban,15-19,17803,9927,7876,4654,0,0,1212,653,559,38
3,51,District - Rupnagar (17),Urban,20-24,18291,9623,8668,4742,0,0,1496,695,801,63
3,51,District - Rupnagar (17),Urban,Adolescent (10-19),33558,18780,14778,8695,0,0,2236,1174,1062,41
3,51,District - Rupnagar (17),Urban,Youth (15-24),36094,19550,16544,9396,0,0,2708,1348,1360,101
3,52,District - Sahibzada Ajit Singh Nagar (18),Total,All Ages,994628,529253,465375,216231,0,0,258053,119309,138744,17277
3,52,District - Sahibzada Ajit Singh Nagar (18),Total,10-14,88031,49751,38280,22496,0,0,5321,2776,2545,141
3,52,District - Sahibzada Ajit Singh Nagar (18),Total,15-19,92545,52005,40540,22871,0,0,5531,2975,2556,935
3,52,District - Sahibzada Ajit Singh Nagar (18),Total,20-24,98083,51551,46532,22122,0,0,7480,3355,4125,1917
3,52,District - Sahibzada Ajit Singh Nagar (18),Total,Adolescent (10-19),180576,101756,78820,45367,0,0,10852,5751,5101,1076
3,52,District - Sahibzada Ajit Singh Nagar (18),Total,Youth (15-24),190628,103556,87072,44993,0,0,13011,6330,6681,2852
3,52,District - Sahibzada Ajit Singh Nagar (18),Rural,All Ages,450017,240984,209033,132713,0,0,136448,62451,73997,14161
3,52,District - Sahibzada Ajit Singh Nagar (18),Rural,10-14,42630,24208,18422,14240,0,0,2369,1223,1146,117
3,52,District - Sahibzada Ajit Singh Nagar (18),Rural,15-19,46132,25809,20323,14486,0,0,2528,1357,1171,773
3,52,District - Sahibzada Ajit Singh Nagar (18),Rural,20-24,46170,24227,21943,13456,0,0,3559,1615,1944,1615
3,52,District - Sahibzada Ajit Singh Nagar (18),Rural,Adolescent (10-19),88762,50017,38745,28726,0,0,4897,2580,2317,890
3,52,District - Sahibzada Ajit Singh Nagar (18),Rural,Youth (15-24),92302,50036,42266,27942,0,0,6087,2972,3115,2388
3,52,District - Sahibzada Ajit Singh Nagar (18),Urban,All Ages,544611,288269,256342,83518,0,0,121605,56858,64747,3116
3,52,District - Sahibzada Ajit Singh Nagar (18),Urban,10-14,45401,25543,19858,8256,0,0,2952,1553,1399,24
3,52,District - Sahibzada Ajit Singh Nagar (18),Urban,15-19,46413,26196,20217,8385,0,0,3003,1618,1385,162
3,52,District - Sahibzada Ajit Singh Nagar (18),Urban,20-24,51913,27324,24589,8666,0,0,3921,1740,2181,302
3,52,District - Sahibzada Ajit Singh Nagar (18),Urban,Adolescent (10-19),91814,51739,40075,16641,0,0,5955,3171,2784,186
3,52,District - Sahibzada Ajit Singh Nagar (18),Urban,Youth (15-24),98326,53520,44806,17051,0,0,6924,3358,3566,464
3,53,District - Sangrur (19),Total,All Ages,1655169,878029,777140,461609,0,0,653092,307616,345476,72139
3,53,District - Sangrur (19),Total,10-14,155043,87225,67818,50666,0,0,10129,5517,4612,738
3,53,District - Sangrur (19),Total,15-19,171193,95840,75353,52726,0,0,15322,8699,6623,5443
3,53,District - Sangrur (19),Total,20-24,169309,89966,79343,47309,0,0,23544,11599,11945,9468
3,53,District - Sangrur (19),Total,Adolescent (10-19),326236,183065,143171,103392,0,0,25451,14216,11235,6181
3,53,District - Sangrur (19),Total,Youth (15-24),340502,185806,154696,100035,0,0,38866,20298,18568,14911
3,53,District - Sangrur (19),Rural,All Ages,1139204,604653,534551,361376,0,0,480347,227066,253281,64660
3,53,District - Sangrur (19),Rural,10-14,106634,59988,46646,39791,0,0,6171,3306,2865,667
3,53,District - Sangrur (19),Rural,15-19,118633,66416,52217,41326,0,0,9781,5485,4296,4931
3,53,District - Sangrur (19),Rural,20-24,114712,60740,53972,36629,0,0,15969,7828,8141,8556
3,53,District - Sangrur (19),Rural,Adolescent (10-19),225267,126404,98863,81117,0,0,15952,8791,7161,5598
3,53,District - Sangrur (19),Rural,Youth (15-24),233345,127156,106189,77955,0,0,25750,13313,12437,13487
3,53,District - Sangrur (19),Urban,All Ages,515965,273376,242589,100233,0,0,172745,80550,92195,7479
3,53,District - Sangrur (19),Urban,10-14,48409,27237,21172,10875,0,0,3958,2211,1747,71
3,53,District - Sangrur (19),Urban,15-19,52560,29424,23136,11400,0,0,5541,3214,2327,512
3,53,District - Sangrur (19),Urban,20-24,54597,29226,25371,10680,0,0,7575,3771,3804,912
3,53,District - Sangrur (19),Urban,Adolescent (10-19),100969,56661,44308,22275,0,0,9499,5425,4074,583
3,53,District - Sangrur (19),Urban,Youth (15-24),107157,58650,48507,22080,0,0,13116,6985,6131,1424
3,54,District - Barnala (20),Total,All Ages,595527,317522,278005,192001,0,0,235696,115523,120173,31710
3,54,District - Barnala (20),Total,10-14,55242,30970,24272,21451,0,0,3673,2137,1536,335
3,54,District - Barnala (20),Total,15-19,59829,33647,26182,21607,0,0,5983,3580,2403,2562
3,54,District - Barnala (20),Total,20-24,59675,32383,27292,19336,0,0,9013,4903,4110,4327
3,54,District - Barnala (20),Total,Adolescent (10-19),115071,64617,50454,43058,0,0,9656,5717,3939,2897
3,54,District - Barnala (20),Total,Youth (15-24),119504,66030,53474,40943,0,0,14996,8483,6513,6889
3,54,District - Barnala (20),Rural,All Ages,404842,215210,189632,133435,0,0,170436,83694,86742,26985
3,54,District - Barnala (20),Rural,10-14,37689,21155,16534,15030,0,0,2151,1286,865,294
3,54,District - Barnala (20),Rural,15-19,41057,23025,18032,14933,0,0,3792,2300,1492,2165
3,54,District - Barnala (20),Rural,20-24,40123,21621,18502,13114,0,0,5960,3255,2705,3655
3,54,District - Barnala (20),Rural,Adolescent (10-19),78746,44180,34566,29963,0,0,5943,3586,2357,2459
3,54,District - Barnala (20),Rural,Youth (15-24),81180,44646,36534,28047,0,0,9752,5555,4197,5820
3,54,District - Barnala (20),Urban,All Ages,190685,102312,88373,58566,0,0,65260,31829,33431,4725
3,54,District - Barnala (20),Urban,10-14,17553,9815,7738,6421,0,0,1522,851,671,41
3,54,District - Barnala (20),Urban,15-19,18772,10622,8150,6674,0,0,2191,1280,911,397
3,54,District - Barnala (20),Urban,20-24,19552,10762,8790,6222,0,0,3053,1648,1405,672
3,54,District - Barnala (20),Urban,Adolescent (10-19),36325,20437,15888,13095,0,0,3713,2131,1582,438
3,54,District - Barnala (20),Urban,Youth (15-24),38324,21384,16940,12896,0,0,5244,2928,2316,1069
4,0,State - CHANDIGARH (04),Total,All Ages,1055450,580663,474787,199086,0,0,250012,115317,134695,1396
4,0,State - CHANDIGARH (04),Total,10-14,93464,52140,41324,21237,0,0,5038,2501,2537,13
4,0,State - CHANDIGARH (04),Total,15-19,104418,60521,43897,22204,0,0,6924,3949,2975,51
4,0,State - CHANDIGARH (04),Total,20-24,121244,68467,52777,22819,0,0,10428,4812,5616,153
4,0,State - CHANDIGARH (04),Total,Adolescent (10-19),197882,112661,85221,43441,0,0,11962,6450,5512,64
4,0,State - CHANDIGARH (04),Total,Youth (15-24),225662,128988,96674,45023,0,0,17352,8761,8591,204
4,0,State - CHANDIGARH (04),Rural,All Ages,28991,17150,11841,4974,0,0,9030,4398,4632,138
4,0,State - CHANDIGARH (04),Rural,10-14,2537,1421,1116,562,0,0,197,88,109,3
4,0,State - CHANDIGARH (04),Rural,15-19,2765,1787,978,549,0,0,302,189,113,13
4,0,State - CHANDIGARH (04),Rural,20-24,3593,2255,1338,544,0,0,499,262,237,21
4,0,State - CHANDIGARH (04),Rural,Adolescent (10-19),5302,3208,2094,1111,0,0,499,277,222,16
4,0,State - CHANDIGARH (04),Rural,Youth (15-24),6358,4042,2316,1093,0,0,801,451,350,34
4,0,State - CHANDIGARH (04),Urban,All Ages,1026459,563513,462946,194112,0,0,240982,110919,130063,1258
4,0,State - CHANDIGARH (04),Urban,10-14,90927,50719,40208,20675,0,0,4841,2413,2428,10
4,0,State - CHANDIGARH (04),Urban,15-19,101653,58734,42919,21655,0,0,6622,3760,2862,38
4,0,State - CHANDIGARH (04),Urban,20-24,117651,66212,51439,22275,0,0,9929,4550,5379,132
4,0,State - CHANDIGARH (04),Urban,Adolescent (10-19),192580,109453,83127,42330,0,0,11463,6173,5290,48
4,0,State - CHANDIGARH (04),Urban,Youth (15-24),219304,124946,94358,43930,0,0,16551,8310,8241,170
4,55,District - Chandigarh (01),Total,All Ages,1055450,580663,474787,199086,0,0,250012,115317,134695,1396
4,55,District - Chandigarh (01),Total,10-14,93464,52140,41324,21237,0,0,5038,2501,2537,13
4,55,District - Chandigarh (01),Total,15-19,104418,60521,43897,22204,0,0,6924,3949,2975,51
4,55,District - Chandigarh (01),Total,20-24,121244,68467,52777,22819,0,0,10428,4812,5616,153
4,55,District - Chandigarh (01),Total,Adolescent (10-19),197882,112661,85221,43441,0,0,11962,6450,5512,64
4,55,District - Chandigarh (01),Total,Youth (15-24),225662,128988,96674,45023,0,0,17352,8761,8591,204
4,55,District - Chandigarh (01),Rural,All Ages,28991,17150,11841,4974,0,0,9030,4398,4632,138
4,55,District - Chandigarh (01),Rural,10-14,2537,1421,1116,562,0,0,197,88,109,3
4,55,District - Chandigarh (01),Rural,15-19,2765,1787,978,549,0,0,302,189,113,13
4,55,District - Chandigarh (01),Rural,20-24,3593,2255,1338,544,0,0,499,262,237,21
4,55,District - Chandigarh (01),Rural,Adolescent (10-19),5302,3208,2094,1111,0,0,499,277,222,16
4,55,District - Chandigarh (01),Rural,Youth (15-24),6358,4042,2316,1093,0,0,801,451,350,34
4,55,District - Chandigarh (01),Urban,All Ages,1026459,563513,462946,194112,0,0,240982,110919,130063,1258
4,55,District - Chandigarh (01),Urban,10-14,90927,50719,40208,20675,0,0,4841,2413,2428,10
4,55,District - Chandigarh (01),Urban,15-19,101653,58734,42919,21655,0,0,6622,3760,2862,38
4,55,District - Chandigarh (01),Urban,20-24,117651,66212,51439,22275,0,0,9929,4550,5379,132
4,55,District - Chandigarh (01),Urban,Adolescent (10-19),192580,109453,83127,42330,0,0,11463,6173,5290,48
4,55,District - Chandigarh (01),Urban,Youth (15-24),219304,124946,94358,43930,0,0,16551,8310,8241,170
5,0,State - UTTARAKHAND (05),Total,All Ages,10086292,5137773,4948519,1892516,291903,148669,3205339,1274065,1931274,247256
5,0,State - UTTARAKHAND (05),Total,10-14,1145343,603274,542069,242392,34685,17935,60759,29348,31411,3050
5,0,State - UTTARAKHAND (05),Total,15-19,1124110,588483,535627,222369,36154,18190,69807,30438,39369,20237
5,0,State - UTTARAKHAND (05),Total,20-24,970068,484614,485454,180434,29918,14751,97193,33899,63294,31906
5,0,State - UTTARAKHAND (05),Total,Adolescent (10-19),2269453,1191757,1077696,464761,70839,36125,130566,59786,70780,23287
5,0,State - UTTARAKHAND (05),Total,Youth (15-24),2094178,1073097,1021081,402803,66072,32941,167000,64337,102663,52143
5,0,State - UTTARAKHAND (05),Rural,All Ages,7036954,3519042,3517912,1496665,264819,134691,2422904,922871,1500033,225529
5,0,State - UTTARAKHAND (05),Rural,10-14,835418,434578,400840,197776,31650,16186,39705,18537,21168,2886
5,0,State - UTTARAKHAND (05),Rural,15-19,792898,407069,385829,174307,33153,16600,44795,17568,27227,18826
5,0,State - UTTARAKHAND (05),Rural,20-24,648027,312431,335596,135414,26999,13308,66375,20472,45903,29197
5,0,State - UTTARAKHAND (05),Rural,Adolescent (10-19),1628316,841647,786669,372083,64803,32786,84500,36105,48395,21712
5,0,State - UTTARAKHAND (05),Rural,Youth (15-24),1440925,719500,721425,309721,60152,29908,111170,38040,73130,48023
5,0,State - UTTARAKHAND (05),Urban,All Ages,3049338,1618731,1430607,395851,27084,13978,782435,351194,431241,21727
5,0,State - UTTARAKHAND (05),Urban,10-14,309925,168696,141229,44616,3035,1749,21054,10811,10243,164
5,0,State - UTTARAKHAND (05),Urban,15-19,331212,181414,149798,48062,3001,1590,25012,12870,12142,1411
5,0,State - UTTARAKHAND (05),Urban,20-24,322041,172183,149858,45020,2919,1443,30818,13427,17391,2709
5,0,State - UTTARAKHAND (05),Urban,Adolescent (10-19),641137,350110,291027,92678,6036,3339,46066,23681,22385,1575
5,0,State - UTTARAKHAND (05),Urban,Youth (15-24),653253,353597,299656,93082,5920,3033,55830,26297,29533,4120
5,56,District - Uttarkashi (01),Total,All Ages,330086,168597,161489,80567,3512,1651,114960,40360,74600,2389
5,56,District - Uttarkashi (01),Total,10-14,40872,21165,19707,10729,327,190,1215,506,709,35
5,56,District - Uttarkashi (01),Total,15-19,36173,18761,17412,8950,372,193,1223,315,908,162
5,56,District - Uttarkashi (01),Total,20-24,31081,15614,15467,7644,336,141,3007,542,2465,328
5,56,District - Uttarkashi (01),Total,Adolescent (10-19),77045,39926,37119,19679,699,383,2438,821,1617,197
5,56,District - Uttarkashi (01),Total,Youth (15-24),67254,34375,32879,16594,708,334,4230,857,3373,490
5,56,District - Uttarkashi (01),Rural,All Ages,305781,155375,150406,76875,3374,1581,109872,38280,71592,2324
5,56,District - Uttarkashi (01),Rural,10-14,38077,19585,18492,10313,304,178,1171,485,686,35
5,56,District - Uttarkashi (01),Rural,15-19,33389,17271,16118,8443,364,189,1172,298,874,156
5,56,District - Uttarkashi (01),Rural,20-24,28783,14350,14433,7212,323,137,2909,501,2408,323
5,56,District - Uttarkashi (01),Rural,Adolescent (10-19),71466,36856,34610,18756,668,367,2343,783,1560,191
5,56,District - Uttarkashi (01),Rural,Youth (15-24),62172,31621,30551,15655,687,326,4081,799,3282,479
5,56,District - Uttarkashi (01),Urban,All Ages,24305,13222,11083,3692,138,70,5088,2080,3008,65
5,56,District - Uttarkashi (01),Urban,10-14,2795,1580,1215,416,23,12,44,21,23,0
5,56,District - Uttarkashi (01),Urban,15-19,2784,1490,1294,507,8,4,51,17,34,6
5,56,District - Uttarkashi (01),Urban,20-24,2298,1264,1034,432,13,4,98,41,57,5
5,56,District - Uttarkashi (01),Urban,Adolescent (10-19),5579,3070,2509,923,31,16,95,38,57,6
5,56,District - Uttarkashi (01),Urban,Youth (15-24),5082,2754,2328,939,21,8,149,58,91,11
5,57,District - Chamoli (02),Total,All Ages,391605,193991,197614,79317,12260,6021,111049,38596,72453,1072
5,57,District - Chamoli (02),Total,10-14,44204,22624,21580,10456,1024,516,713,337,376,9
5,57,District - Chamoli (02),Total,15-19,41293,21003,20290,8609,1094,579,623,282,341,68
5,57,District - Chamoli (02),Total,20-24,36521,16964,19557,7298,1201,597,1277,476,801,130
5,57,District - Chamoli (02),Total,Adolescent (10-19),85497,43627,41870,19065,2118,1095,1336,619,717,77
5,57,District - Chamoli (02),Total,Youth (15-24),77814,37967,39847,15907,2295,1176,1900,758,1142,198
5,57,District - Chamoli (02),Rural,All Ages,332209,160369,171840,68000,9046,4457,99906,33498,66408,874
5,57,District - Chamoli (02),Rural,10-14,38161,19271,18890,9051,705,351,624,286,338,6
5,57,District - Chamoli (02),Rural,15-19,35236,17525,17711,7350,785,415,501,207,294,52
5,57,District - Chamoli (02),Rural,20-24,30607,13621,16986,6118,928,471,1082,366,716,100
5,57,District - Chamoli (02),Rural,Adolescent (10-19),73397,36796,36601,16401,1490,766,1125,493,632,58
5,57,District - Chamoli (02),Rural,Youth (15-24),65843,31146,34697,13468,1713,886,1583,573,1010,152
5,57,District - Chamoli (02),Urban,All Ages,59396,33622,25774,11317,3214,1564,11143,5098,6045,198
5,57,District - Chamoli (02),Urban,10-14,6043,3353,2690,1405,319,165,89,51,38,3
5,57,District - Chamoli (02),Urban,15-19,6057,3478,2579,1259,309,164,122,75,47,16
5,57,District - Chamoli (02),Urban,20-24,5914,3343,2571,1180,273,126,195,110,85,30
5,57,District - Chamoli (02),Urban,Adolescent (10-19),12100,6831,5269,2664,628,329,211,126,85,19
5,57,District - Chamoli (02),Urban,Youth (15-24),11971,6821,5150,2439,582,290,317,185,132,46
5,58,District - Rudraprayag (03),Total,All Ages,242285,114589,127696,47679,386,217,71352,22786,48566,1519
5,58,District - Rudraprayag (03),Total,10-14,28519,14554,13965,6526,35,17,612,275,337,22
5,58,District - Rudraprayag (03),Total,15-19,25905,12898,13007,5139,44,29,331,143,188,51
5,58,District - Rudraprayag (03),Total,20-24,21601,9163,12438,4389,44,21,663,170,493,160
5,58,District - Rudraprayag (03),Total,Adolescent (10-19),54424,27452,26972,11665,79,46,943,418,525,73
5,58,District - Rudraprayag (03),Total,Youth (15-24),47506,22061,25445,9528,88,50,994,313,681,211
5,58,District - Rudraprayag (03),Rural,All Ages,232360,108740,123620,46279,309,169,69416,21887,47529,1409
5,58,District - Rudraprayag (03),Rural,10-14,27526,14022,13504,6352,31,16,586,262,324,22
5,58,District - Rudraprayag (03),Rural,15-19,24917,12318,12599,4958,33,23,293,116,177,48
5,58,District - Rudraprayag (03),Rural,20-24,20653,8594,12059,4223,38,16,611,138,473,155
5,58,District - Rudraprayag (03),Rural,Adolescent (10-19),52443,26340,26103,11310,64,39,879,378,501,70
5,58,District - Rudraprayag (03),Rural,Youth (15-24),45570,20912,24658,9181,71,39,904,254,650,203
5,58,District - Rudraprayag (03),Urban,All Ages,9925,5849,4076,1400,77,48,1936,899,1037,110
5,58,District - Rudraprayag (03),Urban,10-14,993,532,461,174,4,1,26,13,13,0
5,58,District - Rudraprayag (03),Urban,15-19,988,580,408,181,11,6,38,27,11,3
5,58,District - Rudraprayag (03),Urban,20-24,948,569,379,166,6,5,52,32,20,5
5,58,District - Rudraprayag (03),Urban,Adolescent (10-19),1981,1112,869,355,15,7,64,40,24,3
5,58,District - Rudraprayag (03),Urban,Youth (15-24),1936,1149,787,347,17,11,90,59,31,8
5,59,District - Tehri Garhwal (04),Total,All Ages,618931,297986,320945,102130,875,459,210937,70580,140357,3582
5,59,District - Tehri Garhwal (04),Total,10-14,75138,38660,36478,14291,96,51,1448,666,782,112
5,59,District - Tehri Garhwal (04),Total,15-19,68849,34005,34844,11528,92,44,1647,609,1038,269
5,59,District - Tehri Garhwal (04),Total,20-24,53782,23593,30189,8764,109,67,3704,910,2794,426
5,59,District - Tehri Garhwal (04),Total,Adolescent (10-19),143987,72665,71322,25819,188,95,3095,1275,1820,381
5,59,District - Tehri Garhwal (04),Total,Youth (15-24),122631,57598,65033,20292,201,111,5351,1519,3832,695
5,59,District - Tehri Garhwal (04),Rural,All Ages,548792,259381,289411,94628,630,312,196016,64025,131991,3505
5,59,District - Tehri Garhwal (04),Rural,10-14,67415,34351,33064,13341,71,37,1331,603,728,111
5,59,District - Tehri Garhwal (04),Rural,15-19,61440,29791,31649,10631,66,27,1462,473,989,269
5,59,District - Tehri Garhwal (04),Rural,20-24,46801,19705,27096,7964,67,37,3289,652,2637,419
5,59,District - Tehri Garhwal (04),Rural,Adolescent (10-19),128855,64142,64713,23972,137,64,2793,1076,1717,380
5,59,District - Tehri Garhwal (04),Rural,Youth (15-24),108241,49496,58745,18595,133,64,4751,1125,3626,688
5,59,District - Tehri Garhwal (04),Urban,All Ages,70139,38605,31534,7502,245,147,14921,6555,8366,77
5,59,District - Tehri Garhwal (04),Urban,10-14,7723,4309,3414,950,25,14,117,63,54,1
5,59,District - Tehri Garhwal (04),Urban,15-19,7409,4214,3195,897,26,17,185,136,49,0
5,59,District - Tehri Garhwal (04),Urban,20-24,6981,3888,3093,800,42,30,415,258,157,7
5,59,District - Tehri Garhwal (04),Urban,Adolescent (10-19),15132,8523,6609,1847,51,31,302,199,103,1
5,59,District - Tehri Garhwal (04),Urban,Youth (15-24),14390,8102,6288,1697,68,47,600,394,206,7
5,60,District - Dehradun (05),Total,All Ages,1696694,892199,804495,228901,111663,58264,437188,189983,247205,20424
5,60,District - Dehradun (05),Total,10-14,167882,90496,77386,25549,14184,7281,7265,3595,3670,179
5,60,District - Dehradun (05),Total,15-19,175683,95753,79930,24869,13577,6837,8547,4342,4205,1304
5,60,District - Dehradun (05),Total,20-24,175063,91310,83753,24420,10773,5610,13737,5581,8156,2396
5,60,District - Dehradun (05),Total,Adolescent (10-19),343565,186249,157316,50418,27761,14118,15812,7937,7875,1483
5,60,District - Dehradun (05),Total,Youth (15-24),350746,187063,163683,49289,24350,12447,22284,9923,12361,3700
5,60,District - Dehradun (05),Rural,All Ages,754753,392891,361862,119123,101475,52825,236917,100509,136408,16803
5,60,District - Dehradun (05),Rural,10-14,81002,42883,38119,14261,13047,6616,3560,1705,1855,158
5,60,District - Dehradun (05),Rural,15-19,80943,43311,37632,12442,12372,6185,4381,1983,2398,1129
5,60,District - Dehradun (05),Rural,20-24,77328,39440,37888,11695,9560,4977,7581,2824,4757,1997
5,60,District - Dehradun (05),Rural,Adolescent (10-19),161945,86194,75751,26703,25419,12801,7941,3688,4253,1287
5,60,District - Dehradun (05),Rural,Youth (15-24),158271,82751,75520,24137,21932,11162,11962,4807,7155,3126
5,60,District - Dehradun (05),Urban,All Ages,941941,499308,442633,109778,10188,5439,200271,89474,110797,3621
5,60,District - Dehradun (05),Urban,10-14,86880,47613,39267,11288,1137,665,3705,1890,1815,21
5,60,District - Dehradun (05),Urban,15-19,94740,52442,42298,12427,1205,652,4166,2359,1807,175
5,60,District - Dehradun (05),Urban,20-24,97735,51870,45865,12725,1213,633,6156,2757,3399,399
5,60,District - Dehradun (05),Urban,Adolescent (10-19),181620,100055,81565,23715,2342,1317,7871,4249,3622,196
5,60,District - Dehradun (05),Urban,Youth (15-24),192475,104312,88163,25152,2418,1285,10322,5116,5206,574
5,61,District - Garhwal (06),Total,All Ages,687271,326829,360442,122361,2215,1174,192382,64681,127701,4154
5,61,District - Garhwal (06),Total,10-14,76575,39320,37255,15959,280,147,1822,913,909,33
5,61,District - Garhwal (06),Total,15-19,74266,37469,36797,14116,252,125,1540,781,759,149
5,61,District - Garhwal (06),Total,20-24,58033,25524,32509,10444,188,112,2419,950,1469,369
5,61,District - Garhwal (06),Total,Adolescent (10-19),150841,76789,74052,30075,532,272,3362,1694,1668,182
5,61,District - Garhwal (06),Total,Youth (15-24),132299,62993,69306,24560,440,237,3959,1731,2228,518
5,61,District - Garhwal (06),Rural,All Ages,574568,268029,306539,109576,1952,1018,170010,54674,115336,3903
5,61,District - Garhwal (06),Rural,10-14,64869,32867,32002,14523,250,129,1541,759,782,31
5,61,District - Garhwal (06),Rural,15-19,62087,30665,31422,12629,230,113,1187,565,622,135
5,61,District - Garhwal (06),Rural,20-24,46746,19534,27212,8958,168,102,1895,689,1206,341
5,61,District - Garhwal (06),Rural,Adolescent (10-19),126956,63532,63424,27152,480,242,2728,1324,1404,166
5,61,District - Garhwal (06),Rural,Youth (15-24),108833,50199,58634,21587,398,215,3082,1254,1828,476
5,61,District - Garhwal (06),Urban,All Ages,112703,58800,53903,12785,263,156,22372,10007,12365,251
5,61,District - Garhwal (06),Urban,10-14,11706,6453,5253,1436,30,18,281,154,127,2
5,61,District - Garhwal (06),Urban,15-19,12179,6804,5375,1487,22,12,353,216,137,14
5,61,District - Garhwal (06),Urban,20-24,11287,5990,5297,1486,20,10,524,261,263,28
5,61,District - Garhwal (06),Urban,Adolescent (10-19),23885,13257,10628,2923,52,30,634,370,264,16
5,61,District - Garhwal (06),Urban,Youth (15-24),23466,12794,10672,2973,42,22,877,477,400,42
5,62,District - Pithoragarh (07),Total,All Ages,483439,239306,244133,120378,19535,9558,137889,49683,88206,2204
5,62,District - Pithoragarh (07),Total,10-14,52906,27704,25202,15136,1897,999,1071,519,552,15
5,62,District - Pithoragarh (07),Total,15-19,49280,25482,23798,12814,1743,919,965,418,547,95
5,62,District - Pithoragarh (07),Total,20-24,41913,19430,22483,10742,1791,856,1975,628,1347,280
5,62,District - Pithoragarh (07),Total,Adolescent (10-19),102186,53186,49000,27950,3640,1918,2036,937,1099,110
5,62,District - Pithoragarh (07),Total,Youth (15-24),91193,44912,46281,23556,3534,1775,2940,1046,1894,375
5,62,District - Pithoragarh (07),Rural,All Ages,413834,202930,210904,109541,15915,7822,124578,43201,81377,2125
5,62,District - Pithoragarh (07),Rural,10-14,45230,23345,21885,13795,1525,788,947,457,490,15
5,62,District - Pithoragarh (07),Rural,15-19,41443,21068,20375,11489,1422,746,764,273,491,94
5,62,District - Pithoragarh (07),Rural,20-24,35297,16045,19252,9567,1470,700,1667,427,1240,273
5,62,District - Pithoragarh (07),Rural,Adolescent (10-19),86673,44413,42260,25284,2947,1534,1711,730,981,109
5,62,District - Pithoragarh (07),Rural,Youth (15-24),76740,37113,39627,21056,2892,1446,2431,700,1731,367
5,62,District - Pithoragarh (07),Urban,All Ages,69605,36376,33229,10837,3620,1736,13311,6482,6829,79
5,62,District - Pithoragarh (07),Urban,10-14,7676,4359,3317,1341,372,211,124,62,62,0
5,62,District - Pithoragarh (07),Urban,15-19,7837,4414,3423,1325,321,173,201,145,56,1
5,62,District - Pithoragarh (07),Urban,20-24,6616,3385,3231,1175,321,156,308,201,107,7
5,62,District - Pithoragarh (07),Urban,Adolescent (10-19),15513,8773,6740,2666,693,384,325,207,118,1
5,62,District - Pithoragarh (07),Urban,Youth (15-24),14453,7799,6654,2500,642,329,509,346,163,8
5,63,District - Bageshwar (08),Total,All Ages,259898,124326,135572,72061,1982,971,80415,26780,53635,2733
5,63,District - Bageshwar (08),Total,10-14,29092,14777,14315,9151,183,96,451,178,273,19
5,63,District - Bageshwar (08),Total,15-19,26961,13714,13247,7820,151,68,465,171,294,147
5,63,District - Bageshwar (08),Total,20-24,21272,9294,11978,5973,160,80,815,189,626,282
5,63,District - Bageshwar (08),Total,Adolescent (10-19),56053,28491,27562,16971,334,164,916,349,567,166
5,63,District - Bageshwar (08),Total,Youth (15-24),48233,23008,25225,13793,311,148,1280,360,920,429
5,63,District - Bageshwar (08),Rural,All Ages,250819,119615,131204,69842,1874,916,78653,26027,52626,2699
5,63,District - Bageshwar (08),Rural,10-14,28168,14267,13901,8911,174,92,434,171,263,19
5,63,District - Bageshwar (08),Rural,15-19,25952,13146,12806,7552,139,63,440,158,282,146
5,63,District - Bageshwar (08),Rural,20-24,20411,8870,11541,5743,154,76,783,174,609,279
5,63,District - Bageshwar (08),Rural,Adolescent (10-19),54120,27413,26707,16463,313,155,874,329,545,165
5,63,District - Bageshwar (08),Rural,Youth (15-24),46363,22016,24347,13295,293,139,1223,332,891,425
5,63,District - Bageshwar (08),Urban,All Ages,9079,4711,4368,2219,108,55,1762,753,1009,34
5,63,District - Bageshwar (08),Urban,10-14,924,510,414,240,9,4,17,7,10,0
5,63,District - Bageshwar (08),Urban,15-19,1009,568,441,268,12,5,25,13,12,1
5,63,District - Bageshwar (08),Urban,20-24,861,424,437,230,6,4,32,15,17,3
5,63,District - Bageshwar (08),Urban,Adolescent (10-19),1933,1078,855,508,21,9,42,20,22,1
5,63,District - Bageshwar (08),Urban,Youth (15-24),1870,992,878,498,18,9,57,28,29,4
5,64,"District - Almora
 (09)",Total,All Ages,622506,291081,331425,150995,1281,633,186009,59477,126532,4025
5,64,"District - Almora
 (09)",Total,10-14,70771,35973,34798,19622,121,63,982,467,515,45
5,64,"District - Almora
 (09)",Total,15-19,69317,33684,35633,17523,152,71,920,331,589,231
5,64,"District - Almora
 (09)",Total,20-24,52038,22527,29511,12536,116,53,1541,393,1148,447
5,64,"District - Almora
 (09)",Total,Adolescent (10-19),140088,69657,70431,37145,273,134,1902,798,1104,276
5,64,"District - Almora
 (09)",Total,Youth (15-24),121355,56211,65144,30059,268,124,2461,724,1737,678
5,64,"District - Almora
 (09)",Rural,All Ages,560192,257359,302833,140931,750,364,177103,55540,121563,3984
5,64,"District - Almora
 (09)",Rural,10-14,65337,33017,32320,18597,67,36,919,434,485,45
5,64,"District - Almora
 (09)",Rural,15-19,62708,30015,32693,16254,91,32,849,294,555,231
5,64,"District - Almora
 (09)",Rural,20-24,44942,18374,26568,11315,60,31,1396,322,1074,445
5,64,"District - Almora
 (09)",Rural,Adolescent (10-19),128045,63032,65013,34851,158,68,1768,728,1040,276
5,64,"District - Almora
 (09)",Rural,Youth (15-24),107650,48389,59261,27569,151,63,2245,616,1629,676
5,64,"District - Almora
 (09)",Urban,All Ages,62314,33722,28592,10064,531,269,8906,3937,4969,41
5,64,"District - Almora
 (09)",Urban,10-14,5434,2956,2478,1025,54,27,63,33,30,0
5,64,"District - Almora
 (09)",Urban,15-19,6609,3669,2940,1269,61,39,71,37,34,0
5,64,"District - Almora
 (09)",Urban,20-24,7096,4153,2943,1221,56,22,145,71,74,2
5,64,"District - Almora
 (09)",Urban,Adolescent (10-19),12043,6625,5418,2294,115,66,134,70,64,0
5,64,"District - Almora
 (09)",Urban,Youth (15-24),13705,7822,5883,2490,117,61,216,108,108,2
5,65,District - Champawat (10),Total,All Ages,259648,131125,128523,47383,1339,777,81922,29110,52812,1980
5,65,District - Champawat (10),Total,10-14,31848,16331,15517,6345,157,81,786,368,418,19
5,65,District - Champawat (10),Total,15-19,27603,14383,13220,5098,138,82,754,265,489,125
5,65,District - Champawat (10),Total,20-24,22473,11235,11238,4008,116,58,1477,337,1140,223
5,65,District - Champawat (10),Total,Adolescent (10-19),59451,30714,28737,11443,295,163,1540,633,907,144
5,65,District - Champawat (10),Total,Youth (15-24),50076,25618,24458,9106,254,140,2231,602,1629,348
5,65,District - Champawat (10),Rural,All Ages,221305,110842,110463,41725,1084,640,71395,24463,46932,1763
5,65,District - Champawat (10),Rural,10-14,27486,14024,13462,5592,130,70,549,240,309,17
5,65,District - Champawat (10),Rural,15-19,23242,12003,11239,4344,118,68,475,128,347,101
5,65,District - Champawat (10),Rural,20-24,18653,9228,9425,3416,88,43,1070,158,912,196
5,65,District - Champawat (10),Rural,Adolescent (10-19),50728,26027,24701,9936,248,138,1024,368,656,118
5,65,District - Champawat (10),Rural,Youth (15-24),41895,21231,20664,7760,206,111,1545,286,1259,297
5,65,District - Champawat (10),Urban,All Ages,38343,20283,18060,5658,255,137,10527,4647,5880,217
5,65,District - Champawat (10),Urban,10-14,4362,2307,2055,753,27,11,237,128,109,2
5,65,District - Champawat (10),Urban,15-19,4361,2380,1981,754,20,14,279,137,142,24
5,65,District - Champawat (10),Urban,20-24,3820,2007,1813,592,28,15,407,179,228,27
5,65,District - Champawat (10),Urban,Adolescent (10-19),8723,4687,4036,1507,47,25,516,265,251,26
5,65,District - Champawat (10),Urban,Youth (15-24),8181,4387,3794,1346,48,29,686,316,370,51
5,66,District - Nainital (11),Total,All Ages,954605,493666,460939,191206,7495,3801,258105,107887,150218,19618
5,66,District - Nainital (11),Total,10-14,102103,53986,48117,22687,859,446,5028,2623,2405,338
5,66,District - Nainital (11),Total,15-19,103405,54781,48624,22121,883,419,5294,2764,2530,1599
5,66,District - Nainital (11),Total,20-24,94692,48516,46176,19355,776,393,7191,2944,4247,2424
5,66,District - Nainital (11),Total,Adolescent (10-19),205508,108767,96741,44808,1742,865,10322,5387,4935,1937
5,66,District - Nainital (11),Total,Youth (15-24),198097,103297,94800,41476,1659,812,12485,5708,6777,4023
5,66,District - Nainital (11),Rural,All Ages,582871,299257,283614,137906,5780,2934,164901,65003,99898,18536
5,66,District - Nainital (11),Rural,10-14,64333,33586,30747,16751,702,351,2557,1250,1307,321
5,66,District - Nainital (11),Rural,15-19,62634,32994,29640,15700,727,341,2262,1036,1226,1519
5,66,District - Nainital (11),Rural,20-24,55651,28165,27486,13341,614,327,3465,1173,2292,2302
5,66,District - Nainital (11),Rural,Adolescent (10-19),126967,66580,60387,32451,1429,692,4819,2286,2533,1840
5,66,District - Nainital (11),Rural,Youth (15-24),118285,61159,57126,29041,1341,668,5727,2209,3518,3821
5,66,District - Nainital (11),Urban,All Ages,371734,194409,177325,53300,1715,867,93204,42884,50320,1082
5,66,District - Nainital (11),Urban,10-14,37770,20400,17370,5936,157,95,2471,1373,1098,17
5,66,District - Nainital (11),Urban,15-19,40771,21787,18984,6421,156,78,3032,1728,1304,80
5,66,District - Nainital (11),Urban,20-24,39041,20351,18690,6014,162,66,3726,1771,1955,122
5,66,District - Nainital (11),Urban,Adolescent (10-19),78541,42187,36354,12357,313,173,5503,3101,2402,97
5,66,District - Nainital (11),Urban,Youth (15-24),79812,42138,37674,12435,318,144,6758,3499,3259,202
5,67,District - Udham Singh Nagar (12),Total,All Ages,1648902,858783,790119,238264,123037,61758,611063,260258,350805,107603
5,67,District - Udham Singh Nagar (12),Total,10-14,201649,106586,95063,32682,14714,7624,17549,8160,9389,1533
5,67,District - Udham Singh Nagar (12),Total,15-19,201030,106686,94344,30118,16863,8396,21548,8800,12748,9645
5,67,District - Udham Singh Nagar (12),Total,20-24,168034,87566,80468,23358,13724,6411,27599,9517,18082,14067
5,67,District - Udham Singh Nagar (12),Total,Adolescent (10-19),402679,213272,189407,62800,31577,16020,39097,16960,22137,11178
5,67,District - Udham Singh Nagar (12),Total,Youth (15-24),369064,194252,174812,53476,30587,14807,49147,18317,30830,23712
5,67,District - Udham Singh Nagar (12),Rural,All Ages,1062142,550470,511672,174919,117381,58843,409425,171033,238392,96377
5,67,District - Udham Singh Nagar (12),Rural,10-14,133272,70122,63150,24710,13954,7162,9714,4313,5401,1437
5,67,District - Udham Singh Nagar (12),Rural,15-19,129564,68411,61153,21902,16124,8027,12468,4594,7874,8843
5,67,District - Udham Singh Nagar (12),Rural,20-24,104427,54222,50205,16401,13069,6111,17408,5463,11945,12624
5,67,District - Udham Singh Nagar (12),Rural,Adolescent (10-19),262836,138533,124303,46612,30078,15189,22182,8907,13275,10280
5,67,District - Udham Singh Nagar (12),Rural,Youth (15-24),233991,122633,111358,38303,29193,14138,29876,10057,19819,21467
5,67,District - Udham Singh Nagar (12),Urban,All Ages,586760,308313,278447,63345,5656,2915,201638,89225,112413,11226
5,67,District - Udham Singh Nagar (12),Urban,10-14,68377,36464,31913,7972,760,462,7835,3847,3988,96
5,67,District - Udham Singh Nagar (12),Urban,15-19,71466,38275,33191,8216,739,369,9080,4206,4874,802
5,67,District - Udham Singh Nagar (12),Urban,20-24,63607,33344,30263,6957,655,300,10191,4054,6137,1443
5,67,District - Udham Singh Nagar (12),Urban,Adolescent (10-19),139843,74739,65104,16188,1499,831,16915,8053,8862,898
5,67,District - Udham Singh Nagar (12),Urban,Youth (15-24),135073,71619,63454,15173,1394,669,19271,8260,11011,2245
5,68,District - Hardwar (13),Total,All Ages,1890422,1005295,885127,411274,6323,3385,712068,313884,398184,75953
5,68,District - Hardwar (13),Total,10-14,223784,121098,102686,53259,808,424,21817,10741,11076,691
5,68,District - Hardwar (13),Total,15-19,224345,119864,104481,53664,793,428,25950,11217,14733,6392
5,68,District - Hardwar (13),Total,20-24,193565,103878,89687,41503,584,352,31788,11262,20526,10374
5,68,District - Hardwar (13),Total,Adolescent (10-19),448129,240962,207167,106923,1601,852,47767,21958,25809,7083
5,68,District - Hardwar (13),Total,Youth (15-24),417910,223742,194168,95167,1377,780,57738,22479,35259,16766
5,68,District - Hardwar (13),Rural,All Ages,1197328,633784,563544,307320,5249,2810,514712,224731,289981,71227
5,68,District - Hardwar (13),Rural,10-14,154542,83238,71304,41579,690,360,15772,7572,8200,669
5,68,District - Hardwar (13),Rural,15-19,149343,78551,70792,40613,682,371,18541,7443,11098,6103
5,68,District - Hardwar (13),Rural,20-24,117728,62283,55445,29461,460,280,23219,7585,15634,9743
5,68,District - Hardwar (13),Rural,Adolescent (10-19),303885,161789,142096,82192,1372,731,34313,15015,19298,6772
5,68,District - Hardwar (13),Rural,Youth (15-24),267071,140834,126237,70074,1142,651,41760,15028,26732,15846
5,68,District - Hardwar (13),Urban,All Ages,693094,371511,321583,103954,1074,575,197356,89153,108203,4726
5,68,District - Hardwar (13),Urban,10-14,69242,37860,31382,11680,118,64,6045,3169,2876,22
5,68,District - Hardwar (13),Urban,15-19,75002,41313,33689,13051,111,57,7409,3774,3635,289
5,68,District - Hardwar (13),Urban,20-24,75837,41595,34242,12042,124,72,8569,3677,4892,631
5,68,District - Hardwar (13),Urban,Adolescent (10-19),144244,79173,65071,24731,229,121,13454,6943,6511,311
5,68,District - Hardwar (13),Urban,Youth (15-24),150839,82908,67931,25093,235,129,15978,7451,8527,920
6,0,State - HARYANA (06),Total,All Ages,25351462,13494734,11856728,5113615,0,0,8752474,3700667,5051807,891273
6,0,State - HARYANA (06),Total,10-14,2668678,1474136,1194542,593440,0,0,177565,79468,98097,6823
6,0,State - HARYANA (06),Total,15-19,2677390,1487548,1189842,584362,0,0,218511,94184,124327,56522
6,0,State - HARYANA (06),Total,20-24,2567486,1372799,1194687,532241,0,0,308328,111624,196704,121602
6,0,State - HARYANA (06),Total,Adolescent (10-19),5346068,2961684,2384384,1177802,0,0,396076,173652,222424,63345
6,0,State - HARYANA (06),Total,Youth (15-24),5244876,2860347,2384529,1116603,0,0,526839,205808,321031,178124
6,0,State - HARYANA (06),Rural,All Ages,16509359,8774006,7735353,3720109,0,0,6350917,2633907,3717010,808001
6,0,State - HARYANA (06),Rural,10-14,1812859,996086,816773,436573,0,0,118937,50075,68862,6318
6,0,State - HARYANA (06),Rural,15-19,1799991,994391,805600,423281,0,0,152360,60597,91763,52351
6,0,State - HARYANA (06),Rural,20-24,1658579,889577,769002,378892,0,0,217568,74424,143144,111876
6,0,State - HARYANA (06),Rural,Adolescent (10-19),3612850,1990477,1622373,859854,0,0,271297,110672,160625,58669
6,0,State - HARYANA (06),Rural,Youth (15-24),3458570,1883968,1574602,802173,0,0,369928,135021,234907,164227
6,0,State - HARYANA (06),Urban,All Ages,8842103,4720728,4121375,1393506,0,0,2401557,1066760,1334797,83272
6,0,State - HARYANA (06),Urban,10-14,855819,478050,377769,156867,0,0,58628,29393,29235,505
6,0,State - HARYANA (06),Urban,15-19,877399,493157,384242,161081,0,0,66151,33587,32564,4171
6,0,State - HARYANA (06),Urban,20-24,908907,483222,425685,153349,0,0,90760,37200,53560,9726
6,0,State - HARYANA (06),Urban,Adolescent (10-19),1733218,971207,762011,317948,0,0,124779,62980,61799,4676
6,0,State - HARYANA (06),Urban,Youth (15-24),1786306,976379,809927,314430,0,0,156911,70787,86124,13897
6,69,District - Panchkula (01),Total,All Ages,561293,299679,261614,101830,0,0,155975,69817,86158,8630
6,69,District - Panchkula (01),Total,10-14,53025,29298,23727,11470,0,0,4286,2100,2186,79
6,69,District - Panchkula (01),Total,15-19,51584,28517,23067,10906,0,0,3846,1912,1934,437
6,69,District - Panchkula (01),Total,20-24,54745,29406,25339,10497,0,0,5062,2051,3011,1039
6,69,District - Panchkula (01),Total,Adolescent (10-19),104609,57815,46794,22376,0,0,8132,4012,4120,516
6,69,District - Panchkula (01),Total,Youth (15-24),106329,57923,48406,21403,0,0,8908,3963,4945,1476
6,69,District - Panchkula (01),Rural,All Ages,248063,133153,114910,51484,0,0,84636,37227,47409,7061
6,69,District - Panchkula (01),Rural,10-14,25304,13911,11393,5829,0,0,1849,906,943,61
6,69,District - Panchkula (01),Rural,15-19,24384,13240,11144,5537,0,0,1663,833,830,370
6,69,District - Panchkula (01),Rural,20-24,25512,13518,11994,5203,0,0,2413,964,1449,881
6,69,District - Panchkula (01),Rural,Adolescent (10-19),49688,27151,22537,11366,0,0,3512,1739,1773,431
6,69,District - Panchkula (01),Rural,Youth (15-24),49896,26758,23138,10740,0,0,4076,1797,2279,1251
6,69,District - Panchkula (01),Urban,All Ages,313230,166526,146704,50346,0,0,71339,32590,38749,1569
6,69,District - Panchkula (01),Urban,10-14,27721,15387,12334,5641,0,0,2437,1194,1243,18
6,69,District - Panchkula (01),Urban,15-19,27200,15277,11923,5369,0,0,2183,1079,1104,67
6,69,District - Panchkula (01),Urban,20-24,29233,15888,13345,5294,0,0,2649,1087,1562,158
6,69,District - Panchkula (01),Urban,Adolescent (10-19),54921,30664,24257,11010,0,0,4620,2273,2347,85
6,69,District - Panchkula (01),Urban,Youth (15-24),56433,31165,25268,10663,0,0,4832,2166,2666,225
6,70,District - Ambala (02),Total,All Ages,1128350,598703,529647,296246,0,0,310325,137415,172910,41122
6,70,District - Ambala (02),Total,10-14,100432,56826,43606,30322,0,0,4286,2187,2099,169
6,70,District - Ambala (02),Total,15-19,110758,61045,49713,32156,0,0,5049,2617,2432,1982
6,70,District - Ambala (02),Total,20-24,116232,60611,55621,31377,0,0,7813,3254,4559,5068
6,70,District - Ambala (02),Total,Adolescent (10-19),211190,117871,93319,62478,0,0,9335,4804,4531,2151
6,70,District - Ambala (02),Total,Youth (15-24),226990,121656,105334,63533,0,0,12862,5871,6991,7050
6,70,District - Ambala (02),Rural,All Ages,627576,331703,295873,208224,0,0,200934,87421,113513,35672
6,70,District - Ambala (02),Rural,10-14,59209,33515,25694,21665,0,0,2188,1123,1065,150
6,70,District - Ambala (02),Rural,15-19,65483,35870,29613,22807,0,0,2628,1295,1333,1721
6,70,District - Ambala (02),Rural,20-24,64579,32902,31677,21488,0,0,4298,1659,2639,4444
6,70,District - Ambala (02),Rural,Adolescent (10-19),124692,69385,55307,44472,0,0,4816,2418,2398,1871
6,70,District - Ambala (02),Rural,Youth (15-24),130062,68772,61290,44295,0,0,6926,2954,3972,6165
6,70,District - Ambala (02),Urban,All Ages,500774,267000,233774,88022,0,0,109391,49994,59397,5450
6,70,District - Ambala (02),Urban,10-14,41223,23311,17912,8657,0,0,2098,1064,1034,19
6,70,District - Ambala (02),Urban,15-19,45275,25175,20100,9349,0,0,2421,1322,1099,261
6,70,District - Ambala (02),Urban,20-24,51653,27709,23944,9889,0,0,3515,1595,1920,624
6,70,District - Ambala (02),Urban,Adolescent (10-19),86498,48486,38012,18006,0,0,4519,2386,2133,280
6,70,District - Ambala (02),Urban,Youth (15-24),96928,52884,44044,19238,0,0,5936,2917,3019,885
6,71,District - Yamunanagar (03),Total,All Ages,1214205,646718,567487,306743,0,0,381748,171925,209823,54043
6,71,District - Yamunanagar (03),Total,10-14,119376,66458,52918,32827,0,0,6248,3095,3153,307
6,71,District - Yamunanagar (03),Total,15-19,127817,71474,56343,34446,0,0,9252,4697,4555,3328
6,71,District - Yamunanagar (03),Total,20-24,126631,66914,59717,32406,0,0,12788,5585,7203,7268
6,71,District - Yamunanagar (03),Total,Adolescent (10-19),247193,137932,109261,67273,0,0,15500,7792,7708,3635
6,71,District - Yamunanagar (03),Total,Youth (15-24),254448,138388,116060,66852,0,0,22040,10282,11758,10596
6,71,District - Yamunanagar (03),Rural,All Ages,741376,393957,347419,233513,0,0,263563,117124,146439,50639
6,71,District - Yamunanagar (03),Rural,10-14,76265,42113,34152,25125,0,0,3672,1707,1965,286
6,71,District - Yamunanagar (03),Rural,15-19,80934,44843,36091,26147,0,0,6095,2922,3173,3152
6,71,District - Yamunanagar (03),Rural,20-24,77049,40311,36738,24188,0,0,8477,3533,4944,6886
6,71,District - Yamunanagar (03),Rural,Adolescent (10-19),157199,86956,70243,51272,0,0,9767,4629,5138,3438
6,71,District - Yamunanagar (03),Rural,Youth (15-24),157983,85154,72829,50335,0,0,14572,6455,8117,10038
6,71,District - Yamunanagar (03),Urban,All Ages,472829,252761,220068,73230,0,0,118185,54801,63384,3404
6,71,District - Yamunanagar (03),Urban,10-14,43111,24345,18766,7702,0,0,2576,1388,1188,21
6,71,District - Yamunanagar (03),Urban,15-19,46883,26631,20252,8299,0,0,3157,1775,1382,176
6,71,District - Yamunanagar (03),Urban,20-24,49582,26603,22979,8218,0,0,4311,2052,2259,382
6,71,District - Yamunanagar (03),Urban,Adolescent (10-19),89994,50976,39018,16001,0,0,5733,3163,2570,197
6,71,District - Yamunanagar (03),Urban,Youth (15-24),96465,53234,43231,16517,0,0,7468,3827,3641,558
6,72,District - Kurukshetra (04),Total,All Ages,964655,510976,453679,215128,0,0,317762,140148,177614,61286
6,72,District - Kurukshetra (04),Total,10-14,92433,52781,39652,22952,0,0,4571,2433,2138,354
6,72,District - Kurukshetra (04),Total,15-19,101895,57326,44569,23672,0,0,5684,3037,2647,3581
6,72,District - Kurukshetra (04),Total,20-24,103442,53295,50147,23440,0,0,9171,3742,5429,7851
6,72,District - Kurukshetra (04),Total,Adolescent (10-19),194328,110107,84221,46624,0,0,10255,5470,4785,3935
6,72,District - Kurukshetra (04),Total,Youth (15-24),205337,110621,94716,47112,0,0,14855,6779,8076,11432
6,72,District - Kurukshetra (04),Rural,All Ages,685430,361020,324410,173560,0,0,247759,107733,140026,58445
6,72,District - Kurukshetra (04),Rural,10-14,67398,38054,29344,18656,0,0,2877,1522,1355,318
6,72,District - Kurukshetra (04),Rural,15-19,72497,40130,32367,18842,0,0,3666,1889,1777,3431
6,72,District - Kurukshetra (04),Rural,20-24,71138,36308,34830,18446,0,0,6594,2552,4042,7538
6,72,District - Kurukshetra (04),Rural,Adolescent (10-19),139895,78184,61711,37498,0,0,6543,3411,3132,3749
6,72,District - Kurukshetra (04),Rural,Youth (15-24),143635,76438,67197,37288,0,0,10260,4441,5819,10969
6,72,District - Kurukshetra (04),Urban,All Ages,279225,149956,129269,41568,0,0,70003,32415,37588,2841
6,72,District - Kurukshetra (04),Urban,10-14,25035,14727,10308,4296,0,0,1694,911,783,36
6,72,District - Kurukshetra (04),Urban,15-19,29398,17196,12202,4830,0,0,2018,1148,870,150
6,72,District - Kurukshetra (04),Urban,20-24,32304,16987,15317,4994,0,0,2577,1190,1387,313
6,72,District - Kurukshetra (04),Urban,Adolescent (10-19),54433,31923,22510,9126,0,0,3712,2059,1653,186
6,72,District - Kurukshetra (04),Urban,Youth (15-24),61702,34183,27519,9824,0,0,4595,2338,2257,463
6,73,District - Kaithal (05),Total,All Ages,1074304,571003,503301,247513,0,0,427775,185221,242554,49233
6,73,District - Kaithal (05),Total,10-14,111341,61997,49344,28358,0,0,4515,2229,2286,301
6,73,District - Kaithal (05),Total,15-19,115813,64753,51060,27469,0,0,6742,2947,3795,2911
6,73,District - Kaithal (05),Total,20-24,110863,59260,51603,25502,0,0,12779,4418,8361,6647
6,73,District - Kaithal (05),Total,Adolescent (10-19),227154,126750,100404,55827,0,0,11257,5176,6081,3212
6,73,District - Kaithal (05),Total,Youth (15-24),226676,124013,102663,52971,0,0,19521,7365,12156,9558
6,73,District - Kaithal (05),Rural,All Ages,838293,445931,392362,202878,0,0,353070,152865,200205,45021
6,73,District - Kaithal (05),Rural,10-14,88319,48865,39454,23458,0,0,3247,1558,1689,279
6,73,District - Kaithal (05),Rural,15-19,90773,50607,40166,22329,0,0,5137,2147,2990,2680
6,73,District - Kaithal (05),Rural,20-24,85876,46191,39685,20626,0,0,10272,3488,6784,6108
6,73,District - Kaithal (05),Rural,Adolescent (10-19),179092,99472,79620,45787,0,0,8384,3705,4679,2959
6,73,District - Kaithal (05),Rural,Youth (15-24),176649,96798,79851,42955,0,0,15409,5635,9774,8788
6,73,District - Kaithal (05),Urban,All Ages,236011,125072,110939,44635,0,0,74705,32356,42349,4212
6,73,District - Kaithal (05),Urban,10-14,23022,13132,9890,4900,0,0,1268,671,597,22
6,73,District - Kaithal (05),Urban,15-19,25040,14146,10894,5140,0,0,1605,800,805,231
6,73,District - Kaithal (05),Urban,20-24,24987,13069,11918,4876,0,0,2507,930,1577,539
6,73,District - Kaithal (05),Urban,Adolescent (10-19),48062,27278,20784,10040,0,0,2873,1471,1402,253
6,73,District - Kaithal (05),Urban,Youth (15-24),50027,27215,22812,10016,0,0,4112,1730,2382,770
6,74,District - Karnal (06),Total,All Ages,1505324,797712,707612,339604,0,0,527311,233196,294115,82915
6,74,District - Karnal (06),Total,10-14,153060,85137,67923,38654,0,0,11206,5874,5332,736
6,74,District - Karnal (06),Total,15-19,157663,87425,70238,38610,0,0,11480,5762,5718,4986
6,74,District - Karnal (06),Total,20-24,157928,82427,75501,36189,0,0,17845,7032,10813,10975
6,74,District - Karnal (06),Total,Adolescent (10-19),310723,172562,138161,77264,0,0,22686,11636,11050,5722
6,74,District - Karnal (06),Total,Youth (15-24),315591,169852,145739,74799,0,0,29325,12794,16531,15961
6,74,District - Karnal (06),Rural,All Ages,1050514,557110,493404,259520,0,0,402631,176224,226407,76343
6,74,District - Karnal (06),Rural,10-14,110604,61256,49348,29809,0,0,7934,4126,3808,691
6,74,District - Karnal (06),Rural,15-19,113937,62863,51074,29717,0,0,8177,3971,4206,4622
6,74,District - Karnal (06),Rural,20-24,110872,57827,53045,27221,0,0,13198,4981,8217,10142
6,74,District - Karnal (06),Rural,Adolescent (10-19),224541,124119,100422,59526,0,0,16111,8097,8014,5313
6,74,District - Karnal (06),Rural,Youth (15-24),224809,120690,104119,56938,0,0,21375,8952,12423,14764
6,74,District - Karnal (06),Urban,All Ages,454810,240602,214208,80084,0,0,124680,56972,67708,6572
6,74,District - Karnal (06),Urban,10-14,42456,23881,18575,8845,0,0,3272,1748,1524,45
6,74,District - Karnal (06),Urban,15-19,43726,24562,19164,8893,0,0,3303,1791,1512,364
6,74,District - Karnal (06),Urban,20-24,47056,24600,22456,8968,0,0,4647,2051,2596,833
6,74,District - Karnal (06),Urban,Adolescent (10-19),86182,48443,37739,17738,0,0,6575,3539,3036,409
6,74,District - Karnal (06),Urban,Youth (15-24),90782,49162,41620,17861,0,0,7950,3842,4108,1197
6,75,District - Panipat (07),Total,All Ages,1205437,646857,558580,206213,0,0,418838,182721,236117,36191
6,75,District - Panipat (07),Total,10-14,131451,73076,58375,24173,0,0,10317,5041,5276,281
6,75,District - Panipat (07),Total,15-19,130630,73051,57579,23884,0,0,11961,5624,6337,2097
6,75,District - Panipat (07),Total,20-24,126101,67661,58440,21682,0,0,16263,6177,10086,4756
6,75,District - Panipat (07),Total,Adolescent (10-19),262081,146127,115954,48057,0,0,22278,10665,11613,2378
6,75,District - Panipat (07),Total,Youth (15-24),256731,140712,116019,45566,0,0,28224,11801,16423,6853
6,75,District - Panipat (07),Rural,All Ages,650352,349642,300710,130212,0,0,247408,105928,141480,31518
6,75,District - Panipat (07),Rural,10-14,73066,40427,32639,15497,0,0,5040,2435,2605,232
6,75,District - Panipat (07),Rural,15-19,72093,39953,32140,15018,0,0,5926,2605,3321,1837
6,75,District - Panipat (07),Rural,20-24,68185,36844,31341,13393,0,0,8568,3055,5513,4220
6,75,District - Panipat (07),Rural,Adolescent (10-19),145159,80380,64779,30515,0,0,10966,5040,5926,2069
6,75,District - Panipat (07),Rural,Youth (15-24),140278,76797,63481,28411,0,0,14494,5660,8834,6057
6,75,District - Panipat (07),Urban,All Ages,555085,297215,257870,76001,0,0,171430,76793,94637,4673
6,75,District - Panipat (07),Urban,10-14,58385,32649,25736,8676,0,0,5277,2606,2671,49
6,75,District - Panipat (07),Urban,15-19,58537,33098,25439,8866,0,0,6035,3019,3016,260
6,75,District - Panipat (07),Urban,20-24,57916,30817,27099,8289,0,0,7695,3122,4573,536
6,75,District - Panipat (07),Urban,Adolescent (10-19),116922,65747,51175,17542,0,0,11312,5625,5687,309
6,75,District - Panipat (07),Urban,Youth (15-24),116453,63915,52538,17155,0,0,13730,6141,7589,796
6,76,District - Sonipat (08),Total,All Ages,1450001,781299,668702,269935,0,0,451685,191418,260267,54040
6,76,District - Sonipat (08),Total,10-14,149734,83654,66080,30615,0,0,6684,3302,3382,447
6,76,District - Sonipat (08),Total,15-19,155325,86501,68824,30923,0,0,8861,4305,4556,3352
6,76,District - Sonipat (08),Total,20-24,150360,81351,69009,28719,0,0,13428,5120,8308,7529
6,76,District - Sonipat (08),Total,Adolescent (10-19),305059,170155,134904,61538,0,0,15545,7607,7938,3799
6,76,District - Sonipat (08),Total,Youth (15-24),305685,167852,137833,59642,0,0,22289,9425,12864,10881
6,76,District - Sonipat (08),Rural,All Ages,996637,538750,457887,192682,0,0,331496,138638,192858,48463
6,76,District - Sonipat (08),Rural,10-14,105473,58543,46930,22076,0,0,4452,2203,2249,421
6,76,District - Sonipat (08),Rural,15-19,109494,60635,48859,22144,0,0,6086,2905,3181,3057
6,76,District - Sonipat (08),Rural,20-24,103171,56658,46513,20089,0,0,9498,3549,5949,6844
6,76,District - Sonipat (08),Rural,Adolescent (10-19),214967,119178,95789,44220,0,0,10538,5108,5430,3478
6,76,District - Sonipat (08),Rural,Youth (15-24),212665,117293,95372,42233,0,0,15584,6454,9130,9901
6,76,District - Sonipat (08),Urban,All Ages,453364,242549,210815,77253,0,0,120189,52780,67409,5577
6,76,District - Sonipat (08),Urban,10-14,44261,25111,19150,8539,0,0,2232,1099,1133,26
6,76,District - Sonipat (08),Urban,15-19,45831,25866,19965,8779,0,0,2775,1400,1375,295
6,76,District - Sonipat (08),Urban,20-24,47189,24693,22496,8630,0,0,3930,1571,2359,685
6,76,District - Sonipat (08),Urban,Adolescent (10-19),90092,50977,39115,17318,0,0,5007,2499,2508,321
6,76,District - Sonipat (08),Urban,Youth (15-24),93020,50559,42461,17409,0,0,6705,2971,3734,980
6,77,District - Jind (09),Total,All Ages,1334152,713006,621146,282351,0,0,501394,210957,290437,56642
6,77,District - Jind (09),Total,10-14,143719,78790,64929,34338,0,0,5803,2871,2932,476
6,77,District - Jind (09),Total,15-19,148805,82665,66140,33231,0,0,9118,4180,4938,3668
6,77,District - Jind (09),Total,20-24,134678,74269,60409,28100,0,0,14550,5367,9183,7883
6,77,District - Jind (09),Total,Adolescent (10-19),292524,161455,131069,67569,0,0,14921,7051,7870,4144
6,77,District - Jind (09),Total,Youth (15-24),283483,156934,126549,61331,0,0,23668,9547,14121,11551
6,77,District - Jind (09),Rural,All Ages,1028569,550519,478050,228804,0,0,410854,172552,238302,52584
6,77,District - Jind (09),Rural,10-14,112717,61392,51325,28020,0,0,4141,2018,2123,460
6,77,District - Jind (09),Rural,15-19,115935,64150,51785,26836,0,0,6934,3078,3856,3475
6,77,District - Jind (09),Rural,20-24,102276,57103,45173,22316,0,0,11616,4184,7432,7390
6,77,District - Jind (09),Rural,Adolescent (10-19),228652,125542,103110,54856,0,0,11075,5096,5979,3935
6,77,District - Jind (09),Rural,Youth (15-24),218211,121253,96958,49152,0,0,18550,7262,11288,10865
6,77,District - Jind (09),Urban,All Ages,305583,162487,143096,53547,0,0,90540,38405,52135,4058
6,77,District - Jind (09),Urban,10-14,31002,17398,13604,6318,0,0,1662,853,809,16
6,77,District - Jind (09),Urban,15-19,32870,18515,14355,6395,0,0,2184,1102,1082,193
6,77,District - Jind (09),Urban,20-24,32402,17166,15236,5784,0,0,2934,1183,1751,493
6,77,District - Jind (09),Urban,Adolescent (10-19),63872,35913,27959,12713,0,0,3846,1955,1891,209
6,77,District - Jind (09),Urban,Youth (15-24),65272,35681,29591,12179,0,0,5118,2285,2833,686
6,78,District - Fatehabad (10),Total,All Ages,942011,495360,446651,284357,0,0,384433,167889,216544,61057
6,78,District - Fatehabad (10),Total,10-14,101504,55299,46205,34388,0,0,6122,3029,3093,541
6,78,District - Fatehabad (10),Total,15-19,104499,57311,47188,32590,0,0,10405,4793,5612,4592
6,78,District - Fatehabad (10),Total,20-24,94904,50448,44456,28295,0,0,15947,6252,9695,8770
6,78,District - Fatehabad (10),Total,Adolescent (10-19),206003,112610,93393,66978,0,0,16527,7822,8705,5133
6,78,District - Fatehabad (10),Total,Youth (15-24),199403,107759,91644,60885,0,0,26352,11045,15307,13362
6,78,District - Fatehabad (10),Rural,All Ages,762423,400814,361609,239215,0,0,327892,142000,185892,58624
6,78,District - Fatehabad (10),Rural,10-14,83736,45433,38303,29086,0,0,4789,2304,2485,526
6,78,District - Fatehabad (10),Rural,15-19,85324,46721,38603,27244,0,0,8608,3879,4729,4442
6,78,District - Fatehabad (10),Rural,20-24,76396,40772,35624,23573,0,0,13426,5124,8302,8466
6,78,District - Fatehabad (10),Rural,Adolescent (10-19),169060,92154,76906,56330,0,0,13397,6183,7214,4968
6,78,District - Fatehabad (10),Rural,Youth (15-24),161720,87493,74227,50817,0,0,22034,9003,13031,12908
6,78,District - Fatehabad (10),Urban,All Ages,179588,94546,85042,45142,0,0,56541,25889,30652,2433
6,78,District - Fatehabad (10),Urban,10-14,17768,9866,7902,5302,0,0,1333,725,608,15
6,78,District - Fatehabad (10),Urban,15-19,19175,10590,8585,5346,0,0,1797,914,883,150
6,78,District - Fatehabad (10),Urban,20-24,18508,9676,8832,4722,0,0,2521,1128,1393,304
6,78,District - Fatehabad (10),Urban,Adolescent (10-19),36943,20456,16487,10648,0,0,3130,1639,1491,165
6,78,District - Fatehabad (10),Urban,Youth (15-24),37683,20266,17417,10068,0,0,4318,2042,2276,454
6,79,District - Sirsa (11),Total,All Ages,1295189,682582,612607,387381,0,0,512292,225614,286678,99117
6,79,District - Sirsa (11),Total,10-14,135756,74811,60945,47337,0,0,9813,5099,4714,1018
6,79,District - Sirsa (11),Total,15-19,141962,77893,64069,44694,0,0,15339,7775,7564,8214
6,79,District - Sirsa (11),Total,20-24,132254,70251,62003,38637,0,0,21505,9220,12285,14249
6,79,District - Sirsa (11),Total,Adolescent (10-19),277718,152704,125014,92031,0,0,25152,12874,12278,9232
6,79,District - Sirsa (11),Total,Youth (15-24),274216,148144,126072,83331,0,0,36844,16995,19849,22463
6,79,District - Sirsa (11),Rural,All Ages,975941,514177,461764,312059,0,0,416306,182187,234119,94458
6,79,District - Sirsa (11),Rural,10-14,104820,57653,47167,38662,0,0,7125,3687,3438,981
6,79,District - Sirsa (11),Rural,15-19,107666,59094,48572,35513,0,0,11697,5822,5875,7878
6,79,District - Sirsa (11),Rural,20-24,98454,52507,45947,30510,0,0,17147,7297,9850,13672
6,79,District - Sirsa (11),Rural,Adolescent (10-19),212486,116747,95739,74175,0,0,18822,9509,9313,8859
6,79,District - Sirsa (11),Rural,Youth (15-24),206120,111601,94519,66023,0,0,28844,13119,15725,21550
6,79,District - Sirsa (11),Urban,All Ages,319248,168405,150843,75322,0,0,95986,43427,52559,4659
6,79,District - Sirsa (11),Urban,10-14,30936,17158,13778,8675,0,0,2688,1412,1276,37
6,79,District - Sirsa (11),Urban,15-19,34296,18799,15497,9181,0,0,3642,1953,1689,336
6,79,District - Sirsa (11),Urban,20-24,33800,17744,16056,8127,0,0,4358,1923,2435,577
6,79,District - Sirsa (11),Urban,Adolescent (10-19),65232,35957,29275,17856,0,0,6330,3365,2965,373
6,79,District - Sirsa (11),Urban,Youth (15-24),68096,36543,31553,17308,0,0,8000,3876,4124,913
6,80,District - Hisar (12),Total,All Ages,1743931,931562,812369,408785,0,0,629620,261362,368258,86056
6,80,District - Hisar (12),Total,10-14,183658,100180,83478,49101,0,0,10220,5034,5186,599
6,80,District - Hisar (12),Total,15-19,190097,105777,84320,47249,0,0,13848,6448,7400,5802
6,80,District - Hisar (12),Total,20-24,177501,98746,78755,41790,0,0,20594,8096,12498,12114
6,80,District - Hisar (12),Total,Adolescent (10-19),373755,205957,167798,96350,0,0,24068,11482,12586,6401
6,80,District - Hisar (12),Total,Youth (15-24),367598,204523,163075,89039,0,0,34442,14544,19898,17916
6,80,District - Hisar (12),Rural,All Ages,1190443,634139,556304,302577,0,0,475647,195113,280534,78160
6,80,District - Hisar (12),Rural,10-14,130444,70490,59954,37019,0,0,6896,3333,3563,556
6,80,District - Hisar (12),Rural,15-19,133592,74015,59577,34785,0,0,9897,4434,5463,5364
6,80,District - Hisar (12),Rural,20-24,119371,67132,52239,30160,0,0,15393,5919,9474,11175
6,80,District - Hisar (12),Rural,Adolescent (10-19),264036,144505,119531,71804,0,0,16793,7767,9026,5920
6,80,District - Hisar (12),Rural,Youth (15-24),252963,141147,111816,64945,0,0,25290,10353,14937,16539
6,80,District - Hisar (12),Urban,All Ages,553488,297423,256065,106208,0,0,153973,66249,87724,7896
6,80,District - Hisar (12),Urban,10-14,53214,29690,23524,12082,0,0,3324,1701,1623,43
6,80,District - Hisar (12),Urban,15-19,56505,31762,24743,12464,0,0,3951,2014,1937,438
6,80,District - Hisar (12),Urban,20-24,58130,31614,26516,11630,0,0,5201,2177,3024,939
6,80,District - Hisar (12),Urban,Adolescent (10-19),109719,61452,48267,24546,0,0,7275,3715,3560,481
6,80,District - Hisar (12),Urban,Youth (15-24),114635,63376,51259,24094,0,0,9152,4191,4961,1377
6,81,District - Bhiwani (13),Total,All Ages,1634445,866672,767773,341162,0,0,564574,223514,341060,52905
6,81,District - Bhiwani (13),Total,10-14,174834,95424,79410,39906,0,0,5598,2724,2874,312
6,81,District - Bhiwani (13),Total,15-19,176797,98593,78204,39021,0,0,8455,3829,4626,3008
6,81,District - Bhiwani (13),Total,20-24,163504,88846,74658,35260,0,0,15023,5386,9637,7706
6,81,District - Bhiwani (13),Total,Adolescent (10-19),351631,194017,157614,78927,0,0,14053,6553,7500,3320
6,81,District - Bhiwani (13),Total,Youth (15-24),340301,187439,152862,74281,0,0,23478,9215,14263,10714
6,81,District - Bhiwani (13),Rural,All Ages,1313123,696212,616911,274877,0,0,472961,184449,288512,47586
6,81,District - Bhiwani (13),Rural,10-14,142601,77517,65084,32219,0,0,4068,1966,2102,282
6,81,District - Bhiwani (13),Rural,15-19,143042,79750,63292,31170,0,0,6413,2734,3679,2752
6,81,District - Bhiwani (13),Rural,20-24,129781,71030,58751,28085,0,0,11954,4114,7840,7018
6,81,District - Bhiwani (13),Rural,Adolescent (10-19),285643,157267,128376,63389,0,0,10481,4700,5781,3034
6,81,District - Bhiwani (13),Rural,Youth (15-24),272823,150780,122043,59255,0,0,18367,6848,11519,9770
6,81,District - Bhiwani (13),Urban,All Ages,321322,170460,150862,66285,0,0,91613,39065,52548,5319
6,81,District - Bhiwani (13),Urban,10-14,32233,17907,14326,7687,0,0,1530,758,772,30
6,81,District - Bhiwani (13),Urban,15-19,33755,18843,14912,7851,0,0,2042,1095,947,256
6,81,District - Bhiwani (13),Urban,20-24,33723,17816,15907,7175,0,0,3069,1272,1797,688
6,81,District - Bhiwani (13),Urban,Adolescent (10-19),65988,36750,29238,15538,0,0,3572,1853,1719,286
6,81,District - Bhiwani (13),Urban,Youth (15-24),67478,36659,30819,15026,0,0,5111,2367,2744,944
6,82,District - Rohtak (14),Total,All Ages,1061204,568479,492725,216889,0,0,313622,132454,181168,20616
6,82,District - Rohtak (14),Total,10-14,105308,58439,46869,24647,0,0,4043,2091,1952,123
6,82,District - Rohtak (14),Total,15-19,112334,63037,49297,25235,0,0,5802,2999,2803,1117
6,82,District - Rohtak (14),Total,20-24,107524,58580,48944,22804,0,0,8446,3476,4970,2664
6,82,District - Rohtak (14),Total,Adolescent (10-19),217642,121476,96166,49882,0,0,9845,5090,4755,1240
6,82,District - Rohtak (14),Total,Youth (15-24),219858,121617,98241,48039,0,0,14248,6475,7773,3781
6,82,District - Rohtak (14),Rural,All Ages,615040,332034,283006,134935,0,0,202373,83184,119189,17578
6,82,District - Rohtak (14),Rural,10-14,63833,35083,28750,15711,0,0,1951,997,954,109
6,82,District - Rohtak (14),Rural,15-19,66292,37304,28988,15581,0,0,3069,1488,1581,983
6,82,District - Rohtak (14),Rural,20-24,61189,34115,27074,13726,0,0,4790,1872,2918,2302
6,82,District - Rohtak (14),Rural,Adolescent (10-19),130125,72387,57738,31292,0,0,5020,2485,2535,1092
6,82,District - Rohtak (14),Rural,Youth (15-24),127481,71419,56062,29307,0,0,7859,3360,4499,3285
6,82,District - Rohtak (14),Urban,All Ages,446164,236445,209719,81954,0,0,111249,49270,61979,3038
6,82,District - Rohtak (14),Urban,10-14,41475,23356,18119,8936,0,0,2092,1094,998,14
6,82,District - Rohtak (14),Urban,15-19,46042,25733,20309,9654,0,0,2733,1511,1222,134
6,82,District - Rohtak (14),Urban,20-24,46335,24465,21870,9078,0,0,3656,1604,2052,362
6,82,District - Rohtak (14),Urban,Adolescent (10-19),87517,49089,38428,18590,0,0,4825,2605,2220,148
6,82,District - Rohtak (14),Urban,Youth (15-24),92377,50198,42179,18732,0,0,6389,3115,3274,496
6,83,District - Jhajjar (15),Total,All Ages,958405,514667,443738,170448,0,0,282314,115187,167127,19433
6,83,District - Jhajjar (15),Total,10-14,95290,53649,41641,18537,0,0,3311,1725,1586,141
6,83,District - Jhajjar (15),Total,15-19,99232,55516,43716,18910,0,0,3966,1972,1994,885
6,83,District - Jhajjar (15),Total,20-24,97455,52164,45291,18031,0,0,6304,2412,3892,2432
6,83,District - Jhajjar (15),Total,Adolescent (10-19),194522,109165,85357,37447,0,0,7277,3697,3580,1026
6,83,District - Jhajjar (15),Total,Youth (15-24),196687,107680,89007,36941,0,0,10270,4384,5886,3317
6,83,District - Jhajjar (15),Rural,All Ages,715066,384219,330847,130913,0,0,218611,87386,131225,17385
6,83,District - Jhajjar (15),Rural,10-14,71366,40034,31332,14342,0,0,2026,1057,969,132
6,83,District - Jhajjar (15),Rural,15-19,74406,41447,32959,14390,0,0,2633,1246,1387,820
6,83,District - Jhajjar (15),Rural,20-24,72149,38925,33224,13493,0,0,4371,1668,2703,2214
6,83,District - Jhajjar (15),Rural,Adolescent (10-19),145772,81481,64291,28732,0,0,4659,2303,2356,952
6,83,District - Jhajjar (15),Rural,Youth (15-24),146555,80372,66183,27883,0,0,7004,2914,4090,3034
6,83,District - Jhajjar (15),Urban,All Ages,243339,130448,112891,39535,0,0,63703,27801,35902,2048
6,83,District - Jhajjar (15),Urban,10-14,23924,13615,10309,4195,0,0,1285,668,617,9
6,83,District - Jhajjar (15),Urban,15-19,24826,14069,10757,4520,0,0,1333,726,607,65
6,83,District - Jhajjar (15),Urban,20-24,25306,13239,12067,4538,0,0,1933,744,1189,218
6,83,District - Jhajjar (15),Urban,Adolescent (10-19),48750,27684,21066,8715,0,0,2618,1394,1224,74
6,83,District - Jhajjar (15),Urban,Youth (15-24),50132,27308,22824,9058,0,0,3266,1470,1796,283
6,84,District - Mahendragarh (16),Total,All Ages,922088,486665,435423,156314,0,0,291833,106225,185608,10773
6,84,District - Mahendragarh (16),Total,10-14,98421,54382,44039,18269,0,0,2950,1461,1489,61
6,84,District - Mahendragarh (16),Total,15-19,100389,55504,44885,18210,0,0,3642,1439,2203,507
6,84,District - Mahendragarh (16),Total,20-24,91649,48700,42949,16223,0,0,6045,1762,4283,1356
6,84,District - Mahendragarh (16),Total,Adolescent (10-19),198810,109886,88924,36479,0,0,6592,2900,3692,568
6,84,District - Mahendragarh (16),Total,Youth (15-24),192038,104204,87834,34433,0,0,9687,3201,6486,1863
6,84,District - Mahendragarh (16),Rural,All Ages,789233,416358,372875,136311,0,0,255791,91617,164174,10103
6,84,District - Mahendragarh (16),Rural,10-14,84900,46815,38085,15943,0,0,2164,1058,1106,57
6,84,District - Mahendragarh (16),Rural,15-19,86506,47784,38722,15828,0,0,2881,1072,1809,482
6,84,District - Mahendragarh (16),Rural,20-24,77898,41655,36243,14135,0,0,5023,1364,3659,1293
6,84,District - Mahendragarh (16),Rural,Adolescent (10-19),171406,94599,76807,31771,0,0,5045,2130,2915,539
6,84,District - Mahendragarh (16),Rural,Youth (15-24),164404,89439,74965,29963,0,0,7904,2436,5468,1775
6,84,District - Mahendragarh (16),Urban,All Ages,132855,70307,62548,20003,0,0,36042,14608,21434,670
6,84,District - Mahendragarh (16),Urban,10-14,13521,7567,5954,2326,0,0,786,403,383,4
6,84,District - Mahendragarh (16),Urban,15-19,13883,7720,6163,2382,0,0,761,367,394,25
6,84,District - Mahendragarh (16),Urban,20-24,13751,7045,6706,2088,0,0,1022,398,624,63
6,84,District - Mahendragarh (16),Urban,Adolescent (10-19),27404,15287,12117,4708,0,0,1547,770,777,29
6,84,District - Mahendragarh (16),Urban,Youth (15-24),27634,14765,12869,4470,0,0,1783,765,1018,88
6,85,District - Rewari (17),Total,All Ages,900332,474335,425997,182606,0,0,263385,98882,164503,10452
6,85,District - Rewari (17),Total,10-14,91291,51004,40287,20350,0,0,3022,1588,1434,49
6,85,District - Rewari (17),Total,15-19,92184,50541,41643,20118,0,0,3392,1622,1770,424
6,85,District - Rewari (17),Total,20-24,91183,46855,44328,19345,0,0,5520,1864,3656,1224
6,85,District - Rewari (17),Total,Adolescent (10-19),183475,101545,81930,40468,0,0,6414,3210,3204,473
6,85,District - Rewari (17),Total,Youth (15-24),183367,97396,85971,39463,0,0,8912,3486,5426,1648
6,85,District - Rewari (17),Rural,All Ages,666902,349710,317192,140637,0,0,202450,73152,129298,9376
6,85,District - Rewari (17),Rural,10-14,68361,38053,30308,15768,0,0,1832,940,892,46
6,85,District - Rewari (17),Rural,15-19,69012,37654,31358,15408,0,0,2106,984,1122,379
6,85,District - Rewari (17),Rural,20-24,66797,34089,32708,14670,0,0,3643,1124,2519,1095
6,85,District - Rewari (17),Rural,Adolescent (10-19),137373,75707,61666,31176,0,0,3938,1924,2014,425
6,85,District - Rewari (17),Rural,Youth (15-24),135809,71743,64066,30078,0,0,5749,2108,3641,1474
6,85,District - Rewari (17),Urban,All Ages,233430,124625,108805,41969,0,0,60935,25730,35205,1076
6,85,District - Rewari (17),Urban,10-14,22930,12951,9979,4582,0,0,1190,648,542,3
6,85,District - Rewari (17),Urban,15-19,23172,12887,10285,4710,0,0,1286,638,648,45
6,85,District - Rewari (17),Urban,20-24,24386,12766,11620,4675,0,0,1877,740,1137,129
6,85,District - Rewari (17),Urban,Adolescent (10-19),46102,25838,20264,9292,0,0,2476,1286,1190,48
6,85,District - Rewari (17),Urban,Youth (15-24),47558,25653,21905,9385,0,0,3163,1378,1785,174
6,86,District - Gurgaon (18),Total,All Ages,1514432,816690,697742,197937,0,0,403316,178024,225292,15725
6,86,District - Gurgaon (18),Total,10-14,140348,77843,62505,22103,0,0,8177,3884,4293,86
6,86,District - Gurgaon (18),Total,15-19,136906,77231,59675,22272,0,0,8656,4288,4368,679
6,86,District - Gurgaon (18),Total,20-24,153479,83840,69639,21903,0,0,14200,5994,8206,1901
6,86,District - Gurgaon (18),Total,Adolescent (10-19),277254,155074,122180,44375,0,0,16833,8172,8661,765
6,86,District - Gurgaon (18),Total,Youth (15-24),290385,161071,129314,44175,0,0,22856,10282,12574,2580
6,86,District - Gurgaon (18),Rural,All Ages,472179,251462,220717,90113,0,0,148092,59174,88918,10113
6,86,District - Gurgaon (18),Rural,10-14,49956,27568,22388,10323,0,0,1978,903,1075,59
6,86,District - Gurgaon (18),Rural,15-19,50022,27449,22573,10235,0,0,2160,833,1327,474
6,86,District - Gurgaon (18),Rural,20-24,50829,26704,24125,9774,0,0,3771,1140,2631,1254
6,86,District - Gurgaon (18),Rural,Adolescent (10-19),99978,55017,44961,20558,0,0,4138,1736,2402,533
6,86,District - Gurgaon (18),Rural,Youth (15-24),100851,54153,46698,20009,0,0,5931,1973,3958,1728
6,86,District - Gurgaon (18),Urban,All Ages,1042253,565228,477025,107824,0,0,255224,118850,136374,5612
6,86,District - Gurgaon (18),Urban,10-14,90392,50275,40117,11780,0,0,6199,2981,3218,27
6,86,District - Gurgaon (18),Urban,15-19,86884,49782,37102,12037,0,0,6496,3455,3041,205
6,86,District - Gurgaon (18),Urban,20-24,102650,57136,45514,12129,0,0,10429,4854,5575,647
6,86,District - Gurgaon (18),Urban,Adolescent (10-19),177276,100057,77219,23817,0,0,12695,6436,6259,232
6,86,District - Gurgaon (18),Urban,Youth (15-24),189534,106918,82616,24166,0,0,16925,8309,8616,852
6,87,District - Mewat (19),Total,All Ages,1089263,571162,518101,75251,0,0,634366,262727,371639,25426
6,87,District - Mewat (19),Total,10-14,160185,86053,74132,10372,0,0,38092,12195,25897,378
6,87,District - Mewat (19),Total,15-19,117902,63285,54617,8848,0,0,40340,11502,28838,2399
6,87,District - Mewat (19),Total,20-24,93889,49309,44580,7350,0,0,41665,11450,30215,4255
6,87,District - Mewat (19),Total,Adolescent (10-19),278087,149338,128749,19220,0,0,78432,23697,54735,2777
6,87,District - Mewat (19),Total,Youth (15-24),211791,112594,99197,16198,0,0,82005,22952,59053,6654
6,87,District - Mewat (19),Rural,All Ages,965157,506086,459071,57238,0,0,580408,240000,340408,24204
6,87,District - Mewat (19),Rural,10-14,143980,77395,66585,7983,0,0,35602,11176,24426,373
6,87,District - Mewat (19),Rural,15-19,104336,55913,48423,6646,0,0,37669,10531,27138,2298
6,87,District - Mewat (19),Rural,20-24,82290,43260,39030,5505,0,0,38725,10601,28124,4053
6,87,District - Mewat (19),Rural,Adolescent (10-19),248316,133308,115008,14629,0,0,73271,21707,51564,2671
6,87,District - Mewat (19),Rural,Youth (15-24),186626,99173,87453,12151,0,0,76394,21132,55262,6351
6,87,District - Mewat (19),Urban,All Ages,124106,65076,59030,18013,0,0,53958,22727,31231,1222
6,87,District - Mewat (19),Urban,10-14,16205,8658,7547,2389,0,0,2490,1019,1471,5
6,87,District - Mewat (19),Urban,15-19,13566,7372,6194,2202,0,0,2671,971,1700,101
6,87,District - Mewat (19),Urban,20-24,11599,6049,5550,1845,0,0,2940,849,2091,202
6,87,District - Mewat (19),Urban,Adolescent (10-19),29771,16030,13741,4591,0,0,5161,1990,3171,106
6,87,District - Mewat (19),Urban,Youth (15-24),25165,13421,11744,4047,0,0,5611,1820,3791,303
6,88,District - Faridabad (20),Total,All Ages,1809733,966110,843623,223799,0,0,536994,231170,305824,19382
6,88,District - Faridabad (20),Total,10-14,193985,106285,87700,27343,0,0,15265,7042,8223,161
6,88,District - Faridabad (20),Total,15-19,185941,103417,82524,26918,0,0,16052,7131,8921,948
6,88,District - Faridabad (20),Total,20-24,183097,95954,87143,24361,0,0,21948,7440,14508,2136
6,88,District - Faridabad (20),Total,Adolescent (10-19),379926,209702,170224,54261,0,0,31317,14173,17144,1109
6,88,District - Faridabad (20),Total,Youth (15-24),369038,199371,169667,51279,0,0,38000,14571,23429,3084
6,88,District - Faridabad (20),Rural,All Ages,370878,198103,172775,71464,0,0,143856,58386,85470,10984
6,88,District - Faridabad (20),Rural,10-14,44691,24457,20234,9043,0,0,4093,1604,2489,110
6,88,District - Faridabad (20),Rural,15-19,42334,23207,19127,8888,0,0,4912,1855,3057,639
6,88,District - Faridabad (20),Rural,20-24,38970,20657,18313,7612,0,0,6413,1923,4490,1392
6,88,District - Faridabad (20),Rural,Adolescent (10-19),87025,47664,39361,17931,0,0,9005,3459,5546,749
6,88,District - Faridabad (20),Rural,Youth (15-24),81304,43864,37440,16500,0,0,11325,3778,7547,2031
6,88,District - Faridabad (20),Urban,All Ages,1438855,768007,670848,152335,0,0,393138,172784,220354,8398
6,88,District - Faridabad (20),Urban,10-14,149294,81828,67466,18300,0,0,11172,5438,5734,51
6,88,District - Faridabad (20),Urban,15-19,143607,80210,63397,18030,0,0,11140,5276,5864,309
6,88,District - Faridabad (20),Urban,20-24,144127,75297,68830,16749,0,0,15535,5517,10018,744
6,88,District - Faridabad (20),Urban,Adolescent (10-19),292901,162038,130863,36330,0,0,22312,10714,11598,360
6,88,District - Faridabad (20),Urban,Youth (15-24),287734,155507,132227,34779,0,0,26675,10793,15882,1053
6,89,District - Palwal (21),Total,All Ages,1042708,554497,488211,203123,0,0,442912,174801,268111,26229
6,89,District - Palwal (21),Total,10-14,133527,72750,60777,27378,0,0,13036,4464,8572,204
6,89,District - Palwal (21),Total,15-19,118857,66686,52171,25000,0,0,16621,5305,11316,1605
6,89,District - Palwal (21),Total,20-24,100067,53912,46155,20330,0,0,21432,5526,15906,3779
6,89,District - Palwal (21),Total,Adolescent (10-19),252384,139436,112948,52378,0,0,29657,9769,19888,1809
6,89,District - Palwal (21),Total,Youth (15-24),218924,120598,98326,45330,0,0,38053,10831,27222,5384
6,89,District - Palwal (21),Rural,All Ages,806164,428907,377257,148893,0,0,364179,141547,222632,23684
6,89,District - Palwal (21),Rural,10-14,105816,57512,48304,20339,0,0,11013,3452,7561,189
6,89,District - Palwal (21),Rural,15-19,91929,51762,40167,18216,0,0,14003,4074,9929,1495
6,89,District - Palwal (21),Rural,20-24,75797,41069,34728,14679,0,0,17978,4313,13665,3489
6,89,District - Palwal (21),Rural,Adolescent (10-19),197745,109274,88471,38555,0,0,25016,7526,17490,1684
6,89,District - Palwal (21),Rural,Youth (15-24),167726,92831,74895,32895,0,0,31981,8387,23594,4984
6,89,District - Palwal (21),Urban,All Ages,236544,125590,110954,54230,0,0,78733,33254,45479,2545
6,89,District - Palwal (21),Urban,10-14,27711,15238,12473,7039,0,0,2023,1012,1011,15
6,89,District - Palwal (21),Urban,15-19,26928,14924,12004,6784,0,0,2618,1231,1387,110
6,89,District - Palwal (21),Urban,20-24,24270,12843,11427,5651,0,0,3454,1213,2241,290
6,89,District - Palwal (21),Urban,Adolescent (10-19),54639,30162,24477,13823,0,0,4641,2243,2398,125
6,89,District - Palwal (21),Urban,Youth (15-24),51198,27767,23431,12435,0,0,6072,2444,3628,400
7,0,State - NCT OF DELHI (07),Total,All Ages,16787941,8987326,7800615,2812309,0,0,4050174,1792470,2257704,31474
7,0,State - NCT OF DELHI (07),Total,10-14,1648147,895446,752701,301623,0,0,74297,38120,36177,223
7,0,State - NCT OF DELHI (07),Total,15-19,1667375,925118,742257,315323,0,0,91686,48685,43001,1466
7,0,State - NCT OF DELHI (07),Total,20-24,1764060,951411,812649,324784,0,0,142825,60344,82481,3579
7,0,State - NCT OF DELHI (07),Total,Adolescent (10-19),3315522,1820564,1494958,616946,0,0,165983,86805,79178,1689
7,0,State - NCT OF DELHI (07),Total,Youth (15-24),3431435,1876529,1554906,640107,0,0,234511,109029,125482,5045
7,0,State - NCT OF DELHI (07),Rural,All Ages,419042,226321,192721,82183,0,0,122442,51994,70448,6123
7,0,State - NCT OF DELHI (07),Rural,10-14,45883,25479,20404,9481,0,0,2138,1036,1102,38
7,0,State - NCT OF DELHI (07),Rural,15-19,44367,24916,19451,9337,0,0,2766,1327,1439,299
7,0,State - NCT OF DELHI (07),Rural,20-24,44407,23805,20602,9038,0,0,4115,1527,2588,692
7,0,State - NCT OF DELHI (07),Rural,Adolescent (10-19),90250,50395,39855,18818,0,0,4904,2363,2541,337
7,0,State - NCT OF DELHI (07),Rural,Youth (15-24),88774,48721,40053,18375,0,0,6881,2854,4027,991
7,0,State - NCT OF DELHI (07),Urban,All Ages,16368899,8761005,7607894,2730126,0,0,3927732,1740476,2187256,25351
7,0,State - NCT OF DELHI (07),Urban,10-14,1602264,869967,732297,292142,0,0,72159,37084,35075,185
7,0,State - NCT OF DELHI (07),Urban,15-19,1623008,900202,722806,305986,0,0,88920,47358,41562,1167
7,0,State - NCT OF DELHI (07),Urban,20-24,1719653,927606,792047,315746,0,0,138710,58817,79893,2887
7,0,State - NCT OF DELHI (07),Urban,Adolescent (10-19),3225272,1770169,1455103,598128,0,0,161079,84442,76637,1352
7,0,State - NCT OF DELHI (07),Urban,Youth (15-24),3342661,1827808,1514853,621732,0,0,227630,106175,121455,4054
7,90,District - North West (01),Total,All Ages,3656539,1960922,1695617,697237,0,0,948684,418970,529714,10553
7,90,District - North West (01),Total,10-14,375025,204688,170337,78217,0,0,18201,9420,8781,54
7,90,District - North West (01),Total,15-19,374987,210646,164341,80617,0,0,22971,12186,10785,517
7,90,District - North West (01),Total,20-24,382984,206924,176060,80745,0,0,35587,14659,20928,1227
7,90,District - North West (01),Total,Adolescent (10-19),750012,415334,334678,158834,0,0,41172,21606,19566,571
7,90,District - North West (01),Total,Youth (15-24),757971,417570,340401,161362,0,0,58558,26845,31713,1744
7,90,District - North West (01),Rural,All Ages,213950,115680,98270,50468,0,0,66623,28637,37986,4288
7,90,District - North West (01),Rural,10-14,24398,13363,11035,5991,0,0,1121,548,573,25
7,90,District - North West (01),Rural,15-19,23613,13286,10327,6037,0,0,1830,894,936,238
7,90,District - North West (01),Rural,20-24,22889,12488,10401,5550,0,0,2649,1031,1618,475
7,90,District - North West (01),Rural,Adolescent (10-19),48011,26649,21362,12028,0,0,2951,1442,1509,263
7,90,District - North West (01),Rural,Youth (15-24),46502,25774,20728,11587,0,0,4479,1925,2554,713
7,90,District - North West (01),Urban,All Ages,3442589,1845242,1597347,646769,0,0,882061,390333,491728,6265
7,90,District - North West (01),Urban,10-14,350627,191325,159302,72226,0,0,17080,8872,8208,29
7,90,District - North West (01),Urban,15-19,351374,197360,154014,74580,0,0,21141,11292,9849,279
7,90,District - North West (01),Urban,20-24,360095,194436,165659,75195,0,0,32938,13628,19310,752
7,90,District - North West (01),Urban,Adolescent (10-19),702001,388685,313316,146806,0,0,38221,20164,18057,308
7,90,District - North West (01),Urban,Youth (15-24),711469,391796,319673,149775,0,0,54079,24920,29159,1031
7,91,District - North (02),Total,All Ages,887978,475002,412976,165663,0,0,206461,93387,113074,1493
7,91,District - North (02),Total,10-14,86043,46487,39556,16885,0,0,3194,1742,1452,11
7,91,District - North (02),Total,15-19,88499,48534,39965,18190,0,0,3957,2232,1725,74
7,91,District - North (02),Total,20-24,92874,49720,43154,19178,0,0,6445,2977,3468,177
7,91,District - North (02),Total,Adolescent (10-19),174542,95021,79521,35075,0,0,7151,3974,3177,85
7,91,District - North (02),Total,Youth (15-24),181373,98254,83119,37368,0,0,10402,5209,5193,251
7,91,District - North (02),Rural,All Ages,17746,9546,8200,1238,0,0,4506,1846,2660,96
7,91,District - North (02),Rural,10-14,2069,1207,862,139,0,0,73,35,38,0
7,91,District - North (02),Rural,15-19,1905,1029,876,123,0,0,65,24,41,7
7,91,District - North (02),Rural,20-24,1800,942,858,115,0,0,125,40,85,20
7,91,District - North (02),Rural,Adolescent (10-19),3974,2236,1738,262,0,0,138,59,79,7
7,91,District - North (02),Rural,Youth (15-24),3705,1971,1734,238,0,0,190,64,126,27
7,91,District - North (02),Urban,All Ages,870232,465456,404776,164425,0,0,201955,91541,110414,1397
7,91,District - North (02),Urban,10-14,83974,45280,38694,16746,0,0,3121,1707,1414,11
7,91,District - North (02),Urban,15-19,86594,47505,39089,18067,0,0,3892,2208,1684,67
7,91,District - North (02),Urban,20-24,91074,48778,42296,19063,0,0,6320,2937,3383,157
7,91,District - North (02),Urban,Adolescent (10-19),170568,92785,77783,34813,0,0,7013,3915,3098,78
7,91,District - North (02),Urban,Youth (15-24),177668,96283,81385,37130,0,0,10212,5145,5067,224
7,92,District - North East (03),Total,All Ages,2241624,1188425,1053199,373758,0,0,630036,275944,354092,1893
7,92,District - North East (03),Total,10-14,246457,132164,114293,40770,0,0,12421,6568,5853,24
7,92,District - North East (03),Total,15-19,250203,135292,114911,43154,0,0,16554,8810,7744,72
7,92,District - North East (03),Total,20-24,245508,129036,116472,43576,0,0,23931,10062,13869,218
7,92,District - North East (03),Total,Adolescent (10-19),496660,267456,229204,83924,0,0,28975,15378,13597,96
7,92,District - North East (03),Total,Youth (15-24),495711,264328,231383,86730,0,0,40485,18872,21613,290
7,92,District - North East (03),Rural,All Ages,21527,11718,9809,2569,0,0,7062,3203,3859,191
7,92,District - North East (03),Rural,10-14,2532,1394,1138,267,0,0,232,107,125,6
7,92,District - North East (03),Rural,15-19,2393,1348,1045,310,0,0,246,145,101,8
7,92,District - North East (03),Rural,20-24,2286,1248,1038,332,0,0,253,108,145,37
7,92,District - North East (03),Rural,Adolescent (10-19),4925,2742,2183,577,0,0,478,252,226,14
7,92,District - North East (03),Rural,Youth (15-24),4679,2596,2083,642,0,0,499,253,246,45
7,92,District - North East (03),Urban,All Ages,2220097,1176707,1043390,371189,0,0,622974,272741,350233,1702
7,92,District - North East (03),Urban,10-14,243925,130770,113155,40503,0,0,12189,6461,5728,18
7,92,District - North East (03),Urban,15-19,247810,133944,113866,42844,0,0,16308,8665,7643,64
7,92,District - North East (03),Urban,20-24,243222,127788,115434,43244,0,0,23678,9954,13724,181
7,92,District - North East (03),Urban,Adolescent (10-19),491735,264714,227021,83347,0,0,28497,15126,13371,82
7,92,District - North East (03),Urban,Youth (15-24),491032,261732,229300,86088,0,0,39986,18619,21367,245
7,93,District - East (04),Total,All Ages,1709346,907500,801846,281422,0,0,356348,159118,197230,2841
7,93,District - East (04),Total,10-14,156648,85026,71622,29796,0,0,5207,2653,2554,50
7,93,District - East (04),Total,15-19,160541,88681,71860,31253,0,0,7063,3873,3190,185
7,93,District - East (04),Total,20-24,175202,93387,81815,32805,0,0,10712,4618,6094,314
7,93,District - East (04),Total,Adolescent (10-19),317189,173707,143482,61049,0,0,12270,6526,5744,235
7,93,District - East (04),Total,Youth (15-24),335743,182068,153675,64058,0,0,17775,8491,9284,499
7,93,District - East (04),Rural,All Ages,3530,1861,1669,57,0,0,544,278,266,21
7,93,District - East (04),Rural,10-14,232,121,111,2,0,0,5,1,4,0
7,93,District - East (04),Rural,15-19,234,135,99,4,0,0,14,7,7,1
7,93,District - East (04),Rural,20-24,343,166,177,5,0,0,14,10,4,4
7,93,District - East (04),Rural,Adolescent (10-19),466,256,210,6,0,0,19,8,11,1
7,93,District - East (04),Rural,Youth (15-24),577,301,276,9,0,0,28,17,11,5
7,93,District - East (04),Urban,All Ages,1705816,905639,800177,281365,0,0,355804,158840,196964,2820
7,93,District - East (04),Urban,10-14,156416,84905,71511,29794,0,0,5202,2652,2550,50
7,93,District - East (04),Urban,15-19,160307,88546,71761,31249,0,0,7049,3866,3183,184
7,93,District - East (04),Urban,20-24,174859,93221,81638,32800,0,0,10698,4608,6090,310
7,93,District - East (04),Urban,Adolescent (10-19),316723,173451,143272,61043,0,0,12251,6518,5733,234
7,93,District - East (04),Urban,Youth (15-24),335166,181767,153399,64049,0,0,17747,8474,9273,494
7,94,District - New Delhi (05),Total,All Ages,142004,77942,64062,33245,0,0,27825,12264,15561,223
7,94,District - New Delhi (05),Total,10-14,12312,6565,5747,3280,0,0,421,199,222,0
7,94,District - New Delhi (05),Total,15-19,14164,7914,6250,3662,0,0,595,334,261,2
7,94,District - New Delhi (05),Total,20-24,16611,9528,7083,4070,0,0,959,491,468,27
7,94,District - New Delhi (05),Total,Adolescent (10-19),26476,14479,11997,6942,0,0,1016,533,483,2
7,94,District - New Delhi (05),Total,Youth (15-24),30775,17442,13333,7732,0,0,1554,825,729,29
7,94,District - New Delhi (05),Rural,All Ages,0,0,0,0,0,0,0,0,0,0
7,94,District - New Delhi (05),Rural,10-14,0,0,0,0,0,0,0,0,0,0
7,94,District - New Delhi (05),Rural,15-19,0,0,0,0,0,0,0,0,0,0
7,94,District - New Delhi (05),Rural,20-24,0,0,0,0,0,0,0,0,0,0
7,94,District - New Delhi (05),Rural,Adolescent (10-19),0,0,0,0,0,0,0,0,0,0
7,94,District - New Delhi (05),Rural,Youth (15-24),0,0,0,0,0,0,0,0,0,0
7,94,District - New Delhi (05),Urban,All Ages,142004,77942,64062,33245,0,0,27825,12264,15561,223
7,94,District - New Delhi (05),Urban,10-14,12312,6565,5747,3280,0,0,421,199,222,0
7,94,District - New Delhi (05),Urban,15-19,14164,7914,6250,3662,0,0,595,334,261,2
7,94,District - New Delhi (05),Urban,20-24,16611,9528,7083,4070,0,0,959,491,468,27
7,94,District - New Delhi (05),Urban,Adolescent (10-19),26476,14479,11997,6942,0,0,1016,533,483,2
7,94,District - New Delhi (05),Urban,Youth (15-24),30775,17442,13333,7732,0,0,1554,825,729,29
7,95,District - Central (06),Total,All Ages,582320,307821,274499,143178,0,0,139960,67303,72657,511
7,95,District - Central (06),Total,10-14,50735,26999,23736,12835,0,0,2510,1481,1029,4
7,95,District - Central (06),Total,15-19,55244,30148,25096,14255,0,0,3510,2305,1205,20
7,95,District - Central (06),Total,20-24,62330,33308,29022,16093,0,0,5543,3176,2367,47
7,95,District - Central (06),Total,Adolescent (10-19),105979,57147,48832,27090,0,0,6020,3786,2234,24
7,95,District - Central (06),Total,Youth (15-24),117574,63456,54118,30348,0,0,9053,5481,3572,67
7,95,District - Central (06),Rural,All Ages,0,0,0,0,0,0,0,0,0,0
7,95,District - Central (06),Rural,10-14,0,0,0,0,0,0,0,0,0,0
7,95,District - Central (06),Rural,15-19,0,0,0,0,0,0,0,0,0,0
7,95,District - Central (06),Rural,20-24,0,0,0,0,0,0,0,0,0,0
7,95,District - Central (06),Rural,Adolescent (10-19),0,0,0,0,0,0,0,0,0,0
7,95,District - Central (06),Rural,Youth (15-24),0,0,0,0,0,0,0,0,0,0
7,95,District - Central (06),Urban,All Ages,582320,307821,274499,143178,0,0,139960,67303,72657,511
7,95,District - Central (06),Urban,10-14,50735,26999,23736,12835,0,0,2510,1481,1029,4
7,95,District - Central (06),Urban,15-19,55244,30148,25096,14255,0,0,3510,2305,1205,20
7,95,District - Central (06),Urban,20-24,62330,33308,29022,16093,0,0,5543,3176,2367,47
7,95,District - Central (06),Urban,Adolescent (10-19),105979,57147,48832,27090,0,0,6020,3786,2234,24
7,95,District - Central (06),Urban,Youth (15-24),117574,63456,54118,30348,0,0,9053,5481,3572,67
7,96,District - West (07),Total,All Ages,2543243,1356240,1187003,376472,0,0,582064,262307,319757,3725
7,96,District - West (07),Total,10-14,235420,128650,106770,40142,0,0,12234,6096,6138,43
7,96,District - West (07),Total,15-19,238589,133446,105143,41441,0,0,14628,7798,6830,198
7,96,District - West (07),Total,20-24,257209,139715,117494,42884,0,0,22248,9902,12346,445
7,96,District - West (07),Total,Adolescent (10-19),474009,262096,211913,81583,0,0,26862,13894,12968,241
7,96,District - West (07),Total,Youth (15-24),495798,273161,222637,84325,0,0,36876,17700,19176,643
7,96,District - West (07),Rural,All Ages,6420,3355,3065,1263,0,0,1972,792,1180,68
7,96,District - West (07),Rural,10-14,631,356,275,121,0,0,35,17,18,0
7,96,District - West (07),Rural,15-19,621,342,279,94,0,0,51,27,24,2
7,96,District - West (07),Rural,20-24,668,312,356,131,0,0,55,15,40,10
7,96,District - West (07),Rural,Adolescent (10-19),1252,698,554,215,0,0,86,44,42,2
7,96,District - West (07),Rural,Youth (15-24),1289,654,635,225,0,0,106,42,64,12
7,96,District - West (07),Urban,All Ages,2536823,1352885,1183938,375209,0,0,580092,261515,318577,3657
7,96,District - West (07),Urban,10-14,234789,128294,106495,40021,0,0,12199,6079,6120,43
7,96,District - West (07),Urban,15-19,237968,133104,104864,41347,0,0,14577,7771,6806,196
7,96,District - West (07),Urban,20-24,256541,139403,117138,42753,0,0,22193,9887,12306,435
7,96,District - West (07),Urban,Adolescent (10-19),472757,261398,211359,81368,0,0,26776,13850,12926,239
7,96,District - West (07),Urban,Youth (15-24),494509,272507,222002,84100,0,0,36770,17658,19112,631
7,97,District - South West (08),Total,All Ages,2292958,1246046,1046912,318408,0,0,505269,220785,284484,5277
7,97,District - South West (08),Total,10-14,213188,117472,95716,33513,0,0,8828,4512,4316,21
7,97,District - South West (08),Total,15-19,213416,120442,92974,34498,0,0,8659,4382,4277,182
7,97,District - South West (08),Total,20-24,243304,133568,109736,36608,0,0,15260,5934,9326,586
7,97,District - South West (08),Total,Adolescent (10-19),426604,237914,188690,68011,0,0,17487,8894,8593,203
7,97,District - South West (08),Total,Youth (15-24),456720,254010,202710,71106,0,0,23919,10316,13603,768
7,97,District - South West (08),Rural,All Ages,143676,77342,66334,24619,0,0,37678,15455,22223,1274
7,97,District - South West (08),Rural,10-14,14672,8281,6391,2737,0,0,565,278,287,7
7,97,District - South West (08),Rural,15-19,14197,7917,6280,2537,0,0,450,184,266,41
7,97,District - South West (08),Rural,20-24,15171,7931,7240,2678,0,0,837,258,579,131
7,97,District - South West (08),Rural,Adolescent (10-19),28869,16198,12671,5274,0,0,1015,462,553,48
7,97,District - South West (08),Rural,Youth (15-24),29368,15848,13520,5215,0,0,1287,442,845,172
7,97,District - South West (08),Urban,All Ages,2149282,1168704,980578,293789,0,0,467591,205330,262261,4003
7,97,District - South West (08),Urban,10-14,198516,109191,89325,30776,0,0,8263,4234,4029,14
7,97,District - South West (08),Urban,15-19,199219,112525,86694,31961,0,0,8209,4198,4011,141
7,97,District - South West (08),Urban,20-24,228133,125637,102496,33930,0,0,14423,5676,8747,455
7,97,District - South West (08),Urban,Adolescent (10-19),397735,221716,176019,62737,0,0,16472,8432,8040,155
7,97,District - South West (08),Urban,Youth (15-24),427352,238162,189190,65891,0,0,22632,9874,12758,596
7,98,District - South (09),Total,All Ages,2731929,1467428,1264501,422926,0,0,653527,282392,371135,4958
7,98,District - South (09),Total,10-14,272319,147395,124924,46185,0,0,11281,5449,5832,16
7,98,District - South (09),Total,15-19,271732,150015,121717,48253,0,0,13749,6765,6984,216
7,98,District - South (09),Total,20-24,288038,156225,131813,48825,0,0,22140,8525,13615,538
7,98,District - South (09),Total,Adolescent (10-19),544051,297410,246641,94438,0,0,25030,12214,12816,232
7,98,District - South (09),Total,Youth (15-24),559770,306240,253530,97078,0,0,35889,15290,20599,754
7,98,District - South (09),Rural,All Ages,12193,6819,5374,1969,0,0,4057,1783,2274,185
7,98,District - South (09),Rural,10-14,1349,757,592,224,0,0,107,50,57,0
7,98,District - South (09),Rural,15-19,1404,859,545,232,0,0,110,46,64,2
7,98,District - South (09),Rural,20-24,1250,718,532,227,0,0,182,65,117,15
7,98,District - South (09),Rural,Adolescent (10-19),2753,1616,1137,456,0,0,217,96,121,2
7,98,District - South (09),Rural,Youth (15-24),2654,1577,1077,459,0,0,292,111,181,17
7,98,District - South (09),Urban,All Ages,2719736,1460609,1259127,420957,0,0,649470,280609,368861,4773
7,98,District - South (09),Urban,10-14,270970,146638,124332,45961,0,0,11174,5399,5775,16
7,98,District - South (09),Urban,15-19,270328,149156,121172,48021,0,0,13639,6719,6920,214
7,98,District - South (09),Urban,20-24,286788,155507,131281,48598,0,0,21958,8460,13498,523
7,98,District - South (09),Urban,Adolescent (10-19),541298,295794,245504,93982,0,0,24813,12118,12695,230
7,98,District - South (09),Urban,Youth (15-24),557116,304663,252453,96619,0,0,35597,15179,20418,737
8,0,State - RAJASTHAN (08),Total,All Ages,68548437,35550997,32997440,12221593,9238534,4742943,30273155,11862585,18410570,2195304
8,0,State - RAJASTHAN (08),Total,10-14,8380518,4430696,3949822,1597659,1206884,631562,887923,308395,579528,37491
8,0,State - RAJASTHAN (08),Total,15-19,7314017,3889874,3424143,1348461,972910,499318,1031513,292373,739140,221863
8,0,State - RAJASTHAN (08),Total,20-24,6426494,3377483,3049011,1167780,804375,415594,1478273,359330,1118943,349758
8,0,State - RAJASTHAN (08),Total,Adolescent (10-19),15694535,8320570,7373965,2946120,2179794,1130880,1919436,600768,1318668,259354
8,0,State - RAJASTHAN (08),Total,Youth (15-24),13740511,7267357,6473154,2516241,1777285,914912,2509786,651703,1858083,571621
8,0,State - RAJASTHAN (08),Rural,All Ages,51500352,26641747,24858605,9536963,8693123,4454816,25028566,9737158,15291408,2072869
8,0,State - RAJASTHAN (08),Rural,10-14,6537189,3446732,3090457,1274338,1139707,595273,723650,235768,487882,36104
8,0,State - RAJASTHAN (08),Rural,15-19,5496935,2918083,2578852,1035578,906939,463586,850304,219627,630677,212979
8,0,State - RAJASTHAN (08),Rural,20-24,4682761,2471674,2211087,880708,746487,385208,1244374,283359,961015,333060
8,0,State - RAJASTHAN (08),Rural,Adolescent (10-19),12034124,6364815,5669309,2309916,2046646,1058859,1573954,455395,1118559,249083
8,0,State - RAJASTHAN (08),Rural,Youth (15-24),10179696,5389757,4789939,1916286,1653426,848794,2094678,502986,1591692,546039
8,0,State - RAJASTHAN (08),Urban,All Ages,17048085,8909250,8138835,2684630,545411,288127,5244589,2125427,3119162,122435
8,0,State - RAJASTHAN (08),Urban,10-14,1843329,983964,859365,323321,67177,36289,164273,72627,91646,1387
8,0,State - RAJASTHAN (08),Urban,15-19,1817082,971791,845291,312883,65971,35732,181209,72746,108463,8884
8,0,State - RAJASTHAN (08),Urban,20-24,1743733,905809,837924,287072,57888,30386,233899,75971,157928,16698
8,0,State - RAJASTHAN (08),Urban,Adolescent (10-19),3660411,1955755,1704656,636204,133148,72021,345482,145373,200109,10271
8,0,State - RAJASTHAN (08),Urban,Youth (15-24),3560815,1877600,1683215,599955,123859,66118,415108,148717,266391,25582
8,99,District - Ganganagar (01),Total,All Ages,1969168,1043340,925828,720412,13477,7160,775825,332432,443393,147697
8,99,District - Ganganagar (01),Total,10-14,216564,117199,99365,89981,1574,830,16626,7714,8912,2041
8,99,District - Ganganagar (01),Total,15-19,208095,113978,94117,79913,1611,876,20055,9388,10667,13684
8,99,District - Ganganagar (01),Total,20-24,197601,105612,91989,71279,1442,778,32731,11887,20844,21572
8,99,District - Ganganagar (01),Total,Adolescent (10-19),424659,231177,193482,169894,3185,1706,36681,17102,19579,15725
8,99,District - Ganganagar (01),Total,Youth (15-24),405696,219590,186106,151192,3053,1654,52786,21275,31511,35256
8,99,District - Ganganagar (01),Rural,All Ages,1433736,758269,675467,598772,2989,1639,612364,261334,351030,142257
8,99,District - Ganganagar (01),Rural,10-14,162097,87058,75039,74974,384,201,11612,5308,6304,1968
8,99,District - Ganganagar (01),Rural,15-19,152307,83345,68962,65499,294,161,14598,6692,7906,13202
8,99,District - Ganganagar (01),Rural,20-24,142548,76626,65922,58465,269,146,25487,8870,16617,20832
8,99,District - Ganganagar (01),Rural,Adolescent (10-19),314404,170403,144001,140473,678,362,26210,12000,14210,15170
8,99,District - Ganganagar (01),Rural,Youth (15-24),294855,159971,134884,123964,563,307,40085,15562,24523,34034
8,99,District - Ganganagar (01),Urban,All Ages,535432,285071,250361,121640,10488,5521,163461,71098,92363,5440
8,99,District - Ganganagar (01),Urban,10-14,54467,30141,24326,15007,1190,629,5014,2406,2608,73
8,99,District - Ganganagar (01),Urban,15-19,55788,30633,25155,14414,1317,715,5457,2696,2761,482
8,99,District - Ganganagar (01),Urban,20-24,55053,28986,26067,12814,1173,632,7244,3017,4227,740
8,99,District - Ganganagar (01),Urban,Adolescent (10-19),110255,60774,49481,29421,2507,1344,10471,5102,5369,555
8,99,District - Ganganagar (01),Urban,Youth (15-24),110841,59619,51222,27228,2490,1347,12701,5713,6988,1222
8,100,District - Hanumangarh (02),Total,All Ages,1774692,931184,843508,494189,14289,7578,740556,306903,433653,116715
8,100,District - Hanumangarh (02),Total,10-14,203998,108722,95276,62786,1726,943,15415,6804,8611,1721
8,100,District - Hanumangarh (02),Total,15-19,189917,103691,86226,53734,1647,905,19509,8520,10989,11028
8,100,District - Hanumangarh (02),Total,20-24,174008,94057,79951,47806,1331,725,30643,10631,20012,17553
8,100,District - Hanumangarh (02),Total,Adolescent (10-19),393915,212413,181502,116520,3373,1848,34924,15324,19600,12749
8,100,District - Hanumangarh (02),Total,Youth (15-24),363925,197748,166177,101540,2978,1630,50152,19151,31001,28581
8,100,District - Hanumangarh (02),Rural,All Ages,1424228,746887,677341,435504,5717,3054,621569,256525,365044,110039
8,100,District - Hanumangarh (02),Rural,10-14,166317,88230,78087,55894,708,386,11417,4943,6474,1574
8,100,District - Hanumangarh (02),Rural,15-19,152505,83485,69020,46860,597,328,15080,6545,8535,10496
8,100,District - Hanumangarh (02),Rural,20-24,138343,75265,63078,41685,545,293,24984,8497,16487,16679
8,100,District - Hanumangarh (02),Rural,Adolescent (10-19),318822,171715,147107,102754,1305,714,26497,11488,15009,12070
8,100,District - Hanumangarh (02),Rural,Youth (15-24),290848,158750,132098,88545,1142,621,40064,15042,25022,27175
8,100,District - Hanumangarh (02),Urban,All Ages,350464,184297,166167,58685,8572,4524,118987,50378,68609,6676
8,100,District - Hanumangarh (02),Urban,10-14,37681,20492,17189,6892,1018,557,3998,1861,2137,147
8,100,District - Hanumangarh (02),Urban,15-19,37412,20206,17206,6874,1050,577,4429,1975,2454,532
8,100,District - Hanumangarh (02),Urban,20-24,35665,18792,16873,6121,786,432,5659,2134,3525,874
8,100,District - Hanumangarh (02),Urban,Adolescent (10-19),75093,40698,34395,13766,2068,1134,8427,3836,4591,679
8,100,District - Hanumangarh (02),Urban,Youth (15-24),73077,38998,34079,12995,1836,1009,10088,4109,5979,1406
8,101,District - Bikaner (03),Total,All Ages,2363937,1240801,1123136,493646,7779,4207,1085136,458402,626734,54270
8,101,District - Bikaner (03),Total,10-14,305004,160609,144395,69904,972,523,43568,16702,26866,1289
8,101,District - Bikaner (03),Total,15-19,243460,133073,110387,50386,856,458,43026,15641,27385,7229
8,101,District - Bikaner (03),Total,20-24,225375,120384,104991,46975,842,462,61880,19915,41965,10443
8,101,District - Bikaner (03),Total,Adolescent (10-19),548464,293682,254782,120290,1828,981,86594,32343,54251,8518
8,101,District - Bikaner (03),Total,Youth (15-24),468835,253457,215378,97361,1698,920,104906,35556,69350,17672
8,101,District - Bikaner (03),Rural,All Ages,1563553,821434,742119,397781,3782,2015,824349,349516,474833,50455
8,101,District - Bikaner (03),Rural,10-14,219244,115392,103852,58098,522,289,33382,12303,21079,1226
8,101,District - Bikaner (03),Rural,15-19,163375,90525,72850,39963,408,216,32542,11325,21217,6862
8,101,District - Bikaner (03),Rural,20-24,145568,78618,66950,37011,355,183,48955,15328,33627,9867
8,101,District - Bikaner (03),Rural,Adolescent (10-19),382619,205917,176702,98061,930,505,65924,23628,42296,8088
8,101,District - Bikaner (03),Rural,Youth (15-24),308943,169143,139800,76974,763,399,81497,26653,54844,16729
8,101,District - Bikaner (03),Urban,All Ages,800384,419367,381017,95865,3997,2192,260787,108886,151901,3815
8,101,District - Bikaner (03),Urban,10-14,85760,45217,40543,11806,450,234,10186,4399,5787,63
8,101,District - Bikaner (03),Urban,15-19,80085,42548,37537,10423,448,242,10484,4316,6168,367
8,101,District - Bikaner (03),Urban,20-24,79807,41766,38041,9964,487,279,12925,4587,8338,576
8,101,District - Bikaner (03),Urban,Adolescent (10-19),165845,87765,78080,22229,898,476,20670,8715,11955,430
8,101,District - Bikaner (03),Urban,Youth (15-24),159892,84314,75578,20387,935,521,23409,8903,14506,943
8,102,District - Churu (04),Total,All Ages,2039547,1051446,988101,451721,11245,5903,890278,354717,535561,41473
8,102,District - Churu (04),Total,10-14,260114,136614,123500,62248,1453,790,24243,9197,15046,683
8,102,District - Churu (04),Total,15-19,219978,120142,99836,47672,1257,673,26603,9334,17269,4700
8,102,District - Churu (04),Total,20-24,195969,104564,91405,43146,1184,649,41183,11888,29295,8209
8,102,District - Churu (04),Total,Adolescent (10-19),480092,256756,223336,109920,2710,1463,50846,18531,32315,5383
8,102,District - Churu (04),Total,Youth (15-24),415947,224706,191241,90818,2441,1322,67786,21222,46564,12909
8,102,District - Churu (04),Rural,All Ages,1463312,755028,708284,376554,7644,4003,671813,268772,403041,35119
8,102,District - Churu (04),Rural,10-14,190435,100262,90173,52261,995,548,15544,5814,9730,594
8,102,District - Churu (04),Rural,15-19,156247,86543,69704,39056,837,451,17212,5971,11241,4119
8,102,District - Churu (04),Rural,20-24,136524,73264,63260,35353,772,434,29212,8123,21089,7108
8,102,District - Churu (04),Rural,Adolescent (10-19),346682,186805,159877,91317,1832,999,32756,11785,20971,4713
8,102,District - Churu (04),Rural,Youth (15-24),292771,159807,132964,74409,1609,885,46424,14094,32330,11227
8,102,District - Churu (04),Urban,All Ages,576235,296418,279817,75167,3601,1900,218465,85945,132520,6354
8,102,District - Churu (04),Urban,10-14,69679,36352,33327,9987,458,242,8699,3383,5316,89
8,102,District - Churu (04),Urban,15-19,63731,33599,30132,8616,420,222,9391,3363,6028,581
8,102,District - Churu (04),Urban,20-24,59445,31300,28145,7793,412,215,11971,3765,8206,1101
8,102,District - Churu (04),Urban,Adolescent (10-19),133410,69951,63459,18603,878,464,18090,6746,11344,670
8,102,District - Churu (04),Urban,Youth (15-24),123176,64899,58277,16409,832,437,21362,7128,14234,1682
8,103,District - Jhunjhunun (05),Total,All Ages,2137045,1095896,1041149,360709,41629,21380,766685,280062,486623,34464
8,103,District - Jhunjhunun (05),Total,10-14,255050,136876,118174,46190,5086,2756,10685,4463,6222,183
8,103,District - Jhunjhunun (05),Total,15-19,246559,134248,112311,42479,5025,2737,13149,4669,8480,2536
8,103,District - Jhunjhunun (05),Total,20-24,213012,112035,100977,36250,4395,2340,21011,5464,15547,5741
8,103,District - Jhunjhunun (05),Total,Adolescent (10-19),501609,271124,230485,88669,10111,5493,23834,9132,14702,2719
8,103,District - Jhunjhunun (05),Total,Youth (15-24),459571,246283,213288,78729,9420,5077,34160,10133,24027,8277
8,103,District - Jhunjhunun (05),Rural,All Ages,1647966,842718,805248,285737,36862,18900,601417,217046,384371,31891
8,103,District - Jhunjhunun (05),Rural,10-14,196498,105370,91128,37015,4565,2459,5961,2543,3418,169
8,103,District - Jhunjhunun (05),Rural,15-19,189036,102975,86061,33536,4439,2430,7648,2660,4988,2321
8,103,District - Jhunjhunun (05),Rural,20-24,161448,84870,76578,28364,3789,2045,14081,3362,10719,5335
8,103,District - Jhunjhunun (05),Rural,Adolescent (10-19),385534,208345,177189,70551,9004,4889,13609,5203,8406,2490
8,103,District - Jhunjhunun (05),Rural,Youth (15-24),350484,187845,162639,61900,8228,4475,21729,6022,15707,7656
8,103,District - Jhunjhunun (05),Urban,All Ages,489079,253178,235901,74972,4767,2480,165268,63016,102252,2573
8,103,District - Jhunjhunun (05),Urban,10-14,58552,31506,27046,9175,521,297,4724,1920,2804,14
8,103,District - Jhunjhunun (05),Urban,15-19,57523,31273,26250,8943,586,307,5501,2009,3492,215
8,103,District - Jhunjhunun (05),Urban,20-24,51564,27165,24399,7886,606,295,6930,2102,4828,406
8,103,District - Jhunjhunun (05),Urban,Adolescent (10-19),116075,62779,53296,18118,1107,604,10225,3929,6296,229
8,103,District - Jhunjhunun (05),Urban,Youth (15-24),109087,58438,50649,16829,1192,602,12431,4111,8320,621
8,104,District - Alwar (06),Total,All Ages,3674179,1939026,1735153,653036,289249,153397,1491703,579197,912506,95586
8,104,District - Alwar (06),Total,10-14,454991,244032,210959,86205,37658,20206,31171,10144,21027,1379
8,104,District - Alwar (06),Total,15-19,402634,218083,184551,75093,33603,18459,43480,9806,33674,8316
8,104,District - Alwar (06),Total,20-24,354971,189076,165895,64934,26885,14761,66280,12306,53974,15888
8,104,District - Alwar (06),Total,Adolescent (10-19),857625,462115,395510,161298,71261,38665,74651,19950,54701,9695
8,104,District - Alwar (06),Total,Youth (15-24),757605,407159,350446,140027,60488,33220,109760,22112,87648,24204
8,104,District - Alwar (06),Rural,All Ages,3019728,1589508,1430220,540412,266880,141505,1311730,505778,805952,91604
8,104,District - Alwar (06),Rural,10-14,385406,205869,179537,72348,35054,18769,27387,8365,19022,1346
8,104,District - Alwar (06),Rural,15-19,334527,180542,153985,61727,30770,16920,38933,7994,30939,8084
8,104,District - Alwar (06),Rural,20-24,286857,152937,133920,52487,24344,13416,59407,10235,49172,15362
8,104,District - Alwar (06),Rural,Adolescent (10-19),719933,386411,333522,134075,65824,35689,66320,16359,49961,9430
8,104,District - Alwar (06),Rural,Youth (15-24),621384,333479,287905,114214,55114,30336,98340,18229,80111,23446
8,104,District - Alwar (06),Urban,All Ages,654451,349518,304933,112624,22369,11892,179973,73419,106554,3982
8,104,District - Alwar (06),Urban,10-14,69585,38163,31422,13857,2604,1437,3784,1779,2005,33
8,104,District - Alwar (06),Urban,15-19,68107,37541,30566,13366,2833,1539,4547,1812,2735,232
8,104,District - Alwar (06),Urban,20-24,68114,36139,31975,12447,2541,1345,6873,2071,4802,526
8,104,District - Alwar (06),Urban,Adolescent (10-19),137692,75704,61988,27223,5437,2976,8331,3591,4740,265
8,104,District - Alwar (06),Urban,Youth (15-24),136221,73680,62541,25813,5374,2884,11420,3883,7537,758
8,105,District - Bharatpur (07),Total,All Ages,2548462,1355726,1192736,557305,54090,28705,1067593,411816,655777,89379
8,105,District - Bharatpur (07),Total,10-14,329522,178213,151309,75257,6824,3608,28048,9645,18403,1085
8,105,District - Bharatpur (07),Total,15-19,283999,156802,127197,64237,6748,3569,34477,8984,25493,7728
8,105,District - Bharatpur (07),Total,20-24,239516,130353,109163,53638,5181,2904,50425,9797,40628,14929
8,105,District - Bharatpur (07),Total,Adolescent (10-19),613521,335015,278506,139494,13572,7177,62525,18629,43896,8813
8,105,District - Bharatpur (07),Total,Youth (15-24),523515,287155,236360,117875,11929,6473,84902,18781,66121,22657
8,105,District - Bharatpur (07),Rural,All Ages,2053363,1093357,960006,436158,48554,25911,909959,348313,561646,84051
8,105,District - Bharatpur (07),Rural,10-14,271247,146594,124653,59224,6094,3218,23178,7477,15701,1040
8,105,District - Bharatpur (07),Rural,15-19,226674,125683,100991,48923,5771,3145,28520,6579,21941,7350
8,105,District - Bharatpur (07),Rural,20-24,189364,103699,85665,41127,4599,2613,43081,7466,35615,14070
8,105,District - Bharatpur (07),Rural,Adolescent (10-19),497921,272277,225644,108147,11865,6363,51698,14056,37642,8390
8,105,District - Bharatpur (07),Rural,Youth (15-24),416038,229382,186656,90050,10370,5758,71601,14045,57556,21420
8,105,District - Bharatpur (07),Urban,All Ages,495099,262369,232730,121147,5536,2794,157634,63503,94131,5328
8,105,District - Bharatpur (07),Urban,10-14,58275,31619,26656,16033,730,390,4870,2168,2702,45
8,105,District - Bharatpur (07),Urban,15-19,57325,31119,26206,15314,977,424,5957,2405,3552,378
8,105,District - Bharatpur (07),Urban,20-24,50152,26654,23498,12511,582,291,7344,2331,5013,859
8,105,District - Bharatpur (07),Urban,Adolescent (10-19),115600,62738,52862,31347,1707,814,10827,4573,6254,423
8,105,District - Bharatpur (07),Urban,Youth (15-24),107477,57773,49704,27825,1559,715,13301,4736,8565,1237
8,106,District - Dhaulpur (08),Total,All Ages,1206516,653647,552869,245695,58594,31802,523418,217926,305492,30120
8,106,District - Dhaulpur (08),Total,10-14,169080,93311,75769,35108,8558,4770,12539,5274,7265,442
8,106,District - Dhaulpur (08),Total,15-19,139125,79645,59480,28061,6994,3986,16389,5823,10566,3630
8,106,District - Dhaulpur (08),Total,20-24,109563,61297,48266,22402,5358,3050,24689,6060,18629,5492
8,106,District - Dhaulpur (08),Total,Adolescent (10-19),308205,172956,135249,63169,15552,8756,28928,11097,17831,4072
8,106,District - Dhaulpur (08),Total,Youth (15-24),248688,140942,107746,50463,12352,7036,41078,11883,29195,9122
8,106,District - Dhaulpur (08),Rural,All Ages,959066,520930,438136,201991,55842,30288,428360,176323,252037,26474
8,106,District - Dhaulpur (08),Rural,10-14,136426,75292,61134,28940,8123,4530,8238,3212,5026,384
8,106,District - Dhaulpur (08),Rural,15-19,109037,62816,46221,22440,6610,3764,11633,3512,8121,3248
8,106,District - Dhaulpur (08),Rural,20-24,85208,48190,37018,18182,5083,2907,19555,4135,15420,4929
8,106,District - Dhaulpur (08),Rural,Adolescent (10-19),245463,138108,107355,51380,14733,8294,19871,6724,13147,3632
8,106,District - Dhaulpur (08),Rural,Youth (15-24),194245,111006,83239,40622,11693,6671,31188,7647,23541,8177
8,106,District - Dhaulpur (08),Urban,All Ages,247450,132717,114733,43704,2752,1514,95058,41603,53455,3646
8,106,District - Dhaulpur (08),Urban,10-14,32654,18019,14635,6168,435,240,4301,2062,2239,58
8,106,District - Dhaulpur (08),Urban,15-19,30088,16829,13259,5621,384,222,4756,2311,2445,382
8,106,District - Dhaulpur (08),Urban,20-24,24355,13107,11248,4220,275,143,5134,1925,3209,563
8,106,District - Dhaulpur (08),Urban,Adolescent (10-19),62742,34848,27894,11789,819,462,9057,4373,4684,440
8,106,District - Dhaulpur (08),Urban,Youth (15-24),54443,29936,24507,9841,659,365,9890,4236,5654,945
8,107,District - Karauli (09),Total,All Ages,1458248,783639,674609,354465,324960,176200,652399,251735,400664,45793
8,107,District - Karauli (09),Total,10-14,192468,105034,87434,49213,42948,23173,15837,5158,10679,582
8,107,District - Karauli (09),Total,15-19,162331,92328,70003,40139,37165,21310,21583,5349,16234,4120
8,107,District - Karauli (09),Total,20-24,136903,76349,60554,33865,30020,17316,33636,6415,27221,7886
8,107,District - Karauli (09),Total,Adolescent (10-19),354799,197362,157437,89352,80113,44483,37420,10507,26913,4702
8,107,District - Karauli (09),Total,Youth (15-24),299234,168677,130557,74004,67185,38626,55219,11764,43455,12006
8,107,District - Karauli (09),Rural,All Ages,1240143,668185,571958,313060,314468,170422,568720,218373,350347,43542
8,107,District - Karauli (09),Rural,10-14,165016,90141,74875,43470,41457,22359,12253,3673,8580,544
8,107,District - Karauli (09),Rural,15-19,137554,78852,58702,34960,35764,20487,17597,3868,13729,3930
8,107,District - Karauli (09),Rural,20-24,115339,64809,50530,29622,29045,16725,28908,4917,23991,7542
8,107,District - Karauli (09),Rural,Adolescent (10-19),302570,168993,133577,78430,77221,42846,29850,7541,22309,4474
8,107,District - Karauli (09),Rural,Youth (15-24),252893,143661,109232,64582,64809,37212,46505,8785,37720,11472
8,107,District - Karauli (09),Urban,All Ages,218105,115454,102651,41405,10492,5778,83679,33362,50317,2251
8,107,District - Karauli (09),Urban,10-14,27452,14893,12559,5743,1491,814,3584,1485,2099,38
8,107,District - Karauli (09),Urban,15-19,24777,13476,11301,5179,1401,823,3986,1481,2505,190
8,107,District - Karauli (09),Urban,20-24,21564,11540,10024,4243,975,591,4728,1498,3230,344
8,107,District - Karauli (09),Urban,Adolescent (10-19),52229,28369,23860,10922,2892,1637,7570,2966,4604,228
8,107,District - Karauli (09),Urban,Youth (15-24),46341,25016,21325,9422,2376,1414,8714,2979,5735,534
8,108,District - Sawai Madhopur (10),Total,All Ages,1335551,704031,631520,278789,285848,152745,593803,217847,375956,39308
8,108,District - Sawai Madhopur (10),Total,10-14,167357,89029,78328,36102,35993,19394,15536,4003,11533,644
8,108,District - Sawai Madhopur (10),Total,15-19,147142,79267,67875,31412,32349,17959,22532,4096,18436,3380
8,108,District - Sawai Madhopur (10),Total,20-24,128967,69830,59137,27036,27133,15278,33910,5615,28295,6382
8,108,District - Sawai Madhopur (10),Total,Adolescent (10-19),314499,168296,146203,67514,68342,37353,38068,8099,29969,4024
8,108,District - Sawai Madhopur (10),Total,Youth (15-24),276109,149097,127012,58448,59482,33237,56442,9711,46731,9762
8,108,District - Sawai Madhopur (10),Rural,All Ages,1069084,564592,504492,227374,272573,145421,509452,186339,323113,37691
8,108,District - Sawai Madhopur (10),Rural,10-14,136563,72730,63833,29848,34180,18352,13190,3059,10131,637
8,108,District - Sawai Madhopur (10),Rural,15-19,117108,63279,53829,25152,30506,16918,19581,3130,16451,3328
8,108,District - Sawai Madhopur (10),Rural,20-24,101379,55390,45989,21532,25731,14498,29798,4622,25176,6211
8,108,District - Sawai Madhopur (10),Rural,Adolescent (10-19),253671,136009,117662,55000,64686,35270,32771,6189,26582,3965
8,108,District - Sawai Madhopur (10),Rural,Youth (15-24),218487,118669,99818,46684,56237,31416,49379,7752,41627,9539
8,108,District - Sawai Madhopur (10),Urban,All Ages,266467,139439,127028,51415,13275,7324,84351,31508,52843,1617
8,108,District - Sawai Madhopur (10),Urban,10-14,30794,16299,14495,6254,1813,1042,2346,944,1402,7
8,108,District - Sawai Madhopur (10),Urban,15-19,30034,15988,14046,6260,1843,1041,2951,966,1985,52
8,108,District - Sawai Madhopur (10),Urban,20-24,27588,14440,13148,5504,1402,780,4112,993,3119,171
8,108,District - Sawai Madhopur (10),Urban,Adolescent (10-19),60828,32287,28541,12514,3656,2083,5297,1910,3387,59
8,108,District - Sawai Madhopur (10),Urban,Youth (15-24),57622,30428,27194,11764,3245,1821,7063,1959,5104,223
8,109,District - Dausa (11),Total,All Ages,1634409,857787,776622,354337,433344,228554,696358,260852,435506,32647
8,109,District - Dausa (11),Total,10-14,212022,112239,99783,48220,58587,30892,12893,4208,8685,326
8,109,District - Dausa (11),Total,15-19,185752,99065,86687,40714,51273,27457,18448,3437,15011,2440
8,109,District - Dausa (11),Total,20-24,152129,81011,71118,33434,39256,21205,31884,4099,27785,5429
8,109,District - Dausa (11),Total,Adolescent (10-19),397774,211304,186470,88934,109860,58349,31341,7645,23696,2766
8,109,District - Dausa (11),Total,Youth (15-24),337881,180076,157805,74148,90529,48662,50332,7536,42796,7869
8,109,District - Dausa (11),Rural,All Ages,1432616,751900,680716,317204,419816,221306,635833,238162,397671,31463
8,109,District - Dausa (11),Rural,10-14,188300,99515,88785,43693,56689,29888,11359,3589,7770,313
8,109,District - Dausa (11),Rural,15-19,163044,87042,76002,36381,49309,26362,16686,2872,13814,2363
8,109,District - Dausa (11),Rural,20-24,131974,70478,61496,29493,37979,20498,29526,3569,25957,5297
8,109,District - Dausa (11),Rural,Adolescent (10-19),351344,186557,164787,80074,105998,56250,28045,6461,21584,2676
8,109,District - Dausa (11),Rural,Youth (15-24),295018,157520,137498,65874,87288,46860,46212,6441,39771,7660
8,109,District - Dausa (11),Urban,All Ages,201793,105887,95906,37133,13528,7248,60525,22690,37835,1184
8,109,District - Dausa (11),Urban,10-14,23722,12724,10998,4527,1898,1004,1534,619,915,13
8,109,District - Dausa (11),Urban,15-19,22708,12023,10685,4333,1964,1095,1762,565,1197,77
8,109,District - Dausa (11),Urban,20-24,20155,10533,9622,3941,1277,707,2358,530,1828,132
8,109,District - Dausa (11),Urban,Adolescent (10-19),46430,24747,21683,8860,3862,2099,3296,1184,2112,90
8,109,District - Dausa (11),Urban,Youth (15-24),42863,22556,20307,8274,3241,1802,4120,1095,3025,209
8,110,District - Jaipur (12),Total,All Ages,6626178,3468507,3157671,1003302,527966,276638,2325213,913714,1411499,68390
8,110,District - Jaipur (12),Total,10-14,770941,409156,361785,127383,70754,37716,47575,19497,28078,684
8,110,District - Jaipur (12),Total,15-19,733235,391962,341273,118065,64032,34081,63669,20558,43111,4659
8,110,District - Jaipur (12),Total,20-24,662055,347476,314579,104267,52444,27881,99354,23069,76285,10310
8,110,District - Jaipur (12),Total,Adolescent (10-19),1504176,801118,703058,245448,134786,71797,111244,40055,71189,5343
8,110,District - Jaipur (12),Total,Youth (15-24),1395290,739438,655852,222332,116476,61962,163023,43627,119396,14969
8,110,District - Jaipur (12),Rural,All Ages,3154331,1642924,1511407,529842,393865,205300,1346727,500591,846136,57219
8,110,District - Jaipur (12),Rural,10-14,408001,214766,193235,70294,55060,29195,20856,6764,14092,573
8,110,District - Jaipur (12),Rural,15-19,369571,196280,173291,62127,47366,25105,32388,6705,25683,4135
8,110,District - Jaipur (12),Rural,20-24,307741,163574,144167,52454,37331,19895,58413,9011,49402,8929
8,110,District - Jaipur (12),Rural,Adolescent (10-19),777572,411046,366526,132421,102426,54300,53244,13469,39775,4708
8,110,District - Jaipur (12),Rural,Youth (15-24),677312,359854,317458,114581,84697,45000,90801,15716,75085,13064
8,110,District - Jaipur (12),Urban,All Ages,3471847,1825583,1646264,473460,134101,71338,978486,413123,565363,11171
8,110,District - Jaipur (12),Urban,10-14,362940,194390,168550,57089,15694,8521,26719,12733,13986,111
8,110,District - Jaipur (12),Urban,15-19,363664,195682,167982,55938,16666,8976,31281,13853,17428,524
8,110,District - Jaipur (12),Urban,20-24,354314,183902,170412,51813,15113,7986,40941,14058,26883,1381
8,110,District - Jaipur (12),Urban,Adolescent (10-19),726604,390072,336532,113027,32360,17497,58000,26586,31414,635
8,110,District - Jaipur (12),Urban,Youth (15-24),717978,379584,338394,107751,31779,16962,72222,27911,44311,1905
8,111,District - Sikar (13),Total,All Ages,2677333,1374990,1302343,418806,75349,39098,1025216,379715,645501,42399
8,111,District - Sikar (13),Total,10-14,327776,174000,153776,56309,9602,5102,18299,7427,10872,380
8,111,District - Sikar (13),Total,15-19,315383,169199,146184,51344,9131,5003,22864,7416,15448,3523
8,111,District - Sikar (13),Total,20-24,270760,141689,129071,42570,7828,4212,35961,8725,27236,7168
8,111,District - Sikar (13),Total,Adolescent (10-19),643159,343199,299960,107653,18733,10105,41163,14843,26320,3903
8,111,District - Sikar (13),Total,Youth (15-24),586143,310888,275255,93914,16959,9215,58825,16141,42684,10691
8,111,District - Sikar (13),Rural,All Ages,2043427,1047469,995958,339524,66829,34675,802592,292686,509906,38676
8,111,District - Sikar (13),Rural,10-14,254523,135677,118846,46325,8608,4563,10419,4136,6283,356
8,111,District - Sikar (13),Rural,15-19,241792,130701,111091,41238,8041,4413,13836,4221,9615,3265
8,111,District - Sikar (13),Rural,20-24,201442,105452,95990,33781,6815,3676,24668,5102,19566,6594
8,111,District - Sikar (13),Rural,Adolescent (10-19),496315,266378,229937,87563,16649,8976,24255,8357,15898,3621
8,111,District - Sikar (13),Rural,Youth (15-24),443234,236153,207081,75019,14856,8089,38504,9323,29181,9859
8,111,District - Sikar (13),Urban,All Ages,633906,327521,306385,79282,8520,4423,222624,87029,135595,3723
8,111,District - Sikar (13),Urban,10-14,73253,38323,34930,9984,994,539,7880,3291,4589,24
8,111,District - Sikar (13),Urban,15-19,73591,38498,35093,10106,1090,590,9028,3195,5833,258
8,111,District - Sikar (13),Urban,20-24,69318,36237,33081,8789,1013,536,11293,3623,7670,574
8,111,District - Sikar (13),Urban,Adolescent (10-19),146844,76821,70023,20090,2084,1129,16908,6486,10422,282
8,111,District - Sikar (13),Urban,Youth (15-24),142909,74735,68174,18895,2103,1126,20321,6818,13503,832
8,112,District - Nagaur (14),Total,All Ages,3307743,1696325,1611418,699911,10418,5475,1549119,593575,955544,123675
8,112,District - Nagaur (14),Total,10-14,419958,219160,200798,96781,1402,750,46703,16032,30671,2202
8,112,District - Nagaur (14),Total,15-19,364564,192374,172190,77388,1197,670,56264,15923,40341,13545
8,112,District - Nagaur (14),Total,20-24,311311,163089,148222,65003,944,503,80033,19170,60863,21210
8,112,District - Nagaur (14),Total,Adolescent (10-19),784522,411534,372988,174169,2599,1420,102967,31955,71012,15747
8,112,District - Nagaur (14),Total,Youth (15-24),675875,355463,320412,142391,2141,1173,136297,35093,101204,34755
8,112,District - Nagaur (14),Rural,All Ages,2670539,1368771,1301768,613527,9061,4725,1295118,493534,801584,114145
8,112,District - Nagaur (14),Rural,10-14,340644,177883,162761,85179,1234,655,35932,11437,24495,2034
8,112,District - Nagaur (14),Rural,15-19,291000,154031,136969,67205,1021,571,44557,11545,33012,12694
8,112,District - Nagaur (14),Rural,20-24,245841,129027,116814,56114,822,447,66001,14740,51261,19770
8,112,District - Nagaur (14),Rural,Adolescent (10-19),631644,331914,299730,152384,2255,1226,80489,22982,57507,14728
8,112,District - Nagaur (14),Rural,Youth (15-24),536841,283058,253783,123319,1843,1018,110558,26285,84273,32464
8,112,District - Nagaur (14),Urban,All Ages,637204,327554,309650,86384,1357,750,254001,100041,153960,9530
8,112,District - Nagaur (14),Urban,10-14,79314,41277,38037,11602,168,95,10771,4595,6176,168
8,112,District - Nagaur (14),Urban,15-19,73564,38343,35221,10183,176,99,11707,4378,7329,851
8,112,District - Nagaur (14),Urban,20-24,65470,34062,31408,8889,122,56,14032,4430,9602,1440
8,112,District - Nagaur (14),Urban,Adolescent (10-19),152878,79620,73258,21785,344,194,22478,8973,13505,1019
8,112,District - Nagaur (14),Urban,Youth (15-24),139034,72405,66629,19072,298,155,25739,8808,16931,2291
8,113,District - Jodhpur (15),Total,All Ages,3687165,1923928,1763237,608024,118924,61969,1655633,658175,997458,103001
8,113,District - Jodhpur (15),Total,10-14,466464,244710,221754,84878,17361,9182,64243,22280,41963,2382
8,113,District - Jodhpur (15),Total,15-19,379604,206422,173182,63559,11948,6771,63873,19838,44035,11773
8,113,District - Jodhpur (15),Total,20-24,339183,180125,159058,55562,10377,5370,90419,23972,66447,17215
8,113,District - Jodhpur (15),Total,Adolescent (10-19),846068,451132,394936,148437,29309,15953,128116,42118,85998,14155
8,113,District - Jodhpur (15),Total,Youth (15-24),718787,386547,332240,119121,22325,12141,154292,43810,110482,28988
8,113,District - Jodhpur (15),Rural,All Ages,2422551,1260328,1162223,447037,90825,47248,1264211,494629,769582,96515
8,113,District - Jodhpur (15),Rural,10-14,334443,174537,159906,65877,13658,7146,48852,15132,33720,2326
8,113,District - Jodhpur (15),Rural,15-19,252104,137971,114133,45255,8708,4978,48006,12954,35052,11355
8,113,District - Jodhpur (15),Rural,20-24,211749,113222,98527,38286,7478,3889,70952,16854,54098,16383
8,113,District - Jodhpur (15),Rural,Adolescent (10-19),586547,312508,274039,111132,22366,12124,96858,28086,68772,13681
8,113,District - Jodhpur (15),Rural,Youth (15-24),463853,251193,212660,83541,16186,8867,118958,29808,89150,27738
8,113,District - Jodhpur (15),Urban,All Ages,1264614,663600,601014,160987,28099,14721,391422,163546,227876,6486
8,113,District - Jodhpur (15),Urban,10-14,132021,70173,61848,19001,3703,2036,15391,7148,8243,56
8,113,District - Jodhpur (15),Urban,15-19,127500,68451,59049,18304,3240,1793,15867,6884,8983,418
8,113,District - Jodhpur (15),Urban,20-24,127434,66903,60531,17276,2899,1481,19467,7118,12349,832
8,113,District - Jodhpur (15),Urban,Adolescent (10-19),259521,138624,120897,37305,6943,3829,31258,14032,17226,474
8,113,District - Jodhpur (15),Urban,Youth (15-24),254934,135354,119580,35580,6139,3274,35334,14002,21332,1250
8,114,District - Jaisalmer (16),Total,All Ages,669919,361708,308211,99134,42429,22497,361266,151293,209973,14731
8,114,District - Jaisalmer (16),Total,10-14,89157,48574,40583,14145,6062,3185,17767,6060,11707,275
8,114,District - Jaisalmer (16),Total,15-19,62874,36731,26143,9601,3886,2373,14928,4945,9983,1816
8,114,District - Jaisalmer (16),Total,20-24,58687,32020,26667,8363,3617,1863,20797,6080,14717,2610
8,114,District - Jaisalmer (16),Total,Adolescent (10-19),152031,85305,66726,23746,9948,5558,32695,11005,21690,2091
8,114,District - Jaisalmer (16),Total,Youth (15-24),121561,68751,52810,17964,7503,4236,35725,11025,24700,4426
8,114,District - Jaisalmer (16),Rural,All Ages,580894,312447,268447,89388,37273,19758,331605,139094,192511,14021
8,114,District - Jaisalmer (16),Rural,10-14,79111,43082,36029,12865,5348,2808,16601,5579,11022,272
8,114,District - Jaisalmer (16),Rural,15-19,54930,32318,22612,8548,3392,2072,13941,4570,9371,1756
8,114,District - Jaisalmer (16),Rural,20-24,50211,27385,22826,7396,3163,1639,19383,5659,13724,2491
8,114,District - Jaisalmer (16),Rural,Adolescent (10-19),134041,75400,58641,21413,8740,4880,30542,10149,20393,2028
8,114,District - Jaisalmer (16),Rural,Youth (15-24),105141,59703,45438,15944,6555,3711,33324,10229,23095,4247
8,114,District - Jaisalmer (16),Urban,All Ages,89025,49261,39764,9746,5156,2739,29661,12199,17462,710
8,114,District - Jaisalmer (16),Urban,10-14,10046,5492,4554,1280,714,377,1166,481,685,3
8,114,District - Jaisalmer (16),Urban,15-19,7944,4413,3531,1053,494,301,987,375,612,60
8,114,District - Jaisalmer (16),Urban,20-24,8476,4635,3841,967,454,224,1414,421,993,119
8,114,District - Jaisalmer (16),Urban,Adolescent (10-19),17990,9905,8085,2333,1208,678,2153,856,1297,63
8,114,District - Jaisalmer (16),Urban,Youth (15-24),16420,9048,7372,2020,948,525,2401,796,1605,179
8,115,District - Barmer (17),Total,All Ages,2603751,1369022,1234729,436414,176257,92610,1415429,585561,829868,50355
8,115,District - Barmer (17),Total,10-14,356104,187659,168445,62661,24684,13240,56699,18169,38530,1229
8,115,District - Barmer (17),Total,15-19,253285,141256,112029,43079,16571,9351,53098,16045,37053,7022
8,115,District - Barmer (17),Total,20-24,220757,121144,99613,36127,14171,7500,75601,21289,54312,9242
8,115,District - Barmer (17),Total,Adolescent (10-19),609389,328915,280474,105740,41255,22591,109797,34214,75583,8251
8,115,District - Barmer (17),Total,Youth (15-24),474042,262400,211642,79206,30742,16851,128699,37334,91365,16264
8,115,District - Barmer (17),Rural,All Ages,2421914,1273249,1148665,408568,172185,90489,1355249,562374,792875,49889
8,115,District - Barmer (17),Rural,10-14,335577,176702,158875,59043,24116,12954,54689,17351,37338,1227
8,115,District - Barmer (17),Rural,15-19,235405,131592,103813,39941,16196,9135,51318,15371,35947,6999
8,115,District - Barmer (17),Rural,20-24,202500,111550,90950,33288,13812,7323,73102,20587,52515,9174
8,115,District - Barmer (17),Rural,Adolescent (10-19),570982,308294,262688,98984,40312,22089,106007,32722,73285,8226
8,115,District - Barmer (17),Rural,Youth (15-24),437905,243142,194763,73229,30008,16458,124420,35958,88462,16173
8,115,District - Barmer (17),Urban,All Ages,181837,95773,86064,27846,4072,2121,60180,23187,36993,466
8,115,District - Barmer (17),Urban,10-14,20527,10957,9570,3618,568,286,2010,818,1192,2
8,115,District - Barmer (17),Urban,15-19,17880,9664,8216,3138,375,216,1780,674,1106,23
8,115,District - Barmer (17),Urban,20-24,18257,9594,8663,2839,359,177,2499,702,1797,68
8,115,District - Barmer (17),Urban,Adolescent (10-19),38407,20621,17786,6756,943,502,3790,1492,2298,25
8,115,District - Barmer (17),Urban,Youth (15-24),36137,19258,16879,5977,734,393,4279,1376,2903,91
8,116,District - Jalor (18),Total,All Ages,1828730,936634,892096,357196,178719,93290,999148,392711,606437,87894
8,116,District - Jalor (18),Total,10-14,251587,131592,119995,51535,26116,13906,39779,11453,28326,2778
8,116,District - Jalor (18),Total,15-19,189024,98054,90970,39655,17486,9555,41130,10278,30852,12453
8,116,District - Jalor (18),Total,20-24,153320,79244,74076,30400,14001,7412,55047,12429,42618,13661
8,116,District - Jalor (18),Total,Adolescent (10-19),440611,229646,210965,91190,43602,23461,80909,21731,59178,15231
8,116,District - Jalor (18),Total,Youth (15-24),342344,177298,165046,70055,31487,16967,96177,22707,73470,26114
8,116,District - Jalor (18),Rural,All Ages,1676975,857619,819356,326518,170111,88807,939300,370212,569088,86442
8,116,District - Jalor (18),Rural,10-14,232581,121445,111136,47328,24843,13236,37347,10513,26834,2755
8,116,District - Jalor (18),Rural,15-19,172821,89390,83431,36149,16621,9077,38800,9502,29298,12310
8,116,District - Jalor (18),Rural,20-24,138981,71672,67309,27456,13243,7027,52109,11637,40472,13445
8,116,District - Jalor (18),Rural,Adolescent (10-19),405402,210835,194567,83477,41464,22313,76147,20015,56132,15065
8,116,District - Jalor (18),Rural,Youth (15-24),311802,161062,150740,63605,29864,16104,90909,21139,69770,25755
8,116,District - Jalor (18),Urban,All Ages,151755,79015,72740,30678,8608,4483,59848,22499,37349,1452
8,116,District - Jalor (18),Urban,10-14,19006,10147,8859,4207,1273,670,2432,940,1492,23
8,116,District - Jalor (18),Urban,15-19,16203,8664,7539,3506,865,478,2330,776,1554,143
8,116,District - Jalor (18),Urban,20-24,14339,7572,6767,2944,758,385,2938,792,2146,216
8,116,District - Jalor (18),Urban,Adolescent (10-19),35209,18811,16398,7713,2138,1148,4762,1716,3046,166
8,116,District - Jalor (18),Urban,Youth (15-24),30542,16236,14306,6450,1623,863,5268,1568,3700,359
8,117,District - Sirohi (19),Total,All Ages,1036346,534231,502115,201863,292470,148966,559540,224331,335209,55034
8,117,District - Sirohi (19),Total,10-14,129642,69430,60212,26224,39497,20839,29033,9387,19646,1216
8,117,District - Sirohi (19),Total,15-19,108422,56545,51877,22546,28901,14364,27363,7529,19834,6707
8,117,District - Sirohi (19),Total,20-24,88960,46041,42919,17843,23620,11713,31034,8718,22316,7997
8,117,District - Sirohi (19),Total,Adolescent (10-19),238064,125975,112089,48770,68398,35203,56396,16916,39480,7923
8,117,District - Sirohi (19),Total,Youth (15-24),197382,102586,94796,40389,52521,26077,58397,16247,42150,14704
8,117,District - Sirohi (19),Rural,All Ages,827692,424252,403440,160943,272916,138714,494683,200139,294544,53469
8,117,District - Sirohi (19),Rural,10-14,106598,56883,49715,21504,37069,19557,27112,8646,18466,1194
8,117,District - Sirohi (19),Rural,15-19,86408,44572,41836,17885,26765,13204,25543,6893,18650,6549
8,117,District - Sirohi (19),Rural,20-24,69451,35723,33728,13866,21761,10730,28669,8053,20616,7799
8,117,District - Sirohi (19),Rural,Adolescent (10-19),193006,101455,91551,39389,63834,32761,52655,15539,37116,7743
8,117,District - Sirohi (19),Rural,Youth (15-24),155859,80295,75564,31751,48526,23934,54212,14946,39266,14348
8,117,District - Sirohi (19),Urban,All Ages,208654,109979,98675,40920,19554,10252,64857,24192,40665,1565
8,117,District - Sirohi (19),Urban,10-14,23044,12547,10497,4720,2428,1282,1921,741,1180,22
8,117,District - Sirohi (19),Urban,15-19,22014,11973,10041,4661,2136,1160,1820,636,1184,158
8,117,District - Sirohi (19),Urban,20-24,19509,10318,9191,3977,1859,983,2365,665,1700,198
8,117,District - Sirohi (19),Urban,Adolescent (10-19),45058,24520,20538,9381,4564,2442,3741,1377,2364,180
8,117,District - Sirohi (19),Urban,Youth (15-24),41523,22291,19232,8638,3995,2143,4185,1301,2884,356
8,118,District - Pali (20),Total,All Ages,2037573,1025422,1012151,398096,144578,74369,951880,358041,593839,115844
8,118,District - Pali (20),Total,10-14,256878,134282,122596,53339,19226,10200,26909,8364,18545,1498
8,118,District - Pali (20),Total,15-19,215460,106929,108531,44633,15269,7741,30173,7046,23127,11531
8,118,District - Pali (20),Total,20-24,168425,84822,83603,34209,12059,6254,39881,8766,31115,15740
8,118,District - Pali (20),Total,Adolescent (10-19),472338,241211,231127,97972,34495,17941,57082,15410,41672,13029
8,118,District - Pali (20),Total,Youth (15-24),383885,191751,192134,78842,27328,13995,70054,15812,54242,27271
8,118,District - Pali (20),Rural,All Ages,1577567,787559,790008,321262,131456,67467,793779,298662,495117,109552
8,118,District - Pali (20),Rural,10-14,203796,106340,97456,43503,17560,9328,22405,6680,15725,1444
8,118,District - Pali (20),Rural,15-19,164443,80038,84405,35465,13821,6898,25470,5521,19949,11075
8,118,District - Pali (20),Rural,20-24,123131,61352,61779,26541,10828,5604,33513,7080,26433,14945
8,118,District - Pali (20),Rural,Adolescent (10-19),368239,186378,181861,78968,31381,16226,47875,12201,35674,12519
8,118,District - Pali (20),Rural,Youth (15-24),287574,141390,146184,62006,24649,12502,58983,12601,46382,26020
8,118,District - Pali (20),Urban,All Ages,460006,237863,222143,76834,13122,6902,158101,59379,98722,6292
8,118,District - Pali (20),Urban,10-14,53082,27942,25140,9836,1666,872,4504,1684,2820,54
8,118,District - Pali (20),Urban,15-19,51017,26891,24126,9168,1448,843,4703,1525,3178,456
8,118,District - Pali (20),Urban,20-24,45294,23470,21824,7668,1231,650,6368,1686,4682,795
8,118,District - Pali (20),Urban,Adolescent (10-19),104099,54833,49266,19004,3114,1715,9207,3209,5998,510
8,118,District - Pali (20),Urban,Youth (15-24),96311,50361,45950,16836,2679,1493,11071,3211,7860,1251
8,119,District - Ajmer (21),Total,All Ages,2583052,1324085,1258967,478027,63482,32408,1056379,397817,658562,77796
8,119,District - Ajmer (21),Total,10-14,293108,153529,139579,55752,7644,3987,36218,10564,25654,1274
8,119,District - Ajmer (21),Total,15-19,266355,139030,127325,51816,6402,3300,41509,9807,31702,8039
8,119,District - Ajmer (21),Total,20-24,245003,126630,118373,47902,6068,3166,53650,11627,42023,12321
8,119,District - Ajmer (21),Total,Adolescent (10-19),559463,292559,266904,107568,14046,7287,77727,20371,57356,9313
8,119,District - Ajmer (21),Total,Youth (15-24),511358,265660,245698,99718,12470,6466,95159,21434,73725,20360
8,119,District - Ajmer (21),Rural,All Ages,1547642,789397,758245,256646,48564,24632,782620,287627,494993,74060
8,119,District - Ajmer (21),Rural,10-14,191462,99880,91582,32644,6015,3105,28270,7091,21179,1229
8,119,District - Ajmer (21),Rural,15-19,165002,85824,79178,27906,4644,2388,33088,6559,26529,7814
8,119,District - Ajmer (21),Rural,20-24,141982,74060,67922,23572,4303,2248,43154,8331,34823,11865
8,119,District - Ajmer (21),Rural,Adolescent (10-19),356464,185704,170760,60550,10659,5493,61358,13650,47708,9043
8,119,District - Ajmer (21),Rural,Youth (15-24),306984,159884,147100,51478,8947,4636,76242,14890,61352,19679
8,119,District - Ajmer (21),Urban,All Ages,1035410,534688,500722,221381,14918,7776,273759,110190,163569,3736
8,119,District - Ajmer (21),Urban,10-14,101646,53649,47997,23108,1629,882,7948,3473,4475,45
8,119,District - Ajmer (21),Urban,15-19,101353,53206,48147,23910,1758,912,8421,3248,5173,225
8,119,District - Ajmer (21),Urban,20-24,103021,52570,50451,24330,1765,918,10496,3296,7200,456
8,119,District - Ajmer (21),Urban,Adolescent (10-19),202999,106855,96144,47018,3387,1794,16369,6721,9648,270
8,119,District - Ajmer (21),Urban,Youth (15-24),204374,105776,98598,48240,3523,1830,18917,6544,12373,681
8,120,District - Tonk (22),Total,All Ages,1421326,728136,693190,287903,178207,92677,671667,249807,421860,54875
8,120,District - Tonk (22),Total,10-14,174162,90839,83323,36858,23480,12480,17889,5236,12653,769
8,120,District - Tonk (22),Total,15-19,160156,81588,78568,32675,19774,10545,26440,5316,21124,5237
8,120,District - Tonk (22),Total,20-24,139158,71106,68052,27709,16468,8712,38853,7138,31715,9095
8,120,District - Tonk (22),Total,Adolescent (10-19),334318,172427,161891,69533,43254,23025,44329,10552,33777,6006
8,120,District - Tonk (22),Total,Youth (15-24),299314,152694,146620,60384,36242,19257,65293,12454,52839,14332
8,120,District - Tonk (22),Rural,All Ages,1103603,568045,535558,235975,173948,90447,556901,203514,353387,51596
8,120,District - Tonk (22),Rural,10-14,136922,71674,65248,30624,22886,12171,13604,3312,10292,741
8,120,District - Tonk (22),Rural,15-19,120748,62935,57813,26099,19191,10271,20986,3242,17744,4996
8,120,District - Tonk (22),Rural,20-24,103039,54194,48845,21942,16013,8483,32446,5134,27312,8634
8,120,District - Tonk (22),Rural,Adolescent (10-19),257670,134609,123061,56723,42077,22442,34590,6554,28036,5737
8,120,District - Tonk (22),Rural,Youth (15-24),223787,117129,106658,48041,35204,18754,53432,8376,45056,13630
8,120,District - Tonk (22),Urban,All Ages,317723,160091,157632,51928,4259,2230,114766,46293,68473,3279
8,120,District - Tonk (22),Urban,10-14,37240,19165,18075,6234,594,309,4285,1924,2361,28
8,120,District - Tonk (22),Urban,15-19,39408,18653,20755,6576,583,274,5454,2074,3380,241
8,120,District - Tonk (22),Urban,20-24,36119,16912,19207,5767,455,229,6407,2004,4403,461
8,120,District - Tonk (22),Urban,Adolescent (10-19),76648,37818,38830,12810,1177,583,9739,3998,5741,269
8,120,District - Tonk (22),Urban,Youth (15-24),75527,35565,39962,12343,1038,503,11861,4078,7783,702
8,121,District - Bundi (23),Total,All Ages,1110906,577160,533746,210788,228549,119454,525862,205455,320407,45911
8,121,District - Bundi (23),Total,10-14,132786,70489,62297,26251,27982,14974,14143,4782,9361,576
8,121,District - Bundi (23),Total,15-19,123916,65337,58579,23794,25324,13635,20130,5091,15039,3879
8,121,District - Bundi (23),Total,20-24,109567,57570,51997,20697,22228,11787,30190,7249,22941,7133
8,121,District - Bundi (23),Total,Adolescent (10-19),256702,135826,120876,50045,53306,28609,34273,9873,24400,4455
8,121,District - Bundi (23),Total,Youth (15-24),233483,122907,110576,44491,47552,25422,50320,12340,37980,11012
8,121,District - Bundi (23),Rural,All Ages,888205,461734,426471,168317,217005,113315,454687,178162,276525,43738
8,121,District - Bundi (23),Rural,10-14,108808,57707,51101,21319,26515,14157,12491,4056,8435,567
8,121,District - Bundi (23),Rural,15-19,99101,52334,46767,18720,23949,12860,18013,4331,13682,3769
8,121,District - Bundi (23),Rural,20-24,86303,45528,40775,16121,21129,11232,27153,6379,20774,6884
8,121,District - Bundi (23),Rural,Adolescent (10-19),207909,110041,97868,40039,50464,27017,30504,8387,22117,4336
8,121,District - Bundi (23),Rural,Youth (15-24),185404,97862,87542,34841,45078,24092,45166,10710,34456,10653
8,121,District - Bundi (23),Urban,All Ages,222701,115426,107275,42471,11544,6139,71175,27293,43882,2173
8,121,District - Bundi (23),Urban,10-14,23978,12782,11196,4932,1467,817,1652,726,926,9
8,121,District - Bundi (23),Urban,15-19,24815,13003,11812,5074,1375,775,2117,760,1357,110
8,121,District - Bundi (23),Urban,20-24,23264,12042,11222,4576,1099,555,3037,870,2167,249
8,121,District - Bundi (23),Urban,Adolescent (10-19),48793,25785,23008,10006,2842,1592,3769,1486,2283,119
8,121,District - Bundi (23),Urban,Youth (15-24),48079,25045,23034,9650,2474,1330,5154,1630,3524,359
8,122,District - Bhilwara (24),Total,All Ages,2408523,1220736,1187787,407947,229273,117026,1152397,443154,709243,77499
8,122,District - Bhilwara (24),Total,10-14,273835,141294,132541,49950,26982,14069,37320,10720,26600,1554
8,122,District - Bhilwara (24),Total,15-19,242122,122241,119881,42136,21754,11236,44735,10009,34726,8671
8,122,District - Bhilwara (24),Total,20-24,219337,112481,106856,36851,20213,10438,58637,13160,45477,12155
8,122,District - Bhilwara (24),Total,Adolescent (10-19),515957,263535,252422,92086,48736,25305,82055,20729,61326,10225
8,122,District - Bhilwara (24),Total,Youth (15-24),461459,234722,226737,78987,41967,21674,103372,23169,80203,20826
8,122,District - Bhilwara (24),Rural,All Ages,1895869,955378,940491,331943,214584,109340,998932,382483,616449,73847
8,122,District - Bhilwara (24),Rural,10-14,220554,113146,107408,40976,25278,13152,32780,8850,23930,1499
8,122,District - Bhilwara (24),Rural,15-19,190775,95344,95431,33738,20296,10468,39916,8294,31622,8363
8,122,District - Bhilwara (24),Rural,20-24,167084,85569,81515,28795,18710,9630,52094,11388,40706,11639
8,122,District - Bhilwara (24),Rural,Adolescent (10-19),411329,208490,202839,74714,45574,23620,72696,17144,55552,9862
8,122,District - Bhilwara (24),Rural,Youth (15-24),357859,180913,176946,62533,39006,20098,92010,19682,72328,20002
8,122,District - Bhilwara (24),Urban,All Ages,512654,265358,247296,76004,14689,7686,153465,60671,92794,3652
8,122,District - Bhilwara (24),Urban,10-14,53281,28148,25133,8974,1704,917,4540,1870,2670,55
8,122,District - Bhilwara (24),Urban,15-19,51347,26897,24450,8398,1458,768,4819,1715,3104,308
8,122,District - Bhilwara (24),Urban,20-24,52253,26912,25341,8056,1503,808,6543,1772,4771,516
8,122,District - Bhilwara (24),Urban,Adolescent (10-19),104628,55045,49583,17372,3162,1685,9359,3585,5774,363
8,122,District - Bhilwara (24),Urban,Youth (15-24),103600,53809,49791,16454,2961,1576,11362,3487,7875,824
8,123,District - Rajsamand (25),Total,All Ages,1156597,581339,575258,148168,160809,81173,537458,198005,339453,42579
8,123,District - Rajsamand (25),Total,10-14,135172,70494,64678,17957,19616,10233,10232,3197,7035,693
8,123,District - Rajsamand (25),Total,15-19,115759,57384,58375,15582,14632,7123,13530,2604,10926,4142
8,123,District - Rajsamand (25),Total,20-24,99476,49965,49511,13059,13179,6595,21158,3493,17665,5941
8,123,District - Rajsamand (25),Total,Adolescent (10-19),250931,127878,123053,33539,34248,17356,23762,5801,17961,4835
8,123,District - Rajsamand (25),Total,Youth (15-24),215235,107349,107886,28641,27811,13718,34688,6097,28591,10083
8,123,District - Rajsamand (25),Rural,All Ages,972777,486960,485817,121784,149991,75628,485372,178522,306850,40920
8,123,District - Rajsamand (25),Rural,10-14,115045,59755,55290,14785,18177,9463,9328,2800,6528,677
8,123,District - Rajsamand (25),Rural,15-19,96576,47433,49143,12573,13442,6517,12462,2266,10196,4010
8,123,District - Rajsamand (25),Rural,20-24,81781,40960,40821,10410,12132,6038,19615,3132,16483,5780
8,123,District - Rajsamand (25),Rural,Adolescent (10-19),211621,107188,104433,27358,31619,15980,21790,5066,16724,4687
8,123,District - Rajsamand (25),Rural,Youth (15-24),178357,88393,89964,22983,25574,12555,32077,5398,26679,9790
8,123,District - Rajsamand (25),Urban,All Ages,183820,94379,89441,26384,10818,5545,52086,19483,32603,1659
8,123,District - Rajsamand (25),Urban,10-14,20127,10739,9388,3172,1439,770,904,397,507,16
8,123,District - Rajsamand (25),Urban,15-19,19183,9951,9232,3009,1190,606,1068,338,730,132
8,123,District - Rajsamand (25),Urban,20-24,17695,9005,8690,2649,1047,557,1543,361,1182,161
8,123,District - Rajsamand (25),Urban,Adolescent (10-19),39310,20690,18620,6181,2629,1376,1972,735,1237,148
8,123,District - Rajsamand (25),Urban,Youth (15-24),36878,18956,17922,5658,2237,1163,2611,699,1912,293
8,124,District - Dungarpur (26),Total,All Ages,1388552,696532,692020,52267,983437,491631,706961,280712,426249,22771
8,124,District - Dungarpur (26),Total,10-14,174254,90265,83989,6457,132317,67800,21094,7817,13277,475
8,124,District - Dungarpur (26),Total,15-19,142340,71133,71207,5524,102821,50183,26283,7235,19048,2313
8,124,District - Dungarpur (26),Total,20-24,111791,55505,56286,4477,76618,37766,35054,8948,26106,3243
8,124,District - Dungarpur (26),Total,Adolescent (10-19),316594,161398,155196,11981,235138,117983,47377,15052,32325,2788
8,124,District - Dungarpur (26),Total,Youth (15-24),254131,126638,127493,10001,179439,87949,61337,16183,45154,5556
8,124,District - Dungarpur (26),Rural,All Ages,1299809,651046,648763,44309,967086,483335,683958,271475,412483,22451
8,124,District - Dungarpur (26),Rural,10-14,164892,85173,79719,5464,129876,66542,20581,7607,12974,470
8,124,District - Dungarpur (26),Rural,15-19,133061,66176,66885,4669,100812,49142,25638,7031,18607,2286
8,124,District - Dungarpur (26),Rural,20-24,103249,51194,52055,3706,75175,37062,34200,8692,25508,3207
8,124,District - Dungarpur (26),Rural,Adolescent (10-19),297953,151349,146604,10133,230688,115684,46219,14638,31581,2756
8,124,District - Dungarpur (26),Rural,Youth (15-24),236310,117370,118940,8375,175987,86204,59838,15723,44115,5493
8,124,District - Dungarpur (26),Urban,All Ages,88743,45486,43257,7958,16351,8296,23003,9237,13766,320
8,124,District - Dungarpur (26),Urban,10-14,9362,5092,4270,993,2441,1258,513,210,303,5
8,124,District - Dungarpur (26),Urban,15-19,9279,4957,4322,855,2009,1041,645,204,441,27
8,124,District - Dungarpur (26),Urban,20-24,8542,4311,4231,771,1443,704,854,256,598,36
8,124,District - Dungarpur (26),Urban,Adolescent (10-19),18641,10049,8592,1848,4450,2299,1158,414,744,32
8,124,District - Dungarpur (26),Urban,Youth (15-24),17821,9268,8553,1626,3452,1745,1499,460,1039,63
8,125,District - Banswara (27),Total,All Ages,1797485,907754,889731,80091,1372999,690476,968142,393900,574242,56663
8,125,District - Banswara (27),Total,10-14,224817,115940,108877,9957,180888,92412,35387,12460,22927,1325
8,125,District - Banswara (27),Total,15-19,182340,89545,92795,8060,141928,68115,43510,11570,31940,7168
8,125,District - Banswara (27),Total,20-24,154555,78511,76044,7039,115265,58104,56636,14892,41744,9613
8,125,District - Banswara (27),Total,Adolescent (10-19),407157,205485,201672,18017,322816,160527,78897,24030,54867,8493
8,125,District - Banswara (27),Total,Youth (15-24),336895,168056,168839,15099,257193,126219,100146,26462,73684,16781
8,125,District - Banswara (27),Rural,All Ages,1669864,842767,827097,70767,1358208,683104,935934,380442,555492,56021
8,125,District - Banswara (27),Rural,10-14,212014,109090,102924,8903,179038,91456,34445,12035,22410,1320
8,125,District - Banswara (27),Rural,15-19,170116,83147,86969,7030,140261,67308,42660,11221,31439,7123
8,125,District - Banswara (27),Rural,20-24,142206,72311,69895,6077,113775,57348,55516,14530,40986,9515
8,125,District - Banswara (27),Rural,Adolescent (10-19),382130,192237,189893,15933,319299,158764,77105,23256,53849,8443
8,125,District - Banswara (27),Rural,Youth (15-24),312322,155458,156864,13107,254036,124656,98176,25751,72425,16638
8,125,District - Banswara (27),Urban,All Ages,127621,64987,62634,9324,14791,7372,32208,13458,18750,642
8,125,District - Banswara (27),Urban,10-14,12803,6850,5953,1054,1850,956,942,425,517,5
8,125,District - Banswara (27),Urban,15-19,12224,6398,5826,1030,1667,807,850,349,501,45
8,125,District - Banswara (27),Urban,20-24,12349,6200,6149,962,1490,756,1120,362,758,98
8,125,District - Banswara (27),Urban,Adolescent (10-19),25027,13248,11779,2084,3517,1763,1792,774,1018,50
8,125,District - Banswara (27),Urban,Youth (15-24),24573,12598,11975,1992,3157,1563,1970,711,1259,143
8,126,District - Chittaurgarh (28),Total,All Ages,1544338,783171,761167,250224,201546,101893,722513,268320,454193,73199
8,126,District - Chittaurgarh (28),Total,10-14,160966,84308,76658,27539,22197,11663,16862,5624,11238,1435
8,126,District - Chittaurgarh (28),Total,15-19,149066,75380,73686,24657,18319,9001,23272,5427,17845,7976
8,126,District - Chittaurgarh (28),Total,20-24,141273,71547,69726,23046,17996,9034,35292,7495,27797,11230
8,126,District - Chittaurgarh (28),Total,Adolescent (10-19),310032,159688,150344,52196,40516,20664,40134,11051,29083,9411
8,126,District - Chittaurgarh (28),Total,Youth (15-24),290339,146927,143412,47703,36315,18035,58564,12922,45642,19206
8,126,District - Chittaurgarh (28),Rural,All Ages,1259074,636415,622659,212388,192752,97253,644095,237903,406192,70092
8,126,District - Chittaurgarh (28),Rural,10-14,131964,68911,63053,23460,21194,11104,15214,4902,10312,1403
8,126,District - Chittaurgarh (28),Rural,15-19,120812,60509,60303,20558,17417,8522,21403,4755,16648,7756
8,126,District - Chittaurgarh (28),Rural,20-24,113134,57505,55629,18992,17067,8564,32558,6770,25788,10840
8,126,District - Chittaurgarh (28),Rural,Adolescent (10-19),252776,129420,123356,44018,38611,19626,36617,9657,26960,9159
8,126,District - Chittaurgarh (28),Rural,Youth (15-24),233946,118014,115932,39550,34484,17086,53961,11525,42436,18596
8,126,District - Chittaurgarh (28),Urban,All Ages,285264,146756,138508,37836,8794,4640,78418,30417,48001,3107
8,126,District - Chittaurgarh (28),Urban,10-14,29002,15397,13605,4079,1003,559,1648,722,926,32
8,126,District - Chittaurgarh (28),Urban,15-19,28254,14871,13383,4099,902,479,1869,672,1197,220
8,126,District - Chittaurgarh (28),Urban,20-24,28139,14042,14097,4054,929,470,2734,725,2009,390
8,126,District - Chittaurgarh (28),Urban,Adolescent (10-19),57256,30268,26988,8178,1905,1038,3517,1394,2123,252
8,126,District - Chittaurgarh (28),Urban,Youth (15-24),56393,28913,27480,8153,1831,949,4603,1397,3206,610
8,127,District - Kota (29),Total,All Ages,1951014,1021161,929853,405408,183816,96428,652669,255765,396904,58088
8,127,District - Kota (29),Total,10-14,208391,110727,97664,47410,21044,11244,15576,6747,8829,568
8,127,District - Kota (29),Total,15-19,219713,119125,100588,46060,21408,11545,18844,7120,11724,4215
8,127,District - Kota (29),Total,20-24,208494,109278,99216,43533,19821,10622,28853,8476,20377,8409
8,127,District - Kota (29),Total,Adolescent (10-19),428104,229852,198252,93470,42452,22789,34420,13867,20553,4783
8,127,District - Kota (29),Total,Youth (15-24),428207,228403,199804,89593,41229,22167,47697,15596,32101,12624
8,127,District - Kota (29),Rural,All Ages,774410,401331,373079,181857,126725,65673,318030,118253,199777,50262
8,127,District - Kota (29),Rural,10-14,91722,48074,43648,22483,14742,7748,6588,2489,4099,519
8,127,District - Kota (29),Rural,15-19,87187,45593,41594,20302,14333,7498,8760,2689,6071,3726
8,127,District - Kota (29),Rural,20-24,78075,41432,36643,17923,13001,6984,14569,3567,11002,7441
8,127,District - Kota (29),Rural,Adolescent (10-19),178909,93667,85242,42785,29075,15246,15348,5178,10170,4245
8,127,District - Kota (29),Rural,Youth (15-24),165262,87025,78237,38225,27334,14482,23329,6256,17073,11167
8,127,District - Kota (29),Urban,All Ages,1176604,619830,556774,223551,57091,30755,334639,137512,197127,7826
8,127,District - Kota (29),Urban,10-14,116669,62653,54016,24927,6302,3496,8988,4258,4730,49
8,127,District - Kota (29),Urban,15-19,132526,73532,58994,25758,7075,4047,10084,4431,5653,489
8,127,District - Kota (29),Urban,20-24,130419,67846,62573,25610,6820,3638,14284,4909,9375,968
8,127,District - Kota (29),Urban,Adolescent (10-19),249195,136185,113010,50685,13377,7543,19072,8689,10383,538
8,127,District - Kota (29),Urban,Youth (15-24),262945,141378,121567,51368,13895,7685,24368,9340,15028,1457
8,128,District - Baran (30),Total,All Ages,1222755,633945,588810,221184,276857,143094,529448,201338,328110,75753
8,128,District - Baran (30),Total,10-14,149744,78911,70833,27654,35872,18983,13652,4960,8692,857
8,128,District - Baran (30),Total,15-19,133997,70148,63849,24746,28831,14925,16700,4710,11990,5634
8,128,District - Baran (30),Total,20-24,120005,62696,57309,21923,26632,13583,26724,6007,20717,11848
8,128,District - Baran (30),Total,Adolescent (10-19),283741,149059,134682,52400,64703,33908,30352,9670,20682,6491
8,128,District - Baran (30),Total,Youth (15-24),254002,132844,121158,46669,55463,28508,43424,10717,32707,17482
8,128,District - Baran (30),Rural,All Ages,968541,502228,466313,167196,264327,136520,447118,169637,277481,71811
8,128,District - Baran (30),Rural,10-14,119864,63088,56776,20939,34233,18085,11274,3879,7395,832
8,128,District - Baran (30),Rural,15-19,104997,54927,50070,18377,27313,14130,14112,3678,10434,5404
8,128,District - Baran (30),Rural,20-24,93748,49280,44468,16339,25375,12960,23143,4958,18185,11350
8,128,District - Baran (30),Rural,Adolescent (10-19),224861,118015,106846,39316,61546,32215,25386,7557,17829,6236
8,128,District - Baran (30),Rural,Youth (15-24),198745,104207,94538,34716,52688,27090,37255,8636,28619,16754
8,128,District - Baran (30),Urban,All Ages,254214,131717,122497,53988,12530,6574,82330,31701,50629,3942
8,128,District - Baran (30),Urban,10-14,29880,15823,14057,6715,1639,898,2378,1081,1297,25
8,128,District - Baran (30),Urban,15-19,29000,15221,13779,6369,1518,795,2588,1032,1556,230
8,128,District - Baran (30),Urban,20-24,26257,13416,12841,5584,1257,623,3581,1049,2532,498
8,128,District - Baran (30),Urban,Adolescent (10-19),58880,31044,27836,13084,3157,1693,4966,2113,2853,255
8,128,District - Baran (30),Urban,Youth (15-24),55257,28637,26620,11953,2775,1418,6169,2081,4088,728
8,129,District - Jhalawar (31),Total,All Ages,1411129,725143,685986,243582,182229,94185,671337,258328,413009,96128
8,129,District - Jhalawar (31),Total,10-14,163875,85806,78069,29412,23702,12521,16414,5316,11098,1506
8,129,District - Jhalawar (31),Total,15-19,142442,73615,68827,23908,19548,10107,24275,6007,18268,8871
8,129,District - Jhalawar (31),Total,20-24,132597,68618,63979,22679,16562,8606,37014,8673,28341,14765
8,129,District - Jhalawar (31),Total,Adolescent (10-19),306317,159421,146896,53320,43250,22628,40689,11323,29366,10377
8,129,District - Jhalawar (31),Total,Youth (15-24),275039,142233,132806,46587,36110,18713,61289,14680,46609,23636
8,129,District - Jhalawar (31),Rural,All Ages,1181838,606533,575305,205764,171828,88680,602972,231291,371681,92797
8,129,District - Jhalawar (31),Rural,10-14,139287,72744,66543,24962,22407,11809,14714,4567,10147,1469
8,129,District - Jhalawar (31),Rural,15-19,118995,61176,57819,19805,18350,9430,22464,5324,17140,8674
8,129,District - Jhalawar (31),Rural,20-24,109657,57069,52588,18841,15526,8102,34377,7969,26408,14344
8,129,District - Jhalawar (31),Rural,Adolescent (10-19),258282,133920,124362,44767,40757,21239,37178,9891,27287,10143
8,129,District - Jhalawar (31),Rural,Youth (15-24),228652,118245,110407,38646,33876,17532,56841,13293,43548,23018
8,129,District - Jhalawar (31),Urban,All Ages,229291,118610,110681,37818,10401,5505,68365,27037,41328,3331
8,129,District - Jhalawar (31),Urban,10-14,24588,13062,11526,4450,1295,712,1700,749,951,37
8,129,District - Jhalawar (31),Urban,15-19,23447,12439,11008,4103,1198,677,1811,683,1128,197
8,129,District - Jhalawar (31),Urban,20-24,22940,11549,11391,3838,1036,504,2637,704,1933,421
8,129,District - Jhalawar (31),Urban,Adolescent (10-19),48035,25501,22534,8553,2493,1389,3511,1432,2079,234
8,129,District - Jhalawar (31),Urban,Youth (15-24),46387,23988,22399,7941,2234,1181,4448,1387,3061,618
8,130,District - Udaipur (32),Total,All Ages,3068420,1566801,1501619,188525,1525289,773213,1485791,593357,892434,85328
8,130,District - Udaipur (32),Total,10-14,350612,183909,166703,20999,197958,102540,61264,22593,38671,2486
8,130,District - Udaipur (32),Total,15-19,300339,153796,146543,19959,150719,75110,59463,17255,42208,9041
8,130,District - Udaipur (32),Total,20-24,266253,134535,131718,18047,123836,61535,73195,18880,54315,12468
8,130,District - Udaipur (32),Total,Adolescent (10-19),650951,337705,313246,40958,348677,177650,120727,39848,80879,11527
8,130,District - Udaipur (32),Total,Youth (15-24),566592,288331,278261,38006,274555,136645,132658,36135,96523,21509
8,130,District - Udaipur (32),Rural,All Ages,2459994,1251316,1208678,122385,1483035,751109,1351148,538937,812211,82483
8,130,District - Udaipur (32),Rural,10-14,294772,153725,141047,14257,192609,99754,58643,21384,37259,2463
8,130,District - Udaipur (32),Rural,15-19,241880,122498,119382,12700,145704,72489,57027,16321,40706,8846
8,130,District - Udaipur (32),Rural,20-24,206183,103979,102204,10741,119560,59310,69619,17818,51801,12145
8,130,District - Udaipur (32),Rural,Adolescent (10-19),536652,276223,260429,26957,338313,172243,115670,37705,77965,11309
8,130,District - Udaipur (32),Rural,Youth (15-24),448063,226477,221586,23441,265264,131799,126646,34139,92507,20991
8,130,District - Udaipur (32),Urban,All Ages,608426,315485,292941,66140,42254,22104,134643,54420,80223,2845
8,130,District - Udaipur (32),Urban,10-14,55840,30184,25656,6742,5349,2786,2621,1209,1412,23
8,130,District - Udaipur (32),Urban,15-19,58459,31298,27161,7259,5015,2621,2436,934,1502,195
8,130,District - Udaipur (32),Urban,20-24,60070,30556,29514,7306,4276,2225,3576,1062,2514,323
8,130,District - Udaipur (32),Urban,Adolescent (10-19),114299,61482,52817,14001,10364,5407,5057,2143,2914,218
8,130,District - Udaipur (32),Urban,Youth (15-24),118529,61854,56675,14565,9291,4846,6012,1996,4016,518
8,131,District - Pratapgarh (33),Total,All Ages,867848,437744,430104,60429,550427,276742,466333,187622,278711,39939
8,131,District - Pratapgarh (33),Total,10-14,104119,53744,50375,6994,71119,36651,18304,6398,11906,954
8,131,District - Pratapgarh (33),Total,15-19,84629,41758,42871,5834,54501,26195,20209,5597,14612,4857
8,131,District - Pratapgarh (33),Total,20-24,77513,38823,38690,5709,47401,23470,26618,6997,19621,6860
8,131,District - Pratapgarh (33),Total,Adolescent (10-19),188748,95502,93246,12828,125620,62846,38513,11995,26518,5811
8,131,District - Pratapgarh (33),Total,Youth (15-24),162142,80581,81561,11543,101902,49665,46827,12594,34233,11717
8,131,District - Pratapgarh (33),Rural,All Ages,796041,401171,394870,50476,545422,274133,447969,180510,267459,38277
8,131,District - Pratapgarh (33),Rural,10-14,97060,49997,47063,5839,70470,36286,17984,6272,11712,939
8,131,District - Pratapgarh (33),Rural,15-19,77797,38207,39590,4791,53991,25928,19886,5486,14400,4771
8,131,District - Pratapgarh (33),Rural,20-24,70721,35490,35231,4746,46957,23259,26126,6844,19282,6654
8,131,District - Pratapgarh (33),Rural,Adolescent (10-19),174857,88204,86653,10630,124461,62214,37870,11758,26112,5710
8,131,District - Pratapgarh (33),Rural,Youth (15-24),148518,73697,74821,9537,100948,49187,46012,12330,33682,11425
8,131,District - Pratapgarh (33),Urban,All Ages,71807,36573,35234,9953,5005,2609,18364,7112,11252,1662
8,131,District - Pratapgarh (33),Urban,10-14,7059,3747,3312,1155,649,365,320,126,194,15
8,131,District - Pratapgarh (33),Urban,15-19,6832,3551,3281,1043,510,267,323,111,212,86
8,131,District - Pratapgarh (33),Urban,20-24,6792,3333,3459,963,444,211,492,153,339,206
8,131,District - Pratapgarh (33),Urban,Adolescent (10-19),13891,7298,6593,2198,1159,632,643,237,406,101
8,131,District - Pratapgarh (33),Urban,Youth (15-24),13624,6884,6740,2006,954,478,815,264,551,292
9,0,State - UTTAR PRADESH (09),Total,All Ages,199812341,104480510,95331831,41357608,1134273,581083,85414786,36245546,49169240,9749915
9,0,State - UTTAR PRADESH (09),Total,10-14,25869881,13679154,12190727,5534917,151731,78548,3186722,1499187,1687535,162336
9,0,State - UTTAR PRADESH (09),Total,15-19,23040380,12307573,10732807,4752619,117074,61529,3468923,1493476,1975447,828085
9,0,State - UTTAR PRADESH (09),Total,20-24,17578648,9405485,8173163,3479958,91526,46010,4015229,1409787,2605442,1261664
9,0,State - UTTAR PRADESH (09),Total,Adolescent (10-19),48910261,25986727,22923534,10287536,268805,140077,6655645,2992663,3662982,990421
9,0,State - UTTAR PRADESH (09),Total,Youth (15-24),40619028,21713058,18905970,8232577,208600,107539,7484152,2903263,4580889,2089749
9,0,State - UTTAR PRADESH (09),Rural,All Ages,155317278,80992995,74324283,35685227,1031076,526315,70032598,29199307,40833291,9094209
9,0,State - UTTAR PRADESH (09),Rural,10-14,20773940,10962322,9811618,4843848,139179,71909,2351954,1073759,1278195,153336
9,0,State - UTTAR PRADESH (09),Rural,15-19,17779084,9493418,8285666,4037255,104667,54830,2580881,1042540,1538341,771955
9,0,State - UTTAR PRADESH (09),Rural,20-24,12989044,6927701,6061343,2886277,81160,40395,3166603,1011779,2154824,1175574
9,0,State - UTTAR PRADESH (09),Rural,Adolescent (10-19),38553024,20455740,18097284,8881103,243846,126739,4932835,2116299,2816536,925291
9,0,State - UTTAR PRADESH (09),Rural,Youth (15-24),30768128,16421119,14347009,6923532,185827,95225,5747484,2054319,3693165,1947529
9,0,State - UTTAR PRADESH (09),Urban,All Ages,44495063,23487515,21007548,5672381,103197,54768,15382188,7046239,8335949,655706
9,0,State - UTTAR PRADESH (09),Urban,10-14,5095941,2716832,2379109,691069,12552,6639,834768,425428,409340,9000
9,0,State - UTTAR PRADESH (09),Urban,15-19,5261296,2814155,2447141,715364,12407,6699,888042,450936,437106,56130
9,0,State - UTTAR PRADESH (09),Urban,20-24,4589604,2477784,2111820,593681,10366,5615,848626,398008,450618,86090
9,0,State - UTTAR PRADESH (09),Urban,Adolescent (10-19),10357237,5530987,4826250,1406433,24959,13338,1722810,876364,846446,65130
9,0,State - UTTAR PRADESH (09),Urban,Youth (15-24),9850900,5291939,4558961,1309045,22773,12314,1736668,848944,887724,142220
9,132,District - Saharanpur (01),Total,All Ages,3466382,1834106,1632276,764450,980,517,1389274,613992,775282,211046
9,132,District - Saharanpur (01),Total,10-14,440575,237231,203344,102479,124,69,46539,23227,23312,2477
9,132,District - Saharanpur (01),Total,15-19,429948,230503,199445,101184,92,48,55164,25674,29490,21676
9,132,District - Saharanpur (01),Total,20-24,346128,186749,159379,74586,89,45,65350,25355,39995,30460
9,132,District - Saharanpur (01),Total,Adolescent (10-19),870523,467734,402789,203663,216,117,101703,48901,52802,24153
9,132,District - Saharanpur (01),Total,Youth (15-24),776076,417252,358824,175770,181,93,120514,51029,69485,52136
9,132,District - Saharanpur (01),Rural,All Ages,2399856,1269803,1130053,627371,148,74,1009810,436743,573067,196198
9,132,District - Saharanpur (01),Rural,10-14,317027,170729,146298,85979,18,7,28509,13563,14946,2333
9,132,District - Saharanpur (01),Rural,15-19,301093,160931,140162,83335,11,7,35345,15015,20330,20393
9,132,District - Saharanpur (01),Rural,20-24,229546,123156,106390,59239,6,4,44822,15494,29328,28354
9,132,District - Saharanpur (01),Rural,Adolescent (10-19),618120,331660,286460,169314,29,14,63854,28578,35276,22726
9,132,District - Saharanpur (01),Rural,Youth (15-24),530639,284087,246552,142574,17,11,80167,30509,49658,48747
9,132,District - Saharanpur (01),Urban,All Ages,1066526,564303,502223,137079,832,443,379464,177249,202215,14848
9,132,District - Saharanpur (01),Urban,10-14,123548,66502,57046,16500,106,62,18030,9664,8366,144
9,132,District - Saharanpur (01),Urban,15-19,128855,69572,59283,17849,81,41,19819,10659,9160,1283
9,132,District - Saharanpur (01),Urban,20-24,116582,63593,52989,15347,83,41,20528,9861,10667,2106
9,132,District - Saharanpur (01),Urban,Adolescent (10-19),252403,136074,116329,34349,187,103,37849,20323,17526,1427
9,132,District - Saharanpur (01),Urban,Youth (15-24),245437,133165,112272,33196,164,82,40347,20520,19827,3389
9,133,District - Muzaffarnagar (02),Total,All Ages,4143512,2193434,1950078,561250,317,176,1726173,744906,981267,250584
9,133,District - Muzaffarnagar (02),Total,10-14,541168,293168,248000,77189,33,21,71404,32561,38843,3994
9,133,District - Muzaffarnagar (02),Total,15-19,502400,267392,235008,75334,38,24,77022,31045,45977,25749
9,133,District - Muzaffarnagar (02),Total,20-24,389963,208453,181510,52890,41,22,81709,28137,53572,35452
9,133,District - Muzaffarnagar (02),Total,Adolescent (10-19),1043568,560560,483008,152523,71,45,148426,63606,84820,29743
9,133,District - Muzaffarnagar (02),Total,Youth (15-24),892363,475845,416518,128224,79,46,158731,59182,99549,61201
9,133,District - Muzaffarnagar (02),Rural,All Ages,2952200,1565004,1387196,458494,248,136,1256806,532459,724347,221934
9,133,District - Muzaffarnagar (02),Rural,10-14,395425,214366,181059,64567,24,12,44195,19365,24830,3578
9,133,District - Muzaffarnagar (02),Rural,15-19,359548,191176,168372,61535,30,18,49899,18478,31421,22737
9,133,District - Muzaffarnagar (02),Rural,20-24,268343,143868,124475,41490,35,20,56075,17294,38781,31255
9,133,District - Muzaffarnagar (02),Rural,Adolescent (10-19),754973,405542,349431,126102,54,30,94094,37843,56251,26315
9,133,District - Muzaffarnagar (02),Rural,Youth (15-24),627891,335044,292847,103025,65,38,105974,35772,70202,53992
9,133,District - Muzaffarnagar (02),Urban,All Ages,1191312,628430,562882,102756,69,40,469367,212447,256920,28650
9,133,District - Muzaffarnagar (02),Urban,10-14,145743,78802,66941,12622,9,9,27209,13196,14013,416
9,133,District - Muzaffarnagar (02),Urban,15-19,142852,76216,66636,13799,8,6,27123,12567,14556,3012
9,133,District - Muzaffarnagar (02),Urban,20-24,121620,64585,57035,11400,6,2,25634,10843,14791,4197
9,133,District - Muzaffarnagar (02),Urban,Adolescent (10-19),288595,155018,133577,26421,17,15,54332,25763,28569,3428
9,133,District - Muzaffarnagar (02),Urban,Youth (15-24),264472,140801,123671,25199,14,8,52757,23410,29347,7209
9,134,District - Bijnor (03),Total,All Ages,3682713,1921215,1761498,787444,3058,1588,1547320,679744,867576,211266
9,134,District - Bijnor (03),Total,10-14,486300,254874,231426,109835,504,261,53822,27191,26631,2546
9,134,District - Bijnor (03),Total,15-19,480416,245444,234972,107036,383,197,66784,29500,37284,19974
9,134,District - Bijnor (03),Total,20-24,355800,192148,163652,70996,224,129,75557,29738,45819,30489
9,134,District - Bijnor (03),Total,Adolescent (10-19),966716,500318,466398,216871,887,458,120606,56691,63915,22520
9,134,District - Bijnor (03),Total,Youth (15-24),836216,437592,398624,178032,607,326,142341,59238,83103,50463
9,134,District - Bijnor (03),Rural,All Ages,2757401,1438412,1318989,716442,2974,1549,1161227,495476,665751,191413
9,134,District - Bijnor (03),Rural,10-14,370674,194361,176313,100432,491,253,32882,15734,17148,2332
9,134,District - Bijnor (03),Rural,15-19,360255,184660,175595,97305,372,193,43145,17225,25920,18032
9,134,District - Bijnor (03),Rural,20-24,255335,137316,118019,63672,214,125,52255,17669,34586,27371
9,134,District - Bijnor (03),Rural,Adolescent (10-19),730929,379021,351908,197737,863,446,76027,32959,43068,20364
9,134,District - Bijnor (03),Rural,Youth (15-24),615590,321976,293614,160977,586,318,95400,34894,60506,45403
9,134,District - Bijnor (03),Urban,All Ages,925312,482803,442509,71002,84,39,386093,184268,201825,19853
9,134,District - Bijnor (03),Urban,10-14,115626,60513,55113,9403,13,8,20940,11457,9483,214
9,134,District - Bijnor (03),Urban,15-19,120161,60784,59377,9731,11,4,23639,12275,11364,1942
9,134,District - Bijnor (03),Urban,20-24,100465,54832,45633,7324,10,4,23302,12069,11233,3118
9,134,District - Bijnor (03),Urban,Adolescent (10-19),235787,121297,114490,19134,24,12,44579,23732,20847,2156
9,134,District - Bijnor (03),Urban,Youth (15-24),220626,115616,105010,17055,21,8,46941,24344,22597,5060
9,135,District - Moradabad (04),Total,All Ages,4772006,2503186,2268820,731406,685,377,2508158,1145751,1362407,223292
9,135,District - Moradabad (04),Total,10-14,654840,347002,307838,104092,78,45,150099,72883,77216,4876
9,135,District - Moradabad (04),Total,15-19,593074,313073,280001,91850,83,47,170586,76333,94253,26400
9,135,District - Moradabad (04),Total,20-24,438358,237371,200987,65211,76,38,164756,68483,96273,33986
9,135,District - Moradabad (04),Total,Adolescent (10-19),1247914,660075,587839,195942,161,92,320685,149216,171469,31276
9,135,District - Moradabad (04),Total,Youth (15-24),1031432,550444,480988,157061,159,85,335342,144816,190526,60386
9,135,District - Moradabad (04),Rural,All Ages,3198383,1680022,1518361,582700,171,99,1791241,800028,991213,196595
9,135,District - Moradabad (04),Rural,10-14,462109,245521,216588,84928,23,10,99810,46418,53392,4389
9,135,District - Moradabad (04),Rural,15-19,397790,211078,186712,72519,23,12,114758,47255,67503,23539
9,135,District - Moradabad (04),Rural,20-24,272547,148438,124109,49266,20,10,113309,42320,70989,29875
9,135,District - Moradabad (04),Rural,Adolescent (10-19),859899,456599,403300,157447,46,22,214568,93673,120895,27928
9,135,District - Moradabad (04),Rural,Youth (15-24),670337,359516,310821,121785,43,22,228067,89575,138492,53414
9,135,District - Moradabad (04),Urban,All Ages,1573623,823164,750459,148706,514,278,716917,345723,371194,26697
9,135,District - Moradabad (04),Urban,10-14,192731,101481,91250,19164,55,35,50289,26465,23824,487
9,135,District - Moradabad (04),Urban,15-19,195284,101995,93289,19331,60,35,55828,29078,26750,2861
9,135,District - Moradabad (04),Urban,20-24,165811,88933,76878,15945,56,28,51447,26163,25284,4111
9,135,District - Moradabad (04),Urban,Adolescent (10-19),388015,203476,184539,38495,115,70,106117,55543,50574,3348
9,135,District - Moradabad (04),Urban,Youth (15-24),361095,190928,170167,35276,116,63,107275,55241,52034,6972
9,136,District - Rampur (05),Total,All Ages,2335819,1223889,1111930,307936,358,207,1292153,593481,698672,150810
9,136,District - Rampur (05),Total,10-14,334075,175687,158388,46001,45,27,77949,37312,40637,3341
9,136,District - Rampur (05),Total,15-19,310566,162859,147707,40210,38,24,94560,41472,53088,20179
9,136,District - Rampur (05),Total,20-24,213599,117995,95604,25956,36,22,87101,37224,49877,23015
9,136,District - Rampur (05),Total,Adolescent (10-19),644641,338546,306095,86211,83,51,172509,78784,93725,23520
9,136,District - Rampur (05),Total,Youth (15-24),524165,280854,243311,66166,74,46,181661,78696,102965,43194
9,136,District - Rampur (05),Rural,All Ages,1747172,916878,830294,277838,122,66,988193,446272,541921,133391
9,136,District - Rampur (05),Rural,10-14,260453,137342,123111,42025,14,8,54105,24947,29158,3026
9,136,District - Rampur (05),Rural,15-19,232161,122605,109556,36118,16,11,66899,27534,39365,17988
9,136,District - Rampur (05),Rural,20-24,150396,83313,67083,22741,11,7,63221,24699,38522,20217
9,136,District - Rampur (05),Rural,Adolescent (10-19),492614,259947,232667,78143,30,19,121004,52481,68523,21014
9,136,District - Rampur (05),Rural,Youth (15-24),382557,205918,176639,58859,27,18,130120,52233,77887,38205
9,136,District - Rampur (05),Urban,All Ages,588647,307011,281636,30098,236,141,303960,147209,156751,17419
9,136,District - Rampur (05),Urban,10-14,73622,38345,35277,3976,31,19,23844,12365,11479,315
9,136,District - Rampur (05),Urban,15-19,78405,40254,38151,4092,22,13,27661,13938,13723,2191
9,136,District - Rampur (05),Urban,20-24,63203,34682,28521,3215,25,15,23880,12525,11355,2798
9,136,District - Rampur (05),Urban,Adolescent (10-19),152027,78599,73428,8068,53,32,51505,26303,25202,2506
9,136,District - Rampur (05),Urban,Youth (15-24),141608,74936,66672,7307,47,28,51541,26463,25078,4989
9,137,District - Jyotiba Phule Nagar (06),Total,All Ages,1840221,963449,876772,318001,164,89,857111,362908,494203,82002
9,137,District - Jyotiba Phule Nagar (06),Total,10-14,254680,135196,119484,47065,27,15,31514,14090,17424,1272
9,137,District - Jyotiba Phule Nagar (06),Total,15-19,230166,121338,108828,40169,18,8,40124,15282,24842,8017
9,137,District - Jyotiba Phule Nagar (06),Total,20-24,170851,90956,79895,28044,11,8,48051,15312,32739,12350
9,137,District - Jyotiba Phule Nagar (06),Total,Adolescent (10-19),484846,256534,228312,87234,45,23,71638,29372,42266,9289
9,137,District - Jyotiba Phule Nagar (06),Total,Youth (15-24),401017,212294,188723,68213,29,16,88175,30594,57581,20367
9,137,District - Jyotiba Phule Nagar (06),Rural,All Ages,1381508,724539,656969,276283,31,15,652301,268256,384045,72926
9,137,District - Jyotiba Phule Nagar (06),Rural,10-14,196012,104464,91548,41385,2,1,20317,8308,12009,1141
9,137,District - Jyotiba Phule Nagar (06),Rural,15-19,170887,90478,80409,34473,2,1,26707,8460,18247,7121
9,137,District - Jyotiba Phule Nagar (06),Rural,20-24,122783,65328,57455,23874,4,1,34386,9027,25359,10942
9,137,District - Jyotiba Phule Nagar (06),Rural,Adolescent (10-19),366899,194942,171957,75858,4,2,47024,16768,30256,8262
9,137,District - Jyotiba Phule Nagar (06),Rural,Youth (15-24),293670,155806,137864,58347,6,2,61093,17487,43606,18063
9,137,District - Jyotiba Phule Nagar (06),Urban,All Ages,458713,238910,219803,41718,133,74,204810,94652,110158,9076
9,137,District - Jyotiba Phule Nagar (06),Urban,10-14,58668,30732,27936,5680,25,14,11197,5782,5415,131
9,137,District - Jyotiba Phule Nagar (06),Urban,15-19,59279,30860,28419,5696,16,7,13417,6822,6595,896
9,137,District - Jyotiba Phule Nagar (06),Urban,20-24,48068,25628,22440,4170,7,7,13665,6285,7380,1408
9,137,District - Jyotiba Phule Nagar (06),Urban,Adolescent (10-19),117947,61592,56355,11376,41,21,24614,12604,12010,1027
9,137,District - Jyotiba Phule Nagar (06),Urban,Youth (15-24),107347,56488,50859,9866,23,14,27082,13107,13975,2304
9,138,District - Meerut (07),Total,All Ages,3443689,1825743,1617946,624149,3390,1828,1302201,571223,730978,112247
9,138,District - Meerut (07),Total,10-14,408782,221038,187744,78262,438,221,57063,27750,29313,1788
9,138,District - Meerut (07),Total,15-19,410003,218827,191176,80644,408,213,59814,27241,32573,9382
9,138,District - Meerut (07),Total,20-24,349971,186639,163332,65236,340,185,63565,24957,38608,14646
9,138,District - Meerut (07),Total,Adolescent (10-19),818785,439865,378920,158906,846,434,116877,54991,61886,11170
9,138,District - Meerut (07),Total,Youth (15-24),759974,405466,354508,145880,748,398,123379,52198,71181,24028
9,138,District - Meerut (07),Rural,All Ages,1684507,894920,789587,347463,222,122,681839,288160,393679,89170
9,138,District - Meerut (07),Rural,10-14,210791,114267,96524,45903,32,18,23588,10976,12612,1538
9,138,District - Meerut (07),Rural,15-19,204774,109541,95233,45375,32,18,24571,10042,14529,7698
9,138,District - Meerut (07),Rural,20-24,162951,87667,75284,33916,22,13,28931,9675,19256,11886
9,138,District - Meerut (07),Rural,Adolescent (10-19),415565,223808,191757,91278,64,36,48159,21018,27141,9236
9,138,District - Meerut (07),Rural,Youth (15-24),367725,197208,170517,79291,54,31,53502,19717,33785,19584
9,138,District - Meerut (07),Urban,All Ages,1759182,930823,828359,276686,3168,1706,620362,283063,337299,23077
9,138,District - Meerut (07),Urban,10-14,197991,106771,91220,32359,406,203,33475,16774,16701,250
9,138,District - Meerut (07),Urban,15-19,205229,109286,95943,35269,376,195,35243,17199,18044,1684
9,138,District - Meerut (07),Urban,20-24,187020,98972,88048,31320,318,172,34634,15282,19352,2760
9,138,District - Meerut (07),Urban,Adolescent (10-19),403220,216057,187163,67628,782,398,68718,33973,34745,1934
9,138,District - Meerut (07),Urban,Youth (15-24),392249,208258,183991,66589,694,367,69877,32481,37396,4444
9,139,District - Baghpat (08),Total,All Ages,1303048,700070,602978,149060,14,10,505078,210212,294866,49442
9,139,District - Baghpat (08),Total,10-14,161111,87376,73735,19499,0,0,16586,7185,9401,764
9,139,District - Baghpat (08),Total,15-19,153974,83792,70182,19851,1,1,19427,7286,12141,4284
9,139,District - Baghpat (08),Total,20-24,123306,67490,55816,14649,1,0,21536,6716,14820,6597
9,139,District - Baghpat (08),Total,Adolescent (10-19),315085,171168,143917,39350,1,1,36013,14471,21542,5048
9,139,District - Baghpat (08),Total,Youth (15-24),277280,151282,125998,34500,2,1,40963,14002,26961,10881
9,139,District - Baghpat (08),Rural,All Ages,1028023,553807,474216,125954,13,9,401766,165326,236440,45201
9,139,District - Baghpat (08),Rural,10-14,127645,69198,58447,16605,0,0,11760,4862,6898,718
9,139,District - Baghpat (08),Rural,15-19,121895,66376,55519,16887,0,0,14366,5077,9289,4000
9,139,District - Baghpat (08),Rural,20-24,95805,52897,42908,12160,1,0,16384,4808,11576,6007
9,139,District - Baghpat (08),Rural,Adolescent (10-19),249540,135574,113966,33492,0,0,26126,9939,16187,4718
9,139,District - Baghpat (08),Rural,Youth (15-24),217700,119273,98427,29047,1,0,30750,9885,20865,10007
9,139,District - Baghpat (08),Urban,All Ages,275025,146263,128762,23106,1,1,103312,44886,58426,4241
9,139,District - Baghpat (08),Urban,10-14,33466,18178,15288,2894,0,0,4826,2323,2503,46
9,139,District - Baghpat (08),Urban,15-19,32079,17416,14663,2964,1,1,5061,2209,2852,284
9,139,District - Baghpat (08),Urban,20-24,27501,14593,12908,2489,0,0,5152,1908,3244,590
9,139,District - Baghpat (08),Urban,Adolescent (10-19),65545,35594,29951,5858,1,1,9887,4532,5355,330
9,139,District - Baghpat (08),Urban,Youth (15-24),59580,32009,27571,5453,1,1,10213,4117,6096,874
9,140,District - Ghaziabad (09),Total,All Ages,4681645,2488834,2192811,773463,3968,2104,1558381,677437,880944,83227
9,140,District - Ghaziabad (09),Total,10-14,534134,290604,243530,93097,451,233,60141,28464,31677,1583
9,140,District - Ghaziabad (09),Total,15-19,515525,280752,234773,94600,486,271,60539,26836,33703,6752
9,140,District - Ghaziabad (09),Total,20-24,465391,246246,219145,82887,423,231,70929,25477,45452,10816
9,140,District - Ghaziabad (09),Total,Adolescent (10-19),1049659,571356,478303,187697,937,504,120680,55300,65380,8335
9,140,District - Ghaziabad (09),Total,Youth (15-24),980916,526998,453918,177487,909,502,131468,52313,79155,17568
9,140,District - Ghaziabad (09),Rural,All Ages,1519098,808222,710876,287708,572,308,596788,249867,346921,59577
9,140,District - Ghaziabad (09),Rural,10-14,192011,104198,87813,37040,78,38,20648,9388,11260,1226
9,140,District - Ghaziabad (09),Rural,15-19,182205,98847,83358,36505,84,49,21438,8521,12917,5247
9,140,District - Ghaziabad (09),Rural,20-24,152866,82481,70385,29459,69,39,26729,8613,18116,8168
9,140,District - Ghaziabad (09),Rural,Adolescent (10-19),374216,203045,171171,73545,162,87,42086,17909,24177,6473
9,140,District - Ghaziabad (09),Rural,Youth (15-24),335071,181328,153743,65964,153,88,48167,17134,31033,13415
9,140,District - Ghaziabad (09),Urban,All Ages,3162547,1680612,1481935,485755,3396,1796,961593,427570,534023,23650
9,140,District - Ghaziabad (09),Urban,10-14,342123,186406,155717,56057,373,195,39493,19076,20417,357
9,140,District - Ghaziabad (09),Urban,15-19,333320,181905,151415,58095,402,222,39101,18315,20786,1505
9,140,District - Ghaziabad (09),Urban,20-24,312525,163765,148760,53428,354,192,44200,16864,27336,2648
9,140,District - Ghaziabad (09),Urban,Adolescent (10-19),675443,368311,307132,114152,775,417,78594,37391,41203,1862
9,140,District - Ghaziabad (09),Urban,Youth (15-24),645845,345670,300175,111523,756,414,83301,35179,48122,4153
9,141,District - Gautam Buddha Nagar (10),Total,All Ages,1648115,890214,757901,216105,2215,1189,525168,224149,301019,27618
9,141,District - Gautam Buddha Nagar (10),Total,10-14,179980,97983,81997,26736,276,140,15636,7068,8568,376
9,141,District - Gautam Buddha Nagar (10),Total,15-19,169550,93910,75640,25678,270,164,16134,6808,9326,1666
9,141,District - Gautam Buddha Nagar (10),Total,20-24,165170,90615,74555,22017,213,111,21096,6734,14362,3469
9,141,District - Gautam Buddha Nagar (10),Total,Adolescent (10-19),349530,191893,157637,52414,546,304,31770,13876,17894,2042
9,141,District - Gautam Buddha Nagar (10),Total,Youth (15-24),334720,184525,150195,47695,483,275,37230,13542,23688,5135
9,141,District - Gautam Buddha Nagar (10),Rural,All Ages,673806,359605,314201,129086,220,116,251878,100945,150933,19219
9,141,District - Gautam Buddha Nagar (10),Rural,10-14,80886,43747,37139,16387,27,14,6269,2712,3557,325
9,141,District - Gautam Buddha Nagar (10),Rural,15-19,77702,41971,35731,15683,37,21,6741,2453,4288,1259
9,141,District - Gautam Buddha Nagar (10),Rural,20-24,67261,35929,31332,12858,25,15,9359,2418,6941,2416
9,141,District - Gautam Buddha Nagar (10),Rural,Adolescent (10-19),158588,85718,72870,32070,64,35,13010,5165,7845,1584
9,141,District - Gautam Buddha Nagar (10),Rural,Youth (15-24),144963,77900,67063,28541,62,36,16100,4871,11229,3675
9,141,District - Gautam Buddha Nagar (10),Urban,All Ages,974309,530609,443700,87019,1995,1073,273290,123204,150086,8399
9,141,District - Gautam Buddha Nagar (10),Urban,10-14,99094,54236,44858,10349,249,126,9367,4356,5011,51
9,141,District - Gautam Buddha Nagar (10),Urban,15-19,91848,51939,39909,9995,233,143,9393,4355,5038,407
9,141,District - Gautam Buddha Nagar (10),Urban,20-24,97909,54686,43223,9159,188,96,11737,4316,7421,1053
9,141,District - Gautam Buddha Nagar (10),Urban,Adolescent (10-19),190942,106175,84767,20344,482,269,18760,8711,10049,458
9,141,District - Gautam Buddha Nagar (10),Urban,Youth (15-24),189757,106625,83132,19154,421,239,21130,8671,12459,1460
9,142,District - Bulandshahr (11),Total,All Ages,3499171,1845260,1653911,725600,198,118,1467515,591946,875569,136780
9,142,District - Bulandshahr (11),Total,10-14,445650,239722,205928,95936,27,13,52879,23798,29081,1825
9,142,District - Bulandshahr (11),Total,15-19,415829,225525,190304,89581,19,13,63143,24693,38450,12525
9,142,District - Bulandshahr (11),Total,20-24,337996,183643,154353,69919,9,5,75915,24091,51824,19985
9,142,District - Bulandshahr (11),Total,Adolescent (10-19),861479,465247,396232,185517,46,26,116022,48491,67531,14350
9,142,District - Bulandshahr (11),Total,Youth (15-24),753825,409168,344657,159500,28,18,139058,48784,90274,32510
9,142,District - Bulandshahr (11),Rural,All Ages,2631742,1390490,1241252,606673,41,28,1113763,436380,677383,123277
9,142,District - Bulandshahr (11),Rural,10-14,340945,183490,157455,81322,2,2,33126,14229,18897,1574
9,142,District - Bulandshahr (11),Rural,15-19,311861,170265,141596,74933,3,2,41297,14680,26617,11201
9,142,District - Bulandshahr (11),Rural,20-24,248786,136284,112502,57670,3,3,54335,15282,39053,18164
9,142,District - Bulandshahr (11),Rural,Adolescent (10-19),652806,353755,299051,156255,5,4,74423,28909,45514,12775
9,142,District - Bulandshahr (11),Rural,Youth (15-24),560647,306549,254098,132603,6,5,95632,29962,65670,29365
9,142,District - Bulandshahr (11),Urban,All Ages,867429,454770,412659,118927,157,90,353752,155566,198186,13503
9,142,District - Bulandshahr (11),Urban,10-14,104705,56232,48473,14614,25,11,19753,9569,10184,251
9,142,District - Bulandshahr (11),Urban,15-19,103968,55260,48708,14648,16,11,21846,10013,11833,1324
9,142,District - Bulandshahr (11),Urban,20-24,89210,47359,41851,12249,6,2,21580,8809,12771,1821
9,142,District - Bulandshahr (11),Urban,Adolescent (10-19),208673,111492,97181,29262,41,22,41599,19582,22017,1575
9,142,District - Bulandshahr (11),Urban,Youth (15-24),193178,102619,90559,26897,22,13,43426,18822,24604,3145
9,143,District - Aligarh (12),Total,All Ages,3673889,1951996,1721893,755254,629,340,1581322,668616,912706,149020
9,143,District - Aligarh (12),Total,10-14,477701,257258,220443,102938,89,46,78363,37393,40970,2040
9,143,District - Aligarh (12),Total,15-19,440738,243605,197133,93367,69,46,85678,38078,47600,13734
9,143,District - Aligarh (12),Total,20-24,351936,194317,157619,71142,57,31,88837,32695,56142,22682
9,143,District - Aligarh (12),Total,Adolescent (10-19),918439,500863,417576,196305,158,92,164041,75471,88570,15774
9,143,District - Aligarh (12),Total,Youth (15-24),792674,437922,354752,164509,126,77,174515,70773,103742,36416
9,143,District - Aligarh (12),Rural,All Ages,2456698,1308923,1147775,564827,274,147,1073703,432607,641096,135935
9,143,District - Aligarh (12),Rural,10-14,330812,178683,152129,78614,44,26,39551,17419,22132,1835
9,143,District - Aligarh (12),Rural,15-19,291865,162653,129212,68760,30,19,47236,18187,29049,12549
9,143,District - Aligarh (12),Rural,20-24,223236,124026,99210,51184,18,9,55448,16860,38588,20919
9,143,District - Aligarh (12),Rural,Adolescent (10-19),622677,341336,281341,147374,74,45,86787,35606,51181,14384
9,143,District - Aligarh (12),Rural,Youth (15-24),515101,286679,228422,119944,48,28,102684,35047,67637,33468
9,143,District - Aligarh (12),Urban,All Ages,1217191,643073,574118,190427,355,193,507619,236009,271610,13085
9,143,District - Aligarh (12),Urban,10-14,146889,78575,68314,24324,45,20,38812,19974,18838,205
9,143,District - Aligarh (12),Urban,15-19,148873,80952,67921,24607,39,27,38442,19891,18551,1185
9,143,District - Aligarh (12),Urban,20-24,128700,70291,58409,19958,39,22,33389,15835,17554,1763
9,143,District - Aligarh (12),Urban,Adolescent (10-19),295762,159527,136235,48931,84,47,77254,39865,37389,1390
9,143,District - Aligarh (12),Urban,Youth (15-24),277573,151243,126330,44565,78,49,71831,35726,36105,2948
9,144,District - Mahamaya Nagar (13),Total,All Ages,1564708,836127,728581,387554,268,137,622136,256970,365166,77479
9,144,District - Mahamaya Nagar (13),Total,10-14,206514,111687,94827,53811,23,14,21698,10104,11594,842
9,144,District - Mahamaya Nagar (13),Total,15-19,186229,103845,82384,47058,31,17,25074,10756,14318,6291
9,144,District - Mahamaya Nagar (13),Total,20-24,145453,80483,64970,35428,18,12,29725,9660,20065,11340
9,144,District - Mahamaya Nagar (13),Total,Adolescent (10-19),392743,215532,177211,100869,54,31,46772,20860,25912,7133
9,144,District - Mahamaya Nagar (13),Total,Youth (15-24),331682,184328,147354,82486,49,29,54799,20416,34383,17631
9,144,District - Mahamaya Nagar (13),Rural,All Ages,1232015,659814,572201,318235,233,116,494047,198693,295354,72461
9,144,District - Mahamaya Nagar (13),Rural,10-14,166191,89902,76289,44839,20,11,13769,6091,7678,796
9,144,District - Mahamaya Nagar (13),Rural,15-19,146752,82237,64515,38371,23,12,16908,6548,10360,5926
9,144,District - Mahamaya Nagar (13),Rural,20-24,112128,62497,49631,28593,15,10,22226,6313,15913,10660
9,144,District - Mahamaya Nagar (13),Rural,Adolescent (10-19),312943,172139,140804,83210,43,23,30677,12639,18038,6722
9,144,District - Mahamaya Nagar (13),Rural,Youth (15-24),258880,144734,114146,66964,38,22,39134,12861,26273,16586
9,144,District - Mahamaya Nagar (13),Urban,All Ages,332693,176313,156380,69319,35,21,128089,58277,69812,5018
9,144,District - Mahamaya Nagar (13),Urban,10-14,40323,21785,18538,8972,3,3,7929,4013,3916,46
9,144,District - Mahamaya Nagar (13),Urban,15-19,39477,21608,17869,8687,8,5,8166,4208,3958,365
9,144,District - Mahamaya Nagar (13),Urban,20-24,33325,17986,15339,6835,3,2,7499,3347,4152,680
9,144,District - Mahamaya Nagar (13),Urban,Adolescent (10-19),79800,43393,36407,17659,11,8,16095,8221,7874,411
9,144,District - Mahamaya Nagar (13),Urban,Youth (15-24),72802,39594,33208,15522,11,7,15665,7555,8110,1045
9,145,District - Mathura (14),Total,All Ages,2547184,1367125,1180059,506580,1520,826,1039438,423779,615659,89865
9,145,District - Mathura (14),Total,10-14,323302,175600,147702,68169,193,114,37062,16389,20673,1379
9,145,District - Mathura (14),Total,15-19,287026,161202,125824,58733,216,107,40973,15421,25552,6942
9,145,District - Mathura (14),Total,20-24,229509,127354,102155,45785,177,99,49296,14571,34725,12453
9,145,District - Mathura (14),Total,Adolescent (10-19),610328,336802,273526,126902,409,221,78035,31810,46225,8321
9,145,District - Mathura (14),Total,Youth (15-24),516535,288556,227979,104518,393,206,90269,29992,60277,19395
9,145,District - Mathura (14),Rural,All Ages,1791191,962028,829163,400917,313,163,769522,303543,465979,81590
9,145,District - Mathura (14),Rural,10-14,237232,128678,108554,54974,30,15,22788,9308,13480,1302
9,145,District - Mathura (14),Rural,15-19,201369,114074,87295,45485,26,15,25907,8136,17771,6385
9,145,District - Mathura (14),Rural,20-24,154337,86517,67820,34788,33,16,34673,8479,26194,11473
9,145,District - Mathura (14),Rural,Adolescent (10-19),438601,242752,195849,100459,56,30,48695,17444,31251,7687
9,145,District - Mathura (14),Rural,Youth (15-24),355706,200591,155115,80273,59,31,60580,16615,43965,17858
9,145,District - Mathura (14),Urban,All Ages,755993,405097,350896,105663,1207,663,269916,120236,149680,8275
9,145,District - Mathura (14),Urban,10-14,86070,46922,39148,13195,163,99,14274,7081,7193,77
9,145,District - Mathura (14),Urban,15-19,85657,47128,38529,13248,190,92,15066,7285,7781,557
9,145,District - Mathura (14),Urban,20-24,75172,40837,34335,10997,144,83,14623,6092,8531,980
9,145,District - Mathura (14),Urban,Adolescent (10-19),171727,94050,77677,26443,353,191,29340,14366,14974,634
9,145,District - Mathura (14),Urban,Youth (15-24),160829,87965,72864,24245,334,175,29689,13377,16312,1537
9,146,District - Agra (15),Total,All Ages,4418797,2364953,2053844,991325,7255,3827,1738287,750359,987928,136468
9,146,District - Agra (15),Total,10-14,574120,312729,261391,135588,866,463,81537,39836,41701,2085
9,146,District - Agra (15),Total,15-19,541732,299209,242523,129391,935,493,89836,40164,49672,12270
9,146,District - Agra (15),Total,20-24,430604,235306,195298,99318,711,376,95057,34477,60580,20471
9,146,District - Agra (15),Total,Adolescent (10-19),1115852,611938,503914,264979,1801,956,171373,80000,91373,14355
9,146,District - Agra (15),Total,Youth (15-24),972336,534515,437821,228709,1646,869,184893,74641,110252,32741
9,146,District - Agra (15),Rural,All Ages,2394602,1285184,1109418,505140,1113,565,993493,402943,590550,118208
9,146,District - Agra (15),Rural,10-14,331398,180071,151327,71710,153,76,30616,13515,17101,1836
9,146,District - Agra (15),Rural,15-19,286062,158950,127112,60707,118,52,35336,12205,23131,10780
9,146,District - Agra (15),Rural,20-24,217186,119473,97713,46008,104,57,47407,12307,35100,18242
9,146,District - Agra (15),Rural,Adolescent (10-19),617460,339021,278439,132417,271,128,65952,25720,40232,12616
9,146,District - Agra (15),Rural,Youth (15-24),503248,278423,224825,106715,222,109,82743,24512,58231,29022
9,146,District - Agra (15),Urban,All Ages,2024195,1079769,944426,486185,6142,3262,744794,347416,397378,18260
9,146,District - Agra (15),Urban,10-14,242722,132658,110064,63878,713,387,50921,26321,24600,249
9,146,District - Agra (15),Urban,15-19,255670,140259,115411,68684,817,441,54500,27959,26541,1490
9,146,District - Agra (15),Urban,20-24,213418,115833,97585,53310,607,319,47650,22170,25480,2229
9,146,District - Agra (15),Urban,Adolescent (10-19),498392,272917,225475,132562,1530,828,105421,54280,51141,1739
9,146,District - Agra (15),Urban,Youth (15-24),469088,256092,212996,121994,1424,760,102150,50129,52021,3719
9,147,District - Firozabad (16),Total,All Ages,2498156,1332046,1166110,473890,2565,1346,976350,419732,556618,88445
9,147,District - Firozabad (16),Total,10-14,337910,182555,155355,66204,419,227,45781,22132,23649,1254
9,147,District - Firozabad (16),Total,15-19,304306,169211,135095,58797,384,196,43591,20477,23114,7264
9,147,District - Firozabad (16),Total,20-24,232863,128839,104024,43619,254,137,44529,16747,27782,12598
9,147,District - Firozabad (16),Total,Adolescent (10-19),642216,351766,290450,125001,803,423,89372,42609,46763,8518
9,147,District - Firozabad (16),Total,Youth (15-24),537169,298050,239119,102416,638,333,88120,37224,50896,19862
9,147,District - Firozabad (16),Rural,All Ages,1664987,891872,773115,333275,108,55,648743,268790,379953,78839
9,147,District - Firozabad (16),Rural,10-14,230517,124897,105620,47338,18,8,20448,9517,10931,1069
9,147,District - Firozabad (16),Rural,15-19,198846,111954,86892,40559,18,10,19605,8404,11201,6412
9,147,District - Firozabad (16),Rural,20-24,149110,83670,65440,29632,14,8,25344,8118,17226,11467
9,147,District - Firozabad (16),Rural,Adolescent (10-19),429363,236851,192512,87897,36,18,40053,17921,22132,7481
9,147,District - Firozabad (16),Rural,Youth (15-24),347956,195624,152332,70191,32,18,44949,16522,28427,17879
9,147,District - Firozabad (16),Urban,All Ages,833169,440174,392995,140615,2457,1291,327607,150942,176665,9606
9,147,District - Firozabad (16),Urban,10-14,107393,57658,49735,18866,401,219,25333,12615,12718,185
9,147,District - Firozabad (16),Urban,15-19,105460,57257,48203,18238,366,186,23986,12073,11913,852
9,147,District - Firozabad (16),Urban,20-24,83753,45169,38584,13987,240,129,19185,8629,10556,1131
9,147,District - Firozabad (16),Urban,Adolescent (10-19),212853,114915,97938,37104,767,405,49319,24688,24631,1037
9,147,District - Firozabad (16),Urban,Youth (15-24),189213,102426,86787,32225,606,315,43171,20702,22469,1983
9,148,District - Mainpuri (17),Total,All Ages,1868529,993377,875152,368206,478,258,664644,281267,383377,79622
9,148,District - Mainpuri (17),Total,10-14,248639,134025,114614,50511,74,38,20018,9798,10220,1101
9,148,District - Mainpuri (17),Total,15-19,225912,125137,100775,43546,63,36,19311,9089,10222,7179
9,148,District - Mainpuri (17),Total,20-24,168574,92796,75778,32350,41,25,24254,8798,15456,11973
9,148,District - Mainpuri (17),Total,Adolescent (10-19),474551,259162,215389,94057,137,74,39329,18887,20442,8280
9,148,District - Mainpuri (17),Total,Youth (15-24),394486,217933,176553,75896,104,61,43565,17887,25678,19152
9,148,District - Mainpuri (17),Rural,All Ages,1580087,842374,737713,319437,476,257,574155,239853,334302,73918
9,148,District - Mainpuri (17),Rural,10-14,213479,115038,98441,44011,74,38,15405,7327,8078,1007
9,148,District - Mainpuri (17),Rural,15-19,190406,105951,84455,37336,63,36,14777,6582,8195,6762
9,148,District - Mainpuri (17),Rural,20-24,139418,77530,61888,27425,40,24,19948,6800,13148,11230
9,148,District - Mainpuri (17),Rural,Adolescent (10-19),403885,220989,182896,81347,137,74,30182,13909,16273,7769
9,148,District - Mainpuri (17),Rural,Youth (15-24),329824,183481,146343,64761,103,60,34725,13382,21343,17992
9,148,District - Mainpuri (17),Urban,All Ages,288442,151003,137439,48769,2,1,90489,41414,49075,5704
9,148,District - Mainpuri (17),Urban,10-14,35160,18987,16173,6500,0,0,4613,2471,2142,94
9,148,District - Mainpuri (17),Urban,15-19,35506,19186,16320,6210,0,0,4534,2507,2027,417
9,148,District - Mainpuri (17),Urban,20-24,29156,15266,13890,4925,1,1,4306,1998,2308,743
9,148,District - Mainpuri (17),Urban,Adolescent (10-19),70666,38173,32493,12710,0,0,9147,4978,4169,511
9,148,District - Mainpuri (17),Urban,Youth (15-24),64662,34452,30210,11135,1,1,8840,4505,4335,1160
9,149,District - Budaun (18),Total,All Ages,3681896,1967759,1714137,622526,58,30,2134419,981258,1153161,157687
9,149,District - Budaun (18),Total,10-14,512987,278533,234454,89333,10,6,126112,59309,66803,3744
9,149,District - Budaun (18),Total,15-19,413443,227996,185447,70210,9,3,134154,58627,75527,20602
9,149,District - Budaun (18),Total,20-24,302587,167002,135585,50099,1,0,136685,54313,82372,25069
9,149,District - Budaun (18),Total,Adolescent (10-19),926430,506529,419901,159543,19,9,260266,117936,142330,24346
9,149,District - Budaun (18),Total,Youth (15-24),716030,394998,321032,120309,10,3,270839,112940,157899,45671
9,149,District - Budaun (18),Rural,All Ages,3037301,1630376,1406925,553486,7,2,1812796,830483,982313,134288
9,149,District - Budaun (18),Rural,10-14,428966,233834,195132,79627,1,0,101620,46943,54677,3327
9,149,District - Budaun (18),Rural,15-19,333878,185775,148103,61671,3,2,109133,46165,62968,17855
9,149,District - Budaun (18),Rural,20-24,241284,133509,107775,43696,0,0,114915,43790,71125,21391
9,149,District - Budaun (18),Rural,Adolescent (10-19),762844,419609,343235,141298,4,2,210753,93108,117645,21182
9,149,District - Budaun (18),Rural,Youth (15-24),575162,319284,255878,105367,3,2,224048,89955,134093,39246
9,149,District - Budaun (18),Urban,All Ages,644595,337383,307212,69040,51,28,321623,150775,170848,23399
9,149,District - Budaun (18),Urban,10-14,84021,44699,39322,9706,9,6,24492,12366,12126,417
9,149,District - Budaun (18),Urban,15-19,79565,42221,37344,8539,6,1,25021,12462,12559,2747
9,149,District - Budaun (18),Urban,20-24,61303,33493,27810,6403,1,0,21770,10523,11247,3678
9,149,District - Budaun (18),Urban,Adolescent (10-19),163586,86920,76666,18245,15,7,49513,24828,24685,3164
9,149,District - Budaun (18),Urban,Youth (15-24),140868,75714,65154,14942,7,1,46791,22985,23806,6425
9,150,District - Bareilly (19),Total,All Ages,4448359,2357665,2090694,557150,3227,1664,2256600,1014968,1241632,210945
9,150,District - Bareilly (19),Total,10-14,601983,319897,282086,77315,336,179,135302,62829,72473,4875
9,150,District - Bareilly (19),Total,15-19,548631,295579,253052,67282,403,209,152017,65967,86050,26232
9,150,District - Bareilly (19),Total,20-24,397387,218544,178843,47919,426,223,142523,57685,84838,30959
9,150,District - Bareilly (19),Total,Adolescent (10-19),1150614,615476,535138,144597,739,388,287319,128796,158523,31107
9,150,District - Bareilly (19),Total,Youth (15-24),946018,514123,431895,115201,829,432,294540,123652,170888,57191
9,150,District - Bareilly (19),Rural,All Ages,2879950,1530356,1349594,442422,365,196,1547344,683588,863756,178918
9,150,District - Bareilly (19),Rural,10-14,413650,220091,193559,63265,47,24,79923,35594,44329,4175
9,150,District - Bareilly (19),Rural,15-19,351804,191373,160431,52286,33,18,92139,37190,54949,22773
9,150,District - Bareilly (19),Rural,20-24,237200,131222,105978,35792,48,28,92428,33765,58663,26383
9,150,District - Bareilly (19),Rural,Adolescent (10-19),765454,411464,353990,115551,80,42,172062,72784,99278,26948
9,150,District - Bareilly (19),Rural,Youth (15-24),589004,322595,266409,88078,81,46,184567,70955,113612,49156
9,150,District - Bareilly (19),Urban,All Ages,1568409,827309,741100,114728,2862,1468,709256,331380,377876,32027
9,150,District - Bareilly (19),Urban,10-14,188333,99806,88527,14050,289,155,55379,27235,28144,700
9,150,District - Bareilly (19),Urban,15-19,196827,104206,92621,14996,370,191,59878,28777,31101,3459
9,150,District - Bareilly (19),Urban,20-24,160187,87322,72865,12127,378,195,50095,23920,26175,4576
9,150,District - Bareilly (19),Urban,Adolescent (10-19),385160,204012,181148,29046,659,346,115257,56012,59245,4159
9,150,District - Bareilly (19),Urban,Youth (15-24),357014,191528,165486,27123,748,386,109973,52697,57276,8035
9,151,District - Pilibhit (20),Total,All Ages,2031007,1072002,959005,333558,1714,892,969912,417712,552200,138441
9,151,District - Pilibhit (20),Total,10-14,280962,147848,133114,46845,252,125,43575,19904,23671,1940
9,151,District - Pilibhit (20),Total,15-19,251854,136569,115285,39470,215,116,51268,21833,29435,15776
9,151,District - Pilibhit (20),Total,20-24,182983,100416,82567,28514,142,89,56760,20511,36249,21057
9,151,District - Pilibhit (20),Total,Adolescent (10-19),532816,284417,248399,86315,467,241,94843,41737,53106,17716
9,151,District - Pilibhit (20),Total,Youth (15-24),434837,236985,197852,67984,357,205,108028,42344,65684,36833
9,151,District - Pilibhit (20),Rural,All Ages,1679592,886789,792803,304273,1495,782,818044,348003,470041,129588
9,151,District - Pilibhit (20),Rural,10-14,238383,125211,113172,43175,222,108,32613,14525,18088,1864
9,151,District - Pilibhit (20),Rural,15-19,206193,112351,93842,35531,188,101,39096,15872,23224,14919
9,151,District - Pilibhit (20),Rural,20-24,146021,80088,65933,25360,123,78,46415,15515,30900,19705
9,151,District - Pilibhit (20),Rural,Adolescent (10-19),444576,237562,207014,78706,410,209,71709,30397,41312,16783
9,151,District - Pilibhit (20),Rural,Youth (15-24),352214,192439,159775,60891,311,179,85511,31387,54124,34624
9,151,District - Pilibhit (20),Urban,All Ages,351415,185213,166202,29285,219,110,151868,69709,82159,8853
9,151,District - Pilibhit (20),Urban,10-14,42579,22637,19942,3670,30,17,10962,5379,5583,76
9,151,District - Pilibhit (20),Urban,15-19,45661,24218,21443,3939,27,15,12172,5961,6211,857
9,151,District - Pilibhit (20),Urban,20-24,36962,20328,16634,3154,19,11,10345,4996,5349,1352
9,151,District - Pilibhit (20),Urban,Adolescent (10-19),88240,46855,41385,7609,57,32,23134,11340,11794,933
9,151,District - Pilibhit (20),Urban,Youth (15-24),82623,44546,38077,7093,46,26,22517,10957,11560,2209
9,152,District - Shahjahanpur (21),Total,All Ages,3006538,1606403,1400135,532673,508,259,1515608,691261,824347,175020
9,152,District - Shahjahanpur (21),Total,10-14,412455,220583,191872,73801,61,27,74794,36329,38465,3270
9,152,District - Shahjahanpur (21),Total,15-19,340138,188118,152020,57937,43,22,81808,38146,43662,19602
9,152,District - Shahjahanpur (21),Total,20-24,252123,137914,114209,42116,54,30,87054,34662,52392,25876
9,152,District - Shahjahanpur (21),Total,Adolescent (10-19),752593,408701,343892,131738,104,49,156602,74475,82127,22872
9,152,District - Shahjahanpur (21),Total,Youth (15-24),592261,326032,266229,100053,97,52,168862,72808,96054,45478
9,152,District - Shahjahanpur (21),Rural,All Ages,2412446,1293714,1118732,479352,251,122,1255624,568351,687273,158696
9,152,District - Shahjahanpur (21),Rural,10-14,340309,182604,157705,66921,34,15,56368,27008,29360,3062
9,152,District - Shahjahanpur (21),Rural,15-19,265630,148405,117225,50926,15,8,60951,27426,33525,17963
9,152,District - Shahjahanpur (21),Rural,20-24,191054,104991,86063,36597,23,11,69092,25686,43406,23453
9,152,District - Shahjahanpur (21),Rural,Adolescent (10-19),605939,331009,274930,117847,49,23,117319,54434,62885,21025
9,152,District - Shahjahanpur (21),Rural,Youth (15-24),456684,253396,203288,87523,38,19,130043,53112,76931,41416
9,152,District - Shahjahanpur (21),Urban,All Ages,594092,312689,281403,53321,257,137,259984,122910,137074,16324
9,152,District - Shahjahanpur (21),Urban,10-14,72146,37979,34167,6880,27,12,18426,9321,9105,208
9,152,District - Shahjahanpur (21),Urban,15-19,74508,39713,34795,7011,28,14,20857,10720,10137,1639
9,152,District - Shahjahanpur (21),Urban,20-24,61069,32923,28146,5519,31,19,17962,8976,8986,2423
9,152,District - Shahjahanpur (21),Urban,Adolescent (10-19),146654,77692,68962,13891,55,26,39283,20041,19242,1847
9,152,District - Shahjahanpur (21),Urban,Youth (15-24),135577,72636,62941,12530,59,33,38819,19696,19123,4062
9,153,District - Kheri (22),Total,All Ages,4021243,2123187,1898056,1061782,53375,26984,1987199,886030,1101169,257880
9,153,District - Kheri (22),Total,10-14,539036,286821,252215,143779,7751,3964,90425,43230,47195,5068
9,153,District - Kheri (22),Total,15-19,443334,245411,197923,113356,6065,3044,91282,43389,47893,27041
9,153,District - Kheri (22),Total,20-24,328438,177959,150479,81711,4466,2078,102942,39493,63449,34489
9,153,District - Kheri (22),Total,Adolescent (10-19),982370,532232,450138,257135,13816,7008,181707,86619,95088,32109
9,153,District - Kheri (22),Total,Youth (15-24),771772,423370,348402,195067,10531,5122,194224,82882,111342,61530
9,153,District - Kheri (22),Rural,All Ages,3560208,1880679,1679529,1019387,52446,26460,1813274,804527,1008747,246466
9,153,District - Kheri (22),Rural,10-14,483864,257324,226540,138488,7577,3836,80077,37765,42312,4839
9,153,District - Kheri (22),Rural,15-19,388102,215801,172301,108100,5931,2968,80627,37548,43079,25839
9,153,District - Kheri (22),Rural,20-24,283072,153448,129624,77460,4370,2031,93008,34524,58484,32983
9,153,District - Kheri (22),Rural,Adolescent (10-19),871966,473125,398841,246588,13508,6804,160704,75313,85391,30678
9,153,District - Kheri (22),Rural,Youth (15-24),671174,369249,301925,185560,10301,4999,173635,72072,101563,58822
9,153,District - Kheri (22),Urban,All Ages,461035,242508,218527,42395,929,524,173925,81503,92422,11414
9,153,District - Kheri (22),Urban,10-14,55172,29497,25675,5291,174,128,10348,5465,4883,229
9,153,District - Kheri (22),Urban,15-19,55232,29610,25622,5256,134,76,10655,5841,4814,1202
9,153,District - Kheri (22),Urban,20-24,45366,24511,20855,4251,96,47,9934,4969,4965,1506
9,153,District - Kheri (22),Urban,Adolescent (10-19),110404,59107,51297,10547,308,204,21003,11306,9697,1431
9,153,District - Kheri (22),Urban,Youth (15-24),100598,54121,46477,9507,230,123,20589,10810,9779,2708
9,154,District - Sitapur (23),Total,All Ages,4483992,2375264,2108728,1446427,1602,833,2200259,977562,1222697,262453
9,154,District - Sitapur (23),Total,10-14,598997,319733,279264,194423,210,112,88658,43783,44875,4426
9,154,District - Sitapur (23),Total,15-19,479827,266593,213234,147145,160,94,88979,43069,45910,24567
9,154,District - Sitapur (23),Total,20-24,365104,199726,165378,110294,138,64,109708,41998,67710,34502
9,154,District - Sitapur (23),Total,Adolescent (10-19),1078824,586326,492498,341568,370,206,177637,86852,90785,28993
9,154,District - Sitapur (23),Total,Youth (15-24),844931,466319,378612,257439,298,158,198687,85067,113620,59069
9,154,District - Sitapur (23),Rural,All Ages,3953208,2098123,1855085,1393577,1257,667,2000690,883797,1116893,251672
9,154,District - Sitapur (23),Rural,10-14,534311,285631,248680,187968,162,90,76892,37534,39358,4227
9,154,District - Sitapur (23),Rural,15-19,415050,232361,182689,140915,120,71,77166,36536,40630,23497
9,154,District - Sitapur (23),Rural,20-24,309470,169703,139767,104704,98,48,98272,36161,62111,33103
9,154,District - Sitapur (23),Rural,Adolescent (10-19),949361,517992,431369,328883,282,161,154058,74070,79988,27724
9,154,District - Sitapur (23),Rural,Youth (15-24),724520,402064,322456,245619,218,119,175438,72697,102741,56600
9,154,District - Sitapur (23),Urban,All Ages,530784,277141,253643,52850,345,166,199569,93765,105804,10781
9,154,District - Sitapur (23),Urban,10-14,64686,34102,30584,6455,48,22,11766,6249,5517,199
9,154,District - Sitapur (23),Urban,15-19,64777,34232,30545,6230,40,23,11813,6533,5280,1070
9,154,District - Sitapur (23),Urban,20-24,55634,30023,25611,5590,40,16,11436,5837,5599,1399
9,154,District - Sitapur (23),Urban,Adolescent (10-19),129463,68334,61129,12685,88,45,23579,12782,10797,1269
9,154,District - Sitapur (23),Urban,Youth (15-24),120411,64255,56156,11820,80,39,23249,12370,10879,2469
9,155,District - Hardoi (24),Total,All Ages,4092845,2191442,1901403,1274505,349,186,1871244,816855,1054389,228938
9,155,District - Hardoi (24),Total,10-14,550471,293653,256818,172712,45,24,69948,33211,36737,4115
9,155,District - Hardoi (24),Total,15-19,456067,259446,196621,134299,47,27,75563,35774,39789,24391
9,155,District - Hardoi (24),Total,20-24,337130,189818,147312,99283,37,17,91904,34495,57409,32461
9,155,District - Hardoi (24),Total,Adolescent (10-19),1006538,553099,453439,307011,92,51,145511,68985,76526,28506
9,155,District - Hardoi (24),Total,Youth (15-24),793197,449264,343933,233582,84,44,167467,70269,97198,56852
9,155,District - Hardoi (24),Rural,All Ages,3551039,1906147,1644892,1209207,300,154,1667451,723867,943584,212065
9,155,District - Hardoi (24),Rural,10-14,483930,258437,225493,164379,39,21,58085,27156,30929,3924
9,155,District - Hardoi (24),Rural,15-19,388678,223106,165572,126217,42,23,62998,29271,33727,22686
9,155,District - Hardoi (24),Rural,20-24,282929,160068,122861,93080,33,16,80274,28862,51412,29993
9,155,District - Hardoi (24),Rural,Adolescent (10-19),872608,481543,391065,290596,81,44,121083,56427,64656,26610
9,155,District - Hardoi (24),Rural,Youth (15-24),671607,383174,288433,219297,75,39,143272,58133,85139,52679
9,155,District - Hardoi (24),Urban,All Ages,541806,285295,256511,65298,49,32,203793,92988,110805,16873
9,155,District - Hardoi (24),Urban,10-14,66541,35216,31325,8333,6,3,11863,6055,5808,191
9,155,District - Hardoi (24),Urban,15-19,67389,36340,31049,8082,5,4,12565,6503,6062,1705
9,155,District - Hardoi (24),Urban,20-24,54201,29750,24451,6203,4,1,11630,5633,5997,2468
9,155,District - Hardoi (24),Urban,Adolescent (10-19),133930,71556,62374,16415,11,7,24428,12558,11870,1896
9,155,District - Hardoi (24),Urban,Youth (15-24),121590,66090,55500,14285,9,5,24195,12136,12059,4173
9,156,District - Unnao (25),Total,All Ages,3108367,1630087,1478280,948588,2926,1558,1334783,577024,757759,156955
9,156,District - Unnao (25),Total,10-14,395969,207965,188004,126717,420,233,48118,23358,24760,2913
9,156,District - Unnao (25),Total,15-19,367432,197870,169562,110789,296,161,54882,26388,28494,16708
9,156,District - Unnao (25),Total,20-24,269249,152404,116845,76386,226,132,60057,25683,34374,21763
9,156,District - Unnao (25),Total,Adolescent (10-19),763401,405835,357566,237506,716,394,103000,49746,53254,19621
9,156,District - Unnao (25),Total,Youth (15-24),636681,350274,286407,187175,522,293,114939,52071,62868,38471
9,156,District - Unnao (25),Rural,All Ages,2576721,1351897,1224824,873572,2415,1290,1153603,493744,659859,147140
9,156,District - Unnao (25),Rural,10-14,335544,176138,159406,117486,361,200,39043,18627,20416,2822
9,156,District - Unnao (25),Rural,15-19,303833,164150,139683,101306,246,135,44858,21029,23829,15894
9,156,District - Unnao (25),Rural,20-24,214739,122458,92281,68877,186,107,50407,20745,29662,20483
9,156,District - Unnao (25),Rural,Adolescent (10-19),639377,340288,299089,218792,607,335,83901,39656,44245,18716
9,156,District - Unnao (25),Rural,Youth (15-24),518572,286608,231964,170183,432,242,95265,41774,53491,36377
9,156,District - Unnao (25),Urban,All Ages,531646,278190,253456,75016,511,268,181180,83280,97900,9815
9,156,District - Unnao (25),Urban,10-14,60425,31827,28598,9231,59,33,9075,4731,4344,91
9,156,District - Unnao (25),Urban,15-19,63599,33720,29879,9483,50,26,10024,5359,4665,814
9,156,District - Unnao (25),Urban,20-24,54510,29946,24564,7509,40,25,9650,4938,4712,1280
9,156,District - Unnao (25),Urban,Adolescent (10-19),124024,65547,58477,18714,109,59,19099,10090,9009,905
9,156,District - Unnao (25),Urban,Youth (15-24),118109,63666,54443,16992,90,51,19674,10297,9377,2094
9,157,District - Lucknow (26),Total,All Ages,4589838,2394476,2195362,948294,7506,4036,1462578,652036,810542,102508
9,157,District - Lucknow (26),Total,10-14,503053,263466,239587,119393,843,453,56251,28576,27675,1521
9,157,District - Lucknow (26),Total,15-19,517301,276360,240941,113080,897,484,61770,31903,29867,8504
9,157,District - Lucknow (26),Total,20-24,457020,244128,212892,87645,824,466,69195,31506,37689,12854
9,157,District - Lucknow (26),Total,Adolescent (10-19),1020354,539826,480528,232473,1740,937,118021,60479,57542,10025
9,157,District - Lucknow (26),Total,Youth (15-24),974321,520488,453833,200725,1721,950,130965,63409,67556,21358
9,157,District - Lucknow (26),Rural,All Ages,1550842,813752,737090,597272,1008,518,649985,280096,369889,84209
9,157,District - Lucknow (26),Rural,10-14,206239,107564,98675,81457,139,70,18890,9165,9725,1311
9,157,District - Lucknow (26),Rural,15-19,188108,100795,87313,71045,101,56,22442,10636,11806,7127
9,157,District - Lucknow (26),Rural,20-24,138308,76581,61727,49782,88,51,28543,11325,17218,10777
9,157,District - Lucknow (26),Rural,Adolescent (10-19),394347,208359,185988,152502,240,126,41332,19801,21531,8438
9,157,District - Lucknow (26),Rural,Youth (15-24),326416,177376,149040,120827,189,107,50985,21961,29024,17904
9,157,District - Lucknow (26),Urban,All Ages,3038996,1580724,1458272,351022,6498,3518,812593,371940,440653,18299
9,157,District - Lucknow (26),Urban,10-14,296814,155902,140912,37936,704,383,37361,19411,17950,210
9,157,District - Lucknow (26),Urban,15-19,329193,175565,153628,42035,796,428,39328,21267,18061,1377
9,157,District - Lucknow (26),Urban,20-24,318712,167547,151165,37863,736,415,40652,20181,20471,2077
9,157,District - Lucknow (26),Urban,Adolescent (10-19),626007,331467,294540,79971,1500,811,76689,40678,36011,1587
9,157,District - Lucknow (26),Urban,Youth (15-24),647905,343112,304793,79898,1532,843,79980,41448,38532,3454
9,158,District - Rae Bareli (27),Total,All Ages,3405559,1752542,1653017,1030367,1756,876,1439716,586577,853139,173691
9,158,District - Rae Bareli (27),Total,10-14,444282,231007,213275,139827,204,105,42153,19586,22567,2973
9,158,District - Rae Bareli (27),Total,15-19,411194,212048,199146,121517,164,78,51576,20419,31157,13640
9,158,District - Rae Bareli (27),Total,20-24,294180,157798,136382,82789,123,59,60731,20015,40716,20952
9,158,District - Rae Bareli (27),Total,Adolescent (10-19),855476,443055,412421,261344,368,183,93729,40005,53724,16613
9,158,District - Rae Bareli (27),Total,Youth (15-24),705374,369846,335528,204306,287,137,112307,40434,71873,34592
9,158,District - Rae Bareli (27),Rural,All Ages,3097564,1592449,1505115,984420,1425,705,1347538,546060,801478,169522
9,158,District - Rae Bareli (27),Rural,10-14,410435,213216,197219,134119,174,87,38404,17699,20705,2931
9,158,District - Rae Bareli (27),Rural,15-19,372899,192239,180660,115358,124,59,46806,18014,28792,13356
9,158,District - Rae Bareli (27),Rural,20-24,259950,139657,120293,77809,95,49,55920,17731,38189,20450
9,158,District - Rae Bareli (27),Rural,Adolescent (10-19),783334,405455,377879,249477,298,146,85210,35713,49497,16287
9,158,District - Rae Bareli (27),Rural,Youth (15-24),632849,331896,300953,193167,219,108,102726,35745,66981,33806
9,158,District - Rae Bareli (27),Urban,All Ages,307995,160093,147902,45947,331,171,92178,40517,51661,4169
9,158,District - Rae Bareli (27),Urban,10-14,33847,17791,16056,5708,30,18,3749,1887,1862,42
9,158,District - Rae Bareli (27),Urban,15-19,38295,19809,18486,6159,40,19,4770,2405,2365,284
9,158,District - Rae Bareli (27),Urban,20-24,34230,18141,16089,4980,28,10,4811,2284,2527,502
9,158,District - Rae Bareli (27),Urban,Adolescent (10-19),72142,37600,34542,11867,70,37,8519,4292,4227,326
9,158,District - Rae Bareli (27),Urban,Youth (15-24),72525,37950,34575,11139,68,29,9581,4689,4892,786
9,159,District - Farrukhabad (28),Total,All Ages,1885204,1006240,878964,312712,230,124,792527,351413,441114,96798
9,159,District - Farrukhabad (28),Total,10-14,247785,133243,114542,41815,31,19,31987,15932,16055,1636
9,159,District - Farrukhabad (28),Total,15-19,225816,124132,101684,36523,28,17,36179,17049,19130,10717
9,159,District - Farrukhabad (28),Total,20-24,173248,95595,77653,27868,21,11,41320,16238,25082,15096
9,159,District - Farrukhabad (28),Total,Adolescent (10-19),473601,257375,216226,78338,59,36,68166,32981,35185,12353
9,159,District - Farrukhabad (28),Total,Youth (15-24),399064,219727,179337,64391,49,28,77499,33287,44212,25813
9,159,District - Farrukhabad (28),Rural,All Ages,1469019,785301,683718,256428,155,78,641744,280649,361095,88423
9,159,District - Farrukhabad (28),Rural,10-14,199303,107105,92198,34799,19,11,23039,11247,11792,1560
9,159,District - Farrukhabad (28),Rural,15-19,173983,95903,78080,29052,19,11,26122,11803,14319,10027
9,159,District - Farrukhabad (28),Rural,20-24,128915,71189,57726,21916,9,3,32191,11803,20388,13886
9,159,District - Farrukhabad (28),Rural,Adolescent (10-19),373286,203008,170278,63851,38,22,49161,23050,26111,11587
9,159,District - Farrukhabad (28),Rural,Youth (15-24),302898,167092,135806,50968,28,14,58313,23606,34707,23913
9,159,District - Farrukhabad (28),Urban,All Ages,416185,220939,195246,56284,75,46,150783,70764,80019,8375
9,159,District - Farrukhabad (28),Urban,10-14,48482,26138,22344,7016,12,8,8948,4685,4263,76
9,159,District - Farrukhabad (28),Urban,15-19,51833,28229,23604,7471,9,6,10057,5246,4811,690
9,159,District - Farrukhabad (28),Urban,20-24,44333,24406,19927,5952,12,8,9129,4435,4694,1210
9,159,District - Farrukhabad (28),Urban,Adolescent (10-19),100315,54367,45948,14487,21,14,19005,9931,9074,766
9,159,District - Farrukhabad (28),Urban,Youth (15-24),96166,52635,43531,13423,21,14,19186,9681,9505,1900
9,160,District - Kannauj (29),Total,All Ages,1656616,881776,774840,309980,15,9,639529,278180,361349,82537
9,160,District - Kannauj (29),Total,10-14,220063,116828,103235,42430,0,0,22145,10795,11350,1254
9,160,District - Kannauj (29),Total,15-19,203316,111409,91907,36297,1,1,25842,12253,13589,10223
9,160,District - Kannauj (29),Total,20-24,148929,84082,64847,26553,3,1,27860,11417,16443,13657
9,160,District - Kannauj (29),Total,Adolescent (10-19),423379,228237,195142,78727,1,1,47987,23048,24939,11477
9,160,District - Kannauj (29),Total,Youth (15-24),352245,195491,156754,62850,4,2,53702,23670,30032,23880
9,160,District - Kannauj (29),Rural,All Ages,1375775,734245,641530,277813,14,9,529282,227330,301952,72758
9,160,District - Kannauj (29),Rural,10-14,185311,98336,86975,38246,0,0,15023,7191,7832,1111
9,160,District - Kannauj (29),Rural,15-19,167907,92650,75257,32242,1,1,18264,8433,9831,9077
9,160,District - Kannauj (29),Rural,20-24,120156,68404,51752,23364,2,1,21272,8253,13019,12098
9,160,District - Kannauj (29),Rural,Adolescent (10-19),353218,190986,162232,70488,1,1,33287,15624,17663,10188
9,160,District - Kannauj (29),Rural,Youth (15-24),288063,161054,127009,55606,3,2,39536,16686,22850,21175
9,160,District - Kannauj (29),Urban,All Ages,280841,147531,133310,32167,1,0,110247,50850,59397,9779
9,160,District - Kannauj (29),Urban,10-14,34752,18492,16260,4184,0,0,7122,3604,3518,143
9,160,District - Kannauj (29),Urban,15-19,35409,18759,16650,4055,0,0,7578,3820,3758,1146
9,160,District - Kannauj (29),Urban,20-24,28773,15678,13095,3189,1,0,6588,3164,3424,1559
9,160,District - Kannauj (29),Urban,Adolescent (10-19),70161,37251,32910,8239,0,0,14700,7424,7276,1289
9,160,District - Kannauj (29),Urban,Youth (15-24),64182,34437,29745,7244,1,0,14166,6984,7182,2705
9,161,District - Etawah (30),Total,All Ages,1581810,845856,735954,388283,169,89,519807,222273,297534,84275
9,161,District - Etawah (30),Total,10-14,197030,105538,91492,50549,27,18,11376,5686,5690,877
9,161,District - Etawah (30),Total,15-19,187175,103521,83654,46217,14,7,12401,6146,6255,6943
9,161,District - Etawah (30),Total,20-24,146839,81975,64864,35246,17,6,16644,6404,10240,12421
9,161,District - Etawah (30),Total,Adolescent (10-19),384205,209059,175146,96766,41,25,23777,11832,11945,7820
9,161,District - Etawah (30),Total,Youth (15-24),334014,185496,148518,81463,31,13,29045,12550,16495,19364
9,161,District - Etawah (30),Rural,All Ages,1215511,652740,562771,328659,72,39,417308,175362,241946,78929
9,161,District - Etawah (30),Rural,10-14,155625,83261,72364,43344,11,8,7359,3472,3887,844
9,161,District - Etawah (30),Rural,15-19,143454,79972,63482,38599,5,2,7907,3687,4220,6598
9,161,District - Etawah (30),Rural,20-24,108649,61581,47068,29046,5,2,11971,4105,7866,11772
9,161,District - Etawah (30),Rural,Adolescent (10-19),299079,163233,135846,81943,16,10,15266,7159,8107,7442
9,161,District - Etawah (30),Rural,Youth (15-24),252103,141553,110550,67645,10,4,19878,7792,12086,18370
9,161,District - Etawah (30),Urban,All Ages,366299,193116,173183,59624,97,50,102499,46911,55588,5346
9,161,District - Etawah (30),Urban,10-14,41405,22277,19128,7205,16,10,4017,2214,1803,33
9,161,District - Etawah (30),Urban,15-19,43721,23549,20172,7618,9,5,4494,2459,2035,345
9,161,District - Etawah (30),Urban,20-24,38190,20394,17796,6200,12,4,4673,2299,2374,649
9,161,District - Etawah (30),Urban,Adolescent (10-19),85126,45826,39300,14823,25,15,8511,4673,3838,378
9,161,District - Etawah (30),Urban,Youth (15-24),81911,43943,37968,13818,21,9,9167,4758,4409,994
9,162,District - Auraiya (31),Total,All Ages,1379545,740040,639505,391622,150,91,448709,193842,254867,89913
9,162,District - Auraiya (31),Total,10-14,174575,93257,81318,51612,16,10,8698,4360,4338,893
9,162,District - Auraiya (31),Total,15-19,163715,91335,72380,46404,18,13,10263,5266,4997,7217
9,162,District - Auraiya (31),Total,20-24,122372,69603,52769,34023,15,8,13634,5520,8114,12679
9,162,District - Auraiya (31),Total,Adolescent (10-19),338290,184592,153698,98016,34,23,18961,9626,9335,8110
9,162,District - Auraiya (31),Total,Youth (15-24),286087,160938,125149,80427,33,21,23897,10786,13111,19896
9,162,District - Auraiya (31),Rural,All Ages,1145323,616494,528829,350574,76,49,389400,167057,222343,84331
9,162,District - Auraiya (31),Rural,10-14,146773,78315,68458,46342,7,5,7076,3513,3563,850
9,162,District - Auraiya (31),Rural,15-19,136074,76272,59802,41321,8,5,8335,4197,4138,6856
9,162,District - Auraiya (31),Rural,20-24,99125,57199,41926,30008,9,6,11615,4592,7023,11949
9,162,District - Auraiya (31),Rural,Adolescent (10-19),282847,154587,128260,87663,15,10,15411,7710,7701,7706
9,162,District - Auraiya (31),Rural,Youth (15-24),235199,133471,101728,71329,17,11,19950,8789,11161,18805
9,162,District - Auraiya (31),Urban,All Ages,234222,123546,110676,41048,74,42,59309,26785,32524,5582
9,162,District - Auraiya (31),Urban,10-14,27802,14942,12860,5270,9,5,1622,847,775,43
9,162,District - Auraiya (31),Urban,15-19,27641,15063,12578,5083,10,8,1928,1069,859,361
9,162,District - Auraiya (31),Urban,20-24,23247,12404,10843,4015,6,2,2019,928,1091,730
9,162,District - Auraiya (31),Urban,Adolescent (10-19),55443,30005,25438,10353,19,13,3550,1916,1634,404
9,162,District - Auraiya (31),Urban,Youth (15-24),50888,27467,23421,9098,16,10,3947,1997,1950,1091
9,163,District - Kanpur Dehat (32),Total,All Ages,1796184,963255,832929,460544,801,398,625941,270291,355650,133547
9,163,District - Kanpur Dehat (32),Total,10-14,224203,119454,104749,61180,121,59,13021,6355,6666,1547
9,163,District - Kanpur Dehat (32),Total,15-19,215614,118324,97290,55632,84,42,15893,7833,8060,10863
9,163,District - Kanpur Dehat (32),Total,20-24,159770,92160,67610,40022,74,45,20734,8706,12028,18260
9,163,District - Kanpur Dehat (32),Total,Adolescent (10-19),439817,237778,202039,116812,205,101,28914,14188,14726,12410
9,163,District - Kanpur Dehat (32),Total,Youth (15-24),375384,210484,164900,95654,158,87,36627,16539,20088,29123
9,163,District - Kanpur Dehat (32),Rural,All Ages,1622761,871508,751253,431972,761,377,573375,246357,327018,126882
9,163,District - Kanpur Dehat (32),Rural,10-14,203629,108572,95057,57481,113,53,11217,5445,5772,1460
9,163,District - Kanpur Dehat (32),Rural,15-19,194300,106943,87357,52123,81,40,13755,6669,7086,10231
9,163,District - Kanpur Dehat (32),Rural,20-24,142839,82688,60151,37303,74,45,18548,7591,10957,17282
9,163,District - Kanpur Dehat (32),Rural,Adolescent (10-19),397929,215515,182414,109604,194,93,24972,12114,12858,11691
9,163,District - Kanpur Dehat (32),Rural,Youth (15-24),337139,189631,147508,89426,155,85,32303,14260,18043,27513
9,163,District - Kanpur Dehat (32),Urban,All Ages,173423,91747,81676,28572,40,21,52566,23934,28632,6665
9,163,District - Kanpur Dehat (32),Urban,10-14,20574,10882,9692,3699,8,6,1804,910,894,87
9,163,District - Kanpur Dehat (32),Urban,15-19,21314,11381,9933,3509,3,2,2138,1164,974,632
9,163,District - Kanpur Dehat (32),Urban,20-24,16931,9472,7459,2719,0,0,2186,1115,1071,978
9,163,District - Kanpur Dehat (32),Urban,Adolescent (10-19),41888,22263,19625,7208,11,8,3942,2074,1868,719
9,163,District - Kanpur Dehat (32),Urban,Youth (15-24),38245,20853,17392,6228,3,2,4324,2279,2045,1610
9,164,District - Kanpur Nagar (33),Total,All Ages,4581268,2459806,2121462,816754,3753,2108,1338246,630627,707619,160204
9,164,District - Kanpur Nagar (33),Total,10-14,485666,259605,226061,96571,435,230,47101,25023,22078,1894
9,164,District - Kanpur Nagar (33),Total,15-19,527586,286198,241388,101674,422,235,52009,28853,23156,13568
9,164,District - Kanpur Nagar (33),Total,20-24,464532,257096,207436,82126,377,205,58170,30295,27875,20134
9,164,District - Kanpur Nagar (33),Total,Adolescent (10-19),1013252,545803,467449,198245,857,465,99110,53876,45234,15462
9,164,District - Kanpur Nagar (33),Total,Youth (15-24),992118,543294,448824,183800,799,440,110179,59148,51031,33702
9,164,District - Kanpur Nagar (33),Rural,All Ages,1565623,837260,728363,437722,485,269,555471,242893,312578,142084
9,164,District - Kanpur Nagar (33),Rural,10-14,191961,101576,90385,56973,74,42,12450,6326,6124,1713
9,164,District - Kanpur Nagar (33),Rural,15-19,191445,104344,87101,54683,49,26,14666,7540,7126,12322
9,164,District - Kanpur Nagar (33),Rural,20-24,144958,82818,62140,39495,36,22,19290,8412,10878,18220
9,164,District - Kanpur Nagar (33),Rural,Adolescent (10-19),383406,205920,177486,111656,123,68,27116,13866,13250,14035
9,164,District - Kanpur Nagar (33),Rural,Youth (15-24),336403,187162,149241,94178,85,48,33956,15952,18004,30542
9,164,District - Kanpur Nagar (33),Urban,All Ages,3015645,1622546,1393099,379032,3268,1839,782775,387734,395041,18120
9,164,District - Kanpur Nagar (33),Urban,10-14,293705,158029,135676,39598,361,188,34651,18697,15954,181
9,164,District - Kanpur Nagar (33),Urban,15-19,336141,181854,154287,46991,373,209,37343,21313,16030,1246
9,164,District - Kanpur Nagar (33),Urban,20-24,319574,174278,145296,42631,341,183,38880,21883,16997,1914
9,164,District - Kanpur Nagar (33),Urban,Adolescent (10-19),629846,339883,289963,86589,734,397,71994,40010,31984,1427
9,164,District - Kanpur Nagar (33),Urban,Youth (15-24),655715,356132,299583,89622,714,392,76223,43196,33027,3160
9,165,District - Jalaun (34),Total,All Ages,1689974,906092,783882,468178,832,428,614778,252662,362116,125266
9,165,District - Jalaun (34),Total,10-14,195572,105015,90557,55570,98,45,14021,6866,7155,1291
9,165,District - Jalaun (34),Total,15-19,186139,104190,81949,51206,92,53,16997,8210,8787,8149
9,165,District - Jalaun (34),Total,20-24,151585,85145,66440,41721,82,42,24607,8920,15687,16620
9,165,District - Jalaun (34),Total,Adolescent (10-19),381711,209205,172506,106776,190,98,31018,15076,15942,9440
9,165,District - Jalaun (34),Total,Youth (15-24),337724,189335,148389,92927,174,95,41604,17130,24474,24769
9,165,District - Jalaun (34),Rural,All Ages,1271074,683656,587418,375126,599,309,481108,194581,286527,117065
9,165,District - Jalaun (34),Rural,10-14,148578,79611,68967,44787,72,35,8755,4141,4614,1230
9,165,District - Jalaun (34),Rural,15-19,136334,77091,59243,39981,63,39,10746,4872,5874,7625
9,165,District - Jalaun (34),Rural,20-24,109740,62176,47564,32424,59,31,18040,5780,12260,15594
9,165,District - Jalaun (34),Rural,Adolescent (10-19),284912,156702,128210,84768,135,74,19501,9013,10488,8855
9,165,District - Jalaun (34),Rural,Youth (15-24),246074,139267,106807,72405,122,70,28786,10652,18134,23219
9,165,District - Jalaun (34),Urban,All Ages,418900,222436,196464,93052,233,119,133670,58081,75589,8201
9,165,District - Jalaun (34),Urban,10-14,46994,25404,21590,10783,26,10,5266,2725,2541,61
9,165,District - Jalaun (34),Urban,15-19,49805,27099,22706,11225,29,14,6251,3338,2913,524
9,165,District - Jalaun (34),Urban,20-24,41845,22969,18876,9297,23,11,6567,3140,3427,1026
9,165,District - Jalaun (34),Urban,Adolescent (10-19),96799,52503,44296,22008,55,24,11517,6063,5454,585
9,165,District - Jalaun (34),Urban,Youth (15-24),91650,50068,41582,20522,52,25,12818,6478,6340,1550
9,166,District - Jhansi (35),Total,All Ages,1998603,1057436,941167,562505,3873,2074,694090,273731,420359,126789
9,166,District - Jhansi (35),Total,10-14,220752,118060,102692,64869,442,249,14160,6536,7624,1539
9,166,District - Jhansi (35),Total,15-19,206224,111925,94299,59608,358,206,18579,7632,10947,8327
9,166,District - Jhansi (35),Total,20-24,193696,103562,90134,54574,352,171,31780,9271,22509,17433
9,166,District - Jhansi (35),Total,Adolescent (10-19),426976,229985,196991,124477,800,455,32739,14168,18571,9866
9,166,District - Jhansi (35),Total,Youth (15-24),399920,215487,184433,114182,710,377,50359,16903,33456,25760
9,166,District - Jhansi (35),Rural,All Ages,1165119,615629,549490,374245,1969,1046,462126,176428,285698,109872
9,166,District - Jhansi (35),Rural,10-14,137249,73020,64229,44731,251,142,6975,2896,4079,1401
9,166,District - Jhansi (35),Rural,15-19,117551,64450,53101,37863,142,83,10180,3437,6743,7343
9,166,District - Jhansi (35),Rural,20-24,104081,55364,48717,33390,157,67,21024,4868,16156,15367
9,166,District - Jhansi (35),Rural,Adolescent (10-19),254800,137470,117330,82594,393,225,17155,6333,10822,8744
9,166,District - Jhansi (35),Rural,Youth (15-24),221632,119814,101818,71253,299,150,31204,8305,22899,22710
9,166,District - Jhansi (35),Urban,All Ages,833484,441807,391677,188260,1904,1028,231964,97303,134661,16917
9,166,District - Jhansi (35),Urban,10-14,83503,45040,38463,20138,191,107,7185,3640,3545,138
9,166,District - Jhansi (35),Urban,15-19,88673,47475,41198,21745,216,123,8399,4195,4204,984
9,166,District - Jhansi (35),Urban,20-24,89615,48198,41417,21184,195,104,10756,4403,6353,2066
9,166,District - Jhansi (35),Urban,Adolescent (10-19),172176,92515,79661,41883,407,230,15584,7835,7749,1122
9,166,District - Jhansi (35),Urban,Youth (15-24),178288,95673,82615,42929,411,227,19155,8598,10557,3050
9,167,District - Lalitpur (36),Total,All Ages,1221592,641011,580581,240519,71610,36834,580401,243425,336976,59275
9,167,District - Lalitpur (36),Total,10-14,159906,85307,74599,32008,8992,4887,12373,5637,6736,727
9,167,District - Lalitpur (36),Total,15-19,120035,64722,55313,23739,5797,3070,17673,5803,11870,5786
9,167,District - Lalitpur (36),Total,20-24,112480,58160,54320,22254,6008,2921,32857,8218,24639,10627
9,167,District - Lalitpur (36),Total,Adolescent (10-19),279941,150029,129912,55747,14789,7957,30046,11440,18606,6513
9,167,District - Lalitpur (36),Total,Youth (15-24),232515,122882,109633,45993,11805,5991,50530,14021,36509,16413
9,167,District - Lalitpur (36),Rural,All Ages,1046214,549478,496736,215108,69775,35886,528786,222086,306700,56346
9,167,District - Lalitpur (36),Rural,10-14,140567,75006,65561,28955,8738,4750,11221,5016,6205,709
9,167,District - Lalitpur (36),Rural,15-19,100656,54423,46233,20683,5636,2979,16254,5121,11133,5624
9,167,District - Lalitpur (36),Rural,20-24,94381,48715,45666,19571,5845,2844,30681,7471,23210,10275
9,167,District - Lalitpur (36),Rural,Adolescent (10-19),241223,129429,111794,49638,14374,7729,27475,10137,17338,6333
9,167,District - Lalitpur (36),Rural,Youth (15-24),195037,103138,91899,40254,11481,5823,46935,12592,34343,15899
9,167,District - Lalitpur (36),Urban,All Ages,175378,91533,83845,25411,1835,948,51615,21339,30276,2929
9,167,District - Lalitpur (36),Urban,10-14,19339,10301,9038,3053,254,137,1152,621,531,18
9,167,District - Lalitpur (36),Urban,15-19,19379,10299,9080,3056,161,91,1419,682,737,162
9,167,District - Lalitpur (36),Urban,20-24,18099,9445,8654,2683,163,77,2176,747,1429,352
9,167,District - Lalitpur (36),Urban,Adolescent (10-19),38718,20600,18118,6109,415,228,2571,1303,1268,180
9,167,District - Lalitpur (36),Urban,Youth (15-24),37478,19744,17734,5739,324,168,3595,1429,2166,514
9,168,District - Hamirpur (37),Total,All Ages,1104285,593537,510748,241198,474,259,450986,185412,265574,89590
9,168,District - Hamirpur (37),Total,10-14,137661,73057,64604,31063,71,37,10321,4795,5526,949
9,168,District - Hamirpur (37),Total,15-19,120501,67663,52838,26699,45,22,12081,5582,6499,6412
9,168,District - Hamirpur (37),Total,20-24,93214,54530,38684,19952,33,19,17418,5981,11437,11283
9,168,District - Hamirpur (37),Total,Adolescent (10-19),258162,140720,117442,57762,116,59,22402,10377,12025,7361
9,168,District - Hamirpur (37),Total,Youth (15-24),213715,122193,91522,46651,78,41,29499,11563,17936,17695
9,168,District - Hamirpur (37),Rural,All Ages,894437,481373,413064,198693,45,24,382654,156763,225891,83357
9,168,District - Hamirpur (37),Rural,10-14,112917,59791,53126,25617,10,6,7926,3551,4375,898
9,168,District - Hamirpur (37),Rural,15-19,96303,54275,42028,21653,7,3,9575,4288,5287,6055
9,168,District - Hamirpur (37),Rural,20-24,73106,43209,29897,15945,5,3,14637,4786,9851,10550
9,168,District - Hamirpur (37),Rural,Adolescent (10-19),209220,114066,95154,47270,17,9,17501,7839,9662,6953
9,168,District - Hamirpur (37),Rural,Youth (15-24),169409,97484,71925,37598,12,6,24212,9074,15138,16605
9,168,District - Hamirpur (37),Urban,All Ages,209848,112164,97684,42505,429,235,68332,28649,39683,6233
9,168,District - Hamirpur (37),Urban,10-14,24744,13266,11478,5446,61,31,2395,1244,1151,51
9,168,District - Hamirpur (37),Urban,15-19,24198,13388,10810,5046,38,19,2506,1294,1212,357
9,168,District - Hamirpur (37),Urban,20-24,20108,11321,8787,4007,28,16,2781,1195,1586,733
9,168,District - Hamirpur (37),Urban,Adolescent (10-19),48942,26654,22288,10492,99,50,4901,2538,2363,408
9,168,District - Hamirpur (37),Urban,Youth (15-24),44306,24709,19597,9053,66,35,5287,2489,2798,1090
9,169,District - Mahoba (38),Total,All Ages,875958,466358,409600,220898,647,355,387852,164075,223777,66682
9,169,District - Mahoba (38),Total,10-14,111656,59534,52122,29590,74,43,10848,5057,5791,792
9,169,District - Mahoba (38),Total,15-19,90352,49797,40555,22671,55,26,11817,5197,6620,4866
9,169,District - Mahoba (38),Total,20-24,71018,39445,31573,17034,50,27,16701,5584,11117,8734
9,169,District - Mahoba (38),Total,Adolescent (10-19),202008,109331,92677,52261,129,69,22665,10254,12411,5658
9,169,District - Mahoba (38),Total,Youth (15-24),161370,89242,72128,39705,105,53,28518,10781,17737,13600
9,169,District - Mahoba (38),Rural,All Ages,690577,368009,322568,188781,250,143,320861,135425,185436,61238
9,169,District - Mahoba (38),Rural,10-14,89005,47430,41575,25222,30,15,8258,3790,4468,744
9,169,District - Mahoba (38),Rural,15-19,69297,38484,30813,18981,20,9,9055,3820,5235,4547
9,169,District - Mahoba (38),Rural,20-24,54160,30180,23980,14322,20,9,13743,4346,9397,8132
9,169,District - Mahoba (38),Rural,Adolescent (10-19),158302,85914,72388,44203,50,24,17313,7610,9703,5291
9,169,District - Mahoba (38),Rural,Youth (15-24),123457,68664,54793,33303,40,18,22798,8166,14632,12679
9,169,District - Mahoba (38),Urban,All Ages,185381,98349,87032,32117,397,212,66991,28650,38341,5444
9,169,District - Mahoba (38),Urban,10-14,22651,12104,10547,4368,44,28,2590,1267,1323,48
9,169,District - Mahoba (38),Urban,15-19,21055,11313,9742,3690,35,17,2762,1377,1385,319
9,169,District - Mahoba (38),Urban,20-24,16858,9265,7593,2712,30,18,2958,1238,1720,602
9,169,District - Mahoba (38),Urban,Adolescent (10-19),43706,23417,20289,8058,79,45,5352,2644,2708,367
9,169,District - Mahoba (38),Urban,Youth (15-24),37913,20578,17335,6402,65,35,5720,2615,3105,921
9,170,District - Banda (39),Total,All Ages,1799410,965876,833534,387855,163,82,796473,335250,461223,155295
9,170,District - Banda (39),Total,10-14,238071,126811,111260,52220,26,11,19987,9507,10480,1766
9,170,District - Banda (39),Total,15-19,180054,103999,76055,38041,16,10,20963,9673,11290,12252
9,170,District - Banda (39),Total,20-24,142223,83118,59105,28615,10,4,31421,10400,21021,19843
9,170,District - Banda (39),Total,Adolescent (10-19),418125,230810,187315,90261,42,21,40950,19180,21770,14018
9,170,District - Banda (39),Total,Youth (15-24),322277,187117,135160,66656,26,14,52384,20073,32311,32095
9,170,District - Banda (39),Rural,All Ages,1523655,819243,704412,344057,61,27,712521,300081,412440,148518
9,170,District - Banda (39),Rural,10-14,205476,109390,96086,46493,13,6,17353,8190,9163,1687
9,170,District - Banda (39),Rural,15-19,149003,87047,61956,32900,4,2,18140,8206,9934,11781
9,170,District - Banda (39),Rural,20-24,115922,68387,47535,24787,4,1,28501,9121,19380,19137
9,170,District - Banda (39),Rural,Adolescent (10-19),354479,196437,158042,79393,17,8,35493,16396,19097,13468
9,170,District - Banda (39),Rural,Youth (15-24),264925,155434,109491,57687,8,3,46641,17327,29314,30918
9,170,District - Banda (39),Urban,All Ages,275755,146633,129122,43798,102,55,83952,35169,48783,6777
9,170,District - Banda (39),Urban,10-14,32595,17421,15174,5727,13,5,2634,1317,1317,79
9,170,District - Banda (39),Urban,15-19,31051,16952,14099,5141,12,8,2823,1467,1356,471
9,170,District - Banda (39),Urban,20-24,26301,14731,11570,3828,6,3,2920,1279,1641,706
9,170,District - Banda (39),Urban,Adolescent (10-19),63646,34373,29273,10868,25,13,5457,2784,2673,550
9,170,District - Banda (39),Urban,Youth (15-24),57352,31683,25669,8969,18,11,5743,2746,2997,1177
9,171,District - Chitrakoot (40),Total,All Ages,991730,527721,464009,266655,366,196,460658,197382,263276,89510
9,171,District - Chitrakoot (40),Total,10-14,136346,72079,64267,37602,53,27,10688,4915,5773,1156
9,171,District - Chitrakoot (40),Total,15-19,99594,56814,42780,25425,26,14,11477,4854,6623,6918
9,171,District - Chitrakoot (40),Total,20-24,77556,43587,33969,19549,23,8,19352,5642,13710,11894
9,171,District - Chitrakoot (40),Total,Adolescent (10-19),235940,128893,107047,63027,79,41,22165,9769,12396,8074
9,171,District - Chitrakoot (40),Total,Youth (15-24),177150,100401,76749,44974,49,22,30829,10496,20333,18812
9,171,District - Chitrakoot (40),Rural,All Ages,895398,476794,418604,246900,361,193,427706,183292,244414,87646
9,171,District - Chitrakoot (40),Rural,10-14,124287,65779,58508,34703,53,27,9242,4226,5016,1123
9,171,District - Chitrakoot (40),Rural,15-19,88508,50804,37704,23182,26,14,10245,4217,6028,6773
9,171,District - Chitrakoot (40),Rural,20-24,68402,38488,29914,17865,23,8,17985,5060,12925,11660
9,171,District - Chitrakoot (40),Rural,Adolescent (10-19),212795,116583,96212,57885,79,41,19487,8443,11044,7896
9,171,District - Chitrakoot (40),Rural,Youth (15-24),156910,89292,67618,41047,49,22,28230,9277,18953,18433
9,171,District - Chitrakoot (40),Urban,All Ages,96332,50927,45405,19755,5,3,32952,14090,18862,1864
9,171,District - Chitrakoot (40),Urban,10-14,12059,6300,5759,2899,0,0,1446,689,757,33
9,171,District - Chitrakoot (40),Urban,15-19,11086,6010,5076,2243,0,0,1232,637,595,145
9,171,District - Chitrakoot (40),Urban,20-24,9154,5099,4055,1684,0,0,1367,582,785,234
9,171,District - Chitrakoot (40),Urban,Adolescent (10-19),23145,12310,10835,5142,0,0,2678,1326,1352,178
9,171,District - Chitrakoot (40),Urban,Youth (15-24),20240,11109,9131,3927,0,0,2599,1219,1380,379
9,172,District - Fatehpur (41),Total,All Ages,2632733,1384722,1248011,651480,340,189,1120567,473719,646848,204936
9,172,District - Fatehpur (41),Total,10-14,343215,180601,162614,89206,36,25,32438,15951,16487,3136
9,172,District - Fatehpur (41),Total,15-19,300863,160891,139972,74804,37,20,36798,16760,20038,17342
9,172,District - Fatehpur (41),Total,20-24,217301,123116,94185,50530,28,12,41991,15577,26414,24493
9,172,District - Fatehpur (41),Total,Adolescent (10-19),644078,341492,302586,164010,73,45,69236,32711,36525,20478
9,172,District - Fatehpur (41),Total,Youth (15-24),518164,284007,234157,125334,65,32,78789,32337,46452,41835
9,172,District - Fatehpur (41),Rural,All Ages,2310740,1215690,1095050,604239,304,167,1011998,425214,586784,198028
9,172,District - Fatehpur (41),Rural,10-14,305616,160828,144788,83139,34,24,27872,13569,14303,3071
9,172,District - Fatehpur (41),Rural,15-19,261863,140269,121594,68899,37,20,31681,14003,17678,16815
9,172,District - Fatehpur (41),Rural,20-24,185307,105601,79706,46200,24,11,37270,13216,24054,23679
9,172,District - Fatehpur (41),Rural,Adolescent (10-19),567479,301097,266382,152038,71,44,59553,27572,31981,19886
9,172,District - Fatehpur (41),Rural,Youth (15-24),447170,245870,201300,115099,61,31,68951,27219,41732,40494
9,172,District - Fatehpur (41),Urban,All Ages,321993,169032,152961,47241,36,22,108569,48505,60064,6908
9,172,District - Fatehpur (41),Urban,10-14,37599,19773,17826,6067,2,1,4566,2382,2184,65
9,172,District - Fatehpur (41),Urban,15-19,39000,20622,18378,5905,0,0,5117,2757,2360,527
9,172,District - Fatehpur (41),Urban,20-24,31994,17515,14479,4330,4,1,4721,2361,2360,814
9,172,District - Fatehpur (41),Urban,Adolescent (10-19),76599,40395,36204,11972,2,1,9683,5139,4544,592
9,172,District - Fatehpur (41),Urban,Youth (15-24),70994,38137,32857,10235,4,1,9838,5118,4720,1341
9,173,District - Pratapgarh (42),Total,All Ages,3209141,1606085,1603056,709252,723,380,1277582,484704,792878,128274
9,173,District - Pratapgarh (42),Total,10-14,434350,225198,209152,101883,96,42,32816,14543,18273,2204
9,173,District - Pratapgarh (42),Total,15-19,391921,194794,197127,86471,59,30,38599,13340,25259,7901
9,173,District - Pratapgarh (42),Total,20-24,262655,131349,131306,53772,46,20,45655,11907,33748,12629
9,173,District - Pratapgarh (42),Total,Adolescent (10-19),826271,419992,406279,188354,155,72,71415,27883,43532,10105
9,173,District - Pratapgarh (42),Total,Youth (15-24),654576,326143,328433,140243,105,50,84254,25247,59007,20530
9,173,District - Pratapgarh (42),Rural,All Ages,3033899,1515583,1518316,691199,453,235,1224265,462227,762038,125250
9,173,District - Pratapgarh (42),Rural,10-14,414174,214589,199585,99603,67,28,30866,13606,17260,2166
9,173,District - Pratapgarh (42),Rural,15-19,370547,183700,186847,84124,40,18,36372,12364,24008,7691
9,173,District - Pratapgarh (42),Rural,20-24,245066,122069,122997,52049,28,13,43527,11036,32491,12320
9,173,District - Pratapgarh (42),Rural,Adolescent (10-19),784721,398289,386432,183727,107,46,67238,25970,41268,9857
9,173,District - Pratapgarh (42),Rural,Youth (15-24),615613,305769,309844,136173,68,31,79899,23400,56499,20011
9,173,District - Pratapgarh (42),Urban,All Ages,175242,90502,84740,18053,270,145,53317,22477,30840,3024
9,173,District - Pratapgarh (42),Urban,10-14,20176,10609,9567,2280,29,14,1950,937,1013,38
9,173,District - Pratapgarh (42),Urban,15-19,21374,11094,10280,2347,19,12,2227,976,1251,210
9,173,District - Pratapgarh (42),Urban,20-24,17589,9280,8309,1723,18,7,2128,871,1257,309
9,173,District - Pratapgarh (42),Urban,Adolescent (10-19),41550,21703,19847,4627,48,26,4177,1913,2264,248
9,173,District - Pratapgarh (42),Urban,Youth (15-24),38963,20374,18589,4070,37,19,4355,1847,2508,519
9,174,District - Kaushambi (43),Total,All Ages,1599596,838485,761111,555397,193,102,786172,331206,454966,186914
9,174,District - Kaushambi (43),Total,10-14,221913,116681,105232,79469,29,19,32242,14302,17940,4063
9,174,District - Kaushambi (43),Total,15-19,177921,96436,81485,58662,16,8,34457,13517,20940,15443
9,174,District - Kaushambi (43),Total,20-24,123514,70064,53450,39005,10,6,36593,12442,24151,21286
9,174,District - Kaushambi (43),Total,Adolescent (10-19),399834,213117,186717,138131,45,27,66699,27819,38880,19506
9,174,District - Kaushambi (43),Total,Youth (15-24),301435,166500,134935,97667,26,14,71050,25959,45091,36729
9,174,District - Kaushambi (43),Rural,All Ages,1475140,773335,701805,532594,101,49,736098,309155,426943,180184
9,174,District - Kaushambi (43),Rural,10-14,205603,108206,97397,76105,11,7,29692,13040,16652,3979
9,174,District - Kaushambi (43),Rural,15-19,162828,88467,74361,56093,11,6,31810,12304,19506,14909
9,174,District - Kaushambi (43),Rural,20-24,112010,63685,48325,37280,3,3,34220,11431,22789,20510
9,174,District - Kaushambi (43),Rural,Adolescent (10-19),368431,196673,171758,132198,22,13,61502,25344,36158,18888
9,174,District - Kaushambi (43),Rural,Youth (15-24),274838,152152,122686,93373,14,9,66030,23735,42295,35419
9,174,District - Kaushambi (43),Urban,All Ages,124456,65150,59306,22803,92,53,50074,22051,28023,6730
9,174,District - Kaushambi (43),Urban,10-14,16310,8475,7835,3364,18,12,2550,1262,1288,84
9,174,District - Kaushambi (43),Urban,15-19,15093,7969,7124,2569,5,2,2647,1213,1434,534
9,174,District - Kaushambi (43),Urban,20-24,11504,6379,5125,1725,7,3,2373,1011,1362,776
9,174,District - Kaushambi (43),Urban,Adolescent (10-19),31403,16444,14959,5933,23,14,5197,2475,2722,618
9,174,District - Kaushambi (43),Urban,Youth (15-24),26597,14348,12249,4294,12,5,5020,2224,2796,1310
9,175,District - Allahabad (44),Total,All Ages,5954391,3131807,2822584,1309851,7955,4270,2288664,932467,1356197,234806
9,175,District - Allahabad (44),Total,10-14,754726,397464,357262,175727,925,512,69975,32012,37963,4286
9,175,District - Allahabad (44),Total,15-19,694755,372911,321844,149256,841,457,80588,31689,48899,15303
9,175,District - Allahabad (44),Total,20-24,541676,294863,246813,110091,734,390,103373,31424,71949,27662
9,175,District - Allahabad (44),Total,Adolescent (10-19),1449481,770375,679106,324983,1766,969,150563,63701,86862,19589
9,175,District - Allahabad (44),Total,Youth (15-24),1236431,667774,568657,259347,1575,847,183961,63113,120848,42965
9,175,District - Allahabad (44),Rural,All Ages,4481518,2340959,2140559,1108075,4861,2557,1896599,753876,1142723,223280
9,175,District - Allahabad (44),Rural,10-14,606758,318366,288392,153438,599,321,53779,23720,30059,4071
9,175,District - Allahabad (44),Rural,15-19,524707,280003,244704,123967,461,243,61660,21987,39673,14341
9,175,District - Allahabad (44),Rural,20-24,380384,204925,175459,87826,428,217,83913,22065,61848,26301
9,175,District - Allahabad (44),Rural,Adolescent (10-19),1131465,598369,533096,277405,1060,564,115439,45707,69732,18412
9,175,District - Allahabad (44),Rural,Youth (15-24),905091,484928,420163,211793,889,460,145573,44052,101521,40642
9,175,District - Allahabad (44),Urban,All Ages,1472873,790848,682025,201776,3094,1713,392065,178591,213474,11526
9,175,District - Allahabad (44),Urban,10-14,147968,79098,68870,22289,326,191,16196,8292,7904,215
9,175,District - Allahabad (44),Urban,15-19,170048,92908,77140,25289,380,214,18928,9702,9226,962
9,175,District - Allahabad (44),Urban,20-24,161292,89938,71354,22265,306,173,19460,9359,10101,1361
9,175,District - Allahabad (44),Urban,Adolescent (10-19),318016,172006,146010,47578,706,405,35124,17994,17130,1177
9,175,District - Allahabad (44),Urban,Youth (15-24),331340,182846,148494,47554,686,387,38388,19061,19327,2323
9,176,District - Bara Banki (45),Total,All Ages,3260699,1707073,1553626,864559,610,333,1568241,696555,871686,226170
9,176,District - Bara Banki (45),Total,10-14,418506,219305,199201,109028,83,36,60981,29890,31091,4826
9,176,District - Bara Banki (45),Total,15-19,361364,190581,170783,87104,57,33,68724,31713,37011,21213
9,176,District - Bara Banki (45),Total,20-24,270794,146348,124446,67535,48,27,77649,30903,46746,29258
9,176,District - Bara Banki (45),Total,Adolescent (10-19),779870,409886,369984,196132,140,69,129705,61603,68102,26039
9,176,District - Bara Banki (45),Total,Youth (15-24),632158,336929,295229,154639,105,60,146373,62616,83757,50471
9,176,District - Bara Banki (45),Rural,All Ages,2929896,1533455,1396441,833812,508,280,1436272,634154,802118,215596
9,176,District - Bara Banki (45),Rural,10-14,378785,198215,180570,105212,70,28,53788,26122,27666,4669
9,176,District - Bara Banki (45),Rural,15-19,321275,169643,151632,83599,53,30,60582,27466,33116,20245
9,176,District - Bara Banki (45),Rural,20-24,238320,128586,109734,64755,33,21,69988,27006,42982,27757
9,176,District - Bara Banki (45),Rural,Adolescent (10-19),700060,367858,332202,188811,123,58,114370,53588,60782,24914
9,176,District - Bara Banki (45),Rural,Youth (15-24),559595,298229,261366,148354,86,51,130570,54472,76098,48002
9,176,District - Bara Banki (45),Urban,All Ages,330803,173618,157185,30747,102,53,131969,62401,69568,10574
9,176,District - Bara Banki (45),Urban,10-14,39721,21090,18631,3816,13,8,7193,3768,3425,157
9,176,District - Bara Banki (45),Urban,15-19,40089,20938,19151,3505,4,3,8142,4247,3895,968
9,176,District - Bara Banki (45),Urban,20-24,32474,17762,14712,2780,15,6,7661,3897,3764,1501
9,176,District - Bara Banki (45),Urban,Adolescent (10-19),79810,42028,37782,7321,17,11,15335,8015,7320,1125
9,176,District - Bara Banki (45),Urban,Youth (15-24),72563,38700,33863,6285,19,9,15803,8144,7659,2469
9,177,District - Faizabad (46),Total,All Ages,2470996,1259628,1211368,555047,931,469,1020095,421289,598806,105778
9,177,District - Faizabad (46),Total,10-14,317092,163715,153377,71529,132,71,26774,12798,13976,1682
9,177,District - Faizabad (46),Total,15-19,290637,146066,144571,62583,131,65,30827,12239,18588,7421
9,177,District - Faizabad (46),Total,20-24,213055,108201,104854,44912,79,35,40279,12494,27785,12563
9,177,District - Faizabad (46),Total,Adolescent (10-19),607729,309781,297948,134112,263,136,57601,25037,32564,9103
9,177,District - Faizabad (46),Total,Youth (15-24),503692,254267,249425,107495,210,100,71106,24733,46373,19984
9,177,District - Faizabad (46),Rural,All Ages,2130743,1079257,1051486,519511,721,359,921414,376185,545229,101813
9,177,District - Faizabad (46),Rural,10-14,280986,144737,136249,67484,94,54,22826,10682,12144,1643
9,177,District - Faizabad (46),Rural,15-19,250442,124831,125611,58095,104,47,26622,10003,16619,7185
9,177,District - Faizabad (46),Rural,20-24,177712,89021,88691,41338,62,27,35991,10429,25562,12110
9,177,District - Faizabad (46),Rural,Adolescent (10-19),531428,269568,261860,125579,198,101,49448,20685,28763,8828
9,177,District - Faizabad (46),Rural,Youth (15-24),428154,213852,214302,99433,166,74,62613,20432,42181,19295
9,177,District - Faizabad (46),Urban,All Ages,340253,180371,159882,35536,210,110,98681,45104,53577,3965
9,177,District - Faizabad (46),Urban,10-14,36106,18978,17128,4045,38,17,3948,2116,1832,39
9,177,District - Faizabad (46),Urban,15-19,40195,21235,18960,4488,27,18,4205,2236,1969,236
9,177,District - Faizabad (46),Urban,20-24,35343,19180,16163,3574,17,8,4288,2065,2223,453
9,177,District - Faizabad (46),Urban,Adolescent (10-19),76301,40213,36088,8533,65,35,8153,4352,3801,275
9,177,District - Faizabad (46),Urban,Youth (15-24),75538,40415,35123,8062,44,26,8493,4301,4192,689
9,178,District - Ambedkar Nagar (47),Total,All Ages,2397888,1212410,1185478,591125,746,406,910949,365734,545215,109764
9,178,District - Ambedkar Nagar (47),Total,10-14,314511,161299,153212,79249,79,49,18480,8816,9664,1600
9,178,District - Ambedkar Nagar (47),Total,15-19,295632,146637,148995,73115,87,52,20908,8400,12508,6447
9,178,District - Ambedkar Nagar (47),Total,20-24,208988,103438,105550,48168,76,36,27484,7936,19548,11356
9,178,District - Ambedkar Nagar (47),Total,Adolescent (10-19),610143,307936,302207,152364,166,101,39388,17216,22172,8047
9,178,District - Ambedkar Nagar (47),Total,Youth (15-24),504620,250075,254545,121283,163,88,48392,16336,32056,17803
9,178,District - Ambedkar Nagar (47),Rural,All Ages,2117158,1067762,1049396,562930,690,376,817492,324699,492793,104731
9,178,District - Ambedkar Nagar (47),Rural,10-14,279314,143013,136301,75643,72,45,15706,7331,8375,1542
9,178,District - Ambedkar Nagar (47),Rural,15-19,259092,128120,130972,69486,79,47,17761,6813,10948,6118
9,178,District - Ambedkar Nagar (47),Rural,20-24,179942,88332,91610,45617,70,33,23984,6441,17543,10833
9,178,District - Ambedkar Nagar (47),Rural,Adolescent (10-19),538406,271133,267273,145129,151,92,33467,14144,19323,7660
9,178,District - Ambedkar Nagar (47),Rural,Youth (15-24),439034,216452,222582,115103,149,80,41745,13254,28491,16951
9,178,District - Ambedkar Nagar (47),Urban,All Ages,280730,144648,136082,28195,56,30,93457,41035,52422,5033
9,178,District - Ambedkar Nagar (47),Urban,10-14,35197,18286,16911,3606,7,4,2774,1485,1289,58
9,178,District - Ambedkar Nagar (47),Urban,15-19,36540,18517,18023,3629,8,5,3147,1587,1560,329
9,178,District - Ambedkar Nagar (47),Urban,20-24,29046,15106,13940,2551,6,3,3500,1495,2005,523
9,178,District - Ambedkar Nagar (47),Urban,Adolescent (10-19),71737,36803,34934,7235,15,9,5921,3072,2849,387
9,178,District - Ambedkar Nagar (47),Urban,Youth (15-24),65586,33623,31963,6180,14,8,6647,3082,3565,852
9,179,District - Sultanpur (48),Total,All Ages,3797117,1914586,1882531,851587,696,358,1557215,614338,942877,189727
9,179,District - Sultanpur (48),Total,10-14,501628,258893,242735,113671,87,38,36928,16535,20393,2624
9,179,District - Sultanpur (48),Total,15-19,447781,224726,223055,94007,82,45,41017,14753,26264,12130
9,179,District - Sultanpur (48),Total,20-24,316021,156531,159490,65866,62,33,56237,14375,41862,20944
9,179,District - Sultanpur (48),Total,Adolescent (10-19),949409,483619,465790,207678,169,83,77945,31288,46657,14754
9,179,District - Sultanpur (48),Total,Youth (15-24),763802,381257,382545,159873,144,78,97254,29128,68126,33074
9,179,District - Sultanpur (48),Rural,All Ages,3597201,1810496,1786705,832547,681,349,1503527,591301,912226,187554
9,179,District - Sultanpur (48),Rural,10-14,478434,246700,231734,111247,87,38,35267,15746,19521,2603
9,179,District - Sultanpur (48),Rural,15-19,423301,211898,211403,91616,80,43,39202,13867,25335,11960
9,179,District - Sultanpur (48),Rural,20-24,295168,145441,149727,64004,61,33,54300,13600,40700,20671
9,179,District - Sultanpur (48),Rural,Adolescent (10-19),901735,458598,443137,202863,167,81,74469,29613,44856,14563
9,179,District - Sultanpur (48),Rural,Youth (15-24),718469,357339,361130,155620,141,76,93502,27467,66035,32631
9,179,District - Sultanpur (48),Urban,All Ages,199916,104090,95826,19040,15,9,53688,23037,30651,2173
9,179,District - Sultanpur (48),Urban,10-14,23194,12193,11001,2424,0,0,1661,789,872,21
9,179,District - Sultanpur (48),Urban,15-19,24480,12828,11652,2391,2,2,1815,886,929,170
9,179,District - Sultanpur (48),Urban,20-24,20853,11090,9763,1862,1,0,1937,775,1162,273
9,179,District - Sultanpur (48),Urban,Adolescent (10-19),47674,25021,22653,4815,2,2,3476,1675,1801,191
9,179,District - Sultanpur (48),Urban,Youth (15-24),45333,23918,21415,4253,3,2,3752,1661,2091,443
9,180,District - Bahraich (49),Total,All Ages,3487731,1843884,1643847,509307,11159,5606,2089363,965599,1123764,223291
9,180,District - Bahraich (49),Total,10-14,453980,244855,209125,64547,1517,787,125357,61955,63402,4816
9,180,District - Bahraich (49),Total,15-19,342884,193005,149879,47488,1314,649,113148,55741,57407,20984
9,180,District - Bahraich (49),Total,20-24,273936,145611,128325,38378,907,457,124474,50057,74417,29131
9,180,District - Bahraich (49),Total,Adolescent (10-19),796864,437860,359004,112035,2831,1436,238505,117696,120809,25800
9,180,District - Bahraich (49),Total,Youth (15-24),616820,338616,278204,85866,2221,1106,237622,105798,131824,50115
9,180,District - Bahraich (49),Rural,All Ages,3203687,1695122,1508565,494161,10961,5498,1973409,909151,1064258,217485
9,180,District - Bahraich (49),Rural,10-14,419604,226695,192909,62738,1480,763,117782,57821,59961,4678
9,180,District - Bahraich (49),Rural,15-19,308112,174426,133686,45597,1293,639,105527,51360,54167,20393
9,180,District - Bahraich (49),Rural,20-24,245578,130257,115321,36924,887,447,117358,46263,71095,28356
9,180,District - Bahraich (49),Rural,Adolescent (10-19),727716,401121,326595,108335,2773,1402,223309,109181,114128,25071
9,180,District - Bahraich (49),Rural,Youth (15-24),553690,304683,249007,82521,2180,1086,222885,97623,125262,48749
9,180,District - Bahraich (49),Urban,All Ages,284044,148762,135282,15146,198,108,115954,56448,59506,5806
9,180,District - Bahraich (49),Urban,10-14,34376,18160,16216,1809,37,24,7575,4134,3441,138
9,180,District - Bahraich (49),Urban,15-19,34772,18579,16193,1891,21,10,7621,4381,3240,591
9,180,District - Bahraich (49),Urban,20-24,28358,15354,13004,1454,20,10,7116,3794,3322,775
9,180,District - Bahraich (49),Urban,Adolescent (10-19),69148,36739,32409,3700,58,34,15196,8515,6681,729
9,180,District - Bahraich (49),Urban,Youth (15-24),63130,33933,29197,3345,41,20,14737,8175,6562,1366
9,181,District - Shrawasti (50),Total,All Ages,1117361,593897,523464,189334,5534,2889,694048,317197,376851,67766
9,181,District - Shrawasti (50),Total,10-14,141375,77538,63837,23034,803,404,36348,17514,18834,1624
9,181,District - Shrawasti (50),Total,15-19,102531,57991,44540,16013,512,272,34995,16011,18984,5899
9,181,District - Shrawasti (50),Total,20-24,88622,46179,42443,14317,458,231,44448,16472,27976,8745
9,181,District - Shrawasti (50),Total,Adolescent (10-19),243906,135529,108377,39047,1315,676,71343,33525,37818,7523
9,181,District - Shrawasti (50),Total,Youth (15-24),191153,104170,86983,30330,970,503,79443,32483,46960,14644
9,181,District - Shrawasti (50),Rural,All Ages,1078712,573681,505031,187982,5517,2882,676333,308844,367489,66947
9,181,District - Shrawasti (50),Rural,10-14,136472,74956,61516,22851,803,404,35230,16912,18318,1619
9,181,District - Shrawasti (50),Rural,15-19,97770,55481,42289,15840,510,271,33709,15322,18387,5860
9,181,District - Shrawasti (50),Rural,20-24,84840,44148,40692,14214,457,231,43326,15939,27387,8663
9,181,District - Shrawasti (50),Rural,Adolescent (10-19),234242,130437,103805,38691,1313,675,68939,32234,36705,7479
9,181,District - Shrawasti (50),Rural,Youth (15-24),182610,99629,82981,30054,967,502,77035,31261,45774,14523
9,181,District - Shrawasti (50),Urban,All Ages,38649,20216,18433,1352,17,7,17715,8353,9362,819
9,181,District - Shrawasti (50),Urban,10-14,4903,2582,2321,183,0,0,1118,602,516,5
9,181,District - Shrawasti (50),Urban,15-19,4761,2510,2251,173,2,1,1286,689,597,39
9,181,District - Shrawasti (50),Urban,20-24,3782,2031,1751,103,1,0,1122,533,589,82
9,181,District - Shrawasti (50),Urban,Adolescent (10-19),9664,5092,4572,356,2,1,2404,1291,1113,44
9,181,District - Shrawasti (50),Urban,Youth (15-24),8543,4541,4002,276,3,1,2408,1222,1186,121
9,182,District - Balrampur (51),Total,All Ages,2148665,1114721,1033944,277212,24887,12657,1280308,569778,710530,143090
9,182,District - Balrampur (51),Total,10-14,289199,153657,135542,35219,3503,1842,78502,35889,42613,3087
9,182,District - Balrampur (51),Total,15-19,223567,117153,106414,26169,2534,1348,72924,30505,42419,13134
9,182,District - Balrampur (51),Total,20-24,169110,87080,82030,21076,1892,915,76240,27364,48876,18843
9,182,District - Balrampur (51),Total,Adolescent (10-19),512766,270810,241956,61388,6037,3190,151426,66394,85032,16221
9,182,District - Balrampur (51),Total,Youth (15-24),392677,204233,188444,47245,4426,2263,149164,57869,91295,31977
9,182,District - Balrampur (51),Rural,All Ages,1982274,1027943,954331,268612,24750,12605,1209264,536730,672534,138828
9,182,District - Balrampur (51),Rural,10-14,268098,142665,125433,34146,3453,1834,73358,33292,40066,3022
9,182,District - Balrampur (51),Rural,15-19,202759,106219,96540,25148,2520,1339,67741,27735,40006,12703
9,182,District - Balrampur (51),Rural,20-24,152690,78157,74533,20283,1883,910,71997,25247,46750,18231
9,182,District - Balrampur (51),Rural,Adolescent (10-19),470857,248884,221973,59294,5973,3173,141099,61027,80072,15725
9,182,District - Balrampur (51),Rural,Youth (15-24),355449,184376,171073,45431,4403,2249,139738,52982,86756,30934
9,182,District - Balrampur (51),Urban,All Ages,166391,86778,79613,8600,137,52,71044,33048,37996,4262
9,182,District - Balrampur (51),Urban,10-14,21101,10992,10109,1073,50,8,5144,2597,2547,65
9,182,District - Balrampur (51),Urban,15-19,20808,10934,9874,1021,14,9,5183,2770,2413,431
9,182,District - Balrampur (51),Urban,20-24,16420,8923,7497,793,9,5,4243,2117,2126,612
9,182,District - Balrampur (51),Urban,Adolescent (10-19),41909,21926,19983,2094,64,17,10327,5367,4960,496
9,182,District - Balrampur (51),Urban,Youth (15-24),37228,19857,17371,1814,23,14,9426,4887,4539,1043
9,183,District - Gonda (52),Total,All Ages,3433919,1787146,1646773,531973,870,476,1753925,752965,1000960,200475
9,183,District - Gonda (52),Total,10-14,455948,240736,215212,69440,105,68,80094,36450,43644,4481
9,183,District - Gonda (52),Total,15-19,374033,199296,174737,54075,97,54,84213,34854,49359,17582
9,183,District - Gonda (52),Total,20-24,286212,148915,137297,41913,71,39,97591,32586,65005,26251
9,183,District - Gonda (52),Total,Adolescent (10-19),829981,440032,389949,123515,202,122,164307,71304,93003,22063
9,183,District - Gonda (52),Total,Youth (15-24),660245,348211,312034,95988,168,93,181804,67440,114364,43833
9,183,District - Gonda (52),Rural,All Ages,3208890,1669058,1539832,515769,626,336,1679725,718811,960914,195086
9,183,District - Gonda (52),Rural,10-14,429435,226763,202672,67428,73,45,76161,34410,41751,4411
9,183,District - Gonda (52),Rural,15-19,345345,183977,161368,51986,58,36,79994,32574,47420,17110
9,183,District - Gonda (52),Rural,20-24,262330,135840,126490,40285,41,24,93594,30592,63002,25526
9,183,District - Gonda (52),Rural,Adolescent (10-19),774780,410740,364040,119414,131,81,156155,66984,89171,21521
9,183,District - Gonda (52),Rural,Youth (15-24),607675,319817,287858,92271,99,60,173588,63166,110422,42636
9,183,District - Gonda (52),Urban,All Ages,225029,118088,106941,16204,244,140,74200,34154,40046,5389
9,183,District - Gonda (52),Urban,10-14,26513,13973,12540,2012,32,23,3933,2040,1893,70
9,183,District - Gonda (52),Urban,15-19,28688,15319,13369,2089,39,18,4219,2280,1939,472
9,183,District - Gonda (52),Urban,20-24,23882,13075,10807,1628,30,15,3997,1994,2003,725
9,183,District - Gonda (52),Urban,Adolescent (10-19),55201,29292,25909,4101,71,41,8152,4320,3832,542
9,183,District - Gonda (52),Urban,Youth (15-24),52570,28394,24176,3717,69,33,8216,4274,3942,1197
9,184,District - Siddharthnagar (53),Total,All Ages,2559297,1295095,1264202,408763,12021,6087,1330371,554377,775994,133485
9,184,District - Siddharthnagar (53),Total,10-14,347043,178250,168793,53229,1615,803,52098,22034,30064,2683
9,184,District - Siddharthnagar (53),Total,15-19,267015,131641,135374,38834,1247,641,54676,18332,36344,9759
9,184,District - Siddharthnagar (53),Total,20-24,195854,95507,100347,30560,978,459,64652,16919,47733,15701
9,184,District - Siddharthnagar (53),Total,Adolescent (10-19),614058,309891,304167,92063,2862,1444,106774,40366,66408,12442
9,184,District - Siddharthnagar (53),Total,Youth (15-24),462869,227148,235721,69394,2225,1100,119328,35251,84077,25460
9,184,District - Siddharthnagar (53),Rural,All Ages,2398606,1212141,1186465,392650,10590,5365,1267299,526905,740394,128131
9,184,District - Siddharthnagar (53),Rural,10-14,326227,167599,158628,51151,1432,722,49141,20587,28554,2630
9,184,District - Siddharthnagar (53),Rural,15-19,247283,121606,125677,36995,1086,551,51657,16928,34729,9396
9,184,District - Siddharthnagar (53),Rural,20-24,180573,87378,93195,29232,842,387,61600,15735,45865,15080
9,184,District - Siddharthnagar (53),Rural,Adolescent (10-19),573510,289205,284305,88146,2518,1273,100798,37515,63283,12026
9,184,District - Siddharthnagar (53),Rural,Youth (15-24),427856,208984,218872,66227,1928,938,113257,32663,80594,24476
9,184,District - Siddharthnagar (53),Urban,All Ages,160691,82954,77737,16113,1431,722,63072,27472,35600,5354
9,184,District - Siddharthnagar (53),Urban,10-14,20816,10651,10165,2078,183,81,2957,1447,1510,53
9,184,District - Siddharthnagar (53),Urban,15-19,19732,10035,9697,1839,161,90,3019,1404,1615,363
9,184,District - Siddharthnagar (53),Urban,20-24,15281,8129,7152,1328,136,72,3052,1184,1868,621
9,184,District - Siddharthnagar (53),Urban,Adolescent (10-19),40548,20686,19862,3917,344,171,5976,2851,3125,416
9,184,District - Siddharthnagar (53),Urban,Youth (15-24),35013,18164,16849,3167,297,162,6071,2588,3483,984
9,185,District - Basti (54),Total,All Ages,2464464,1255272,1209192,513959,3620,1876,1070681,435553,635128,94482
9,185,District - Basti (54),Total,10-14,332828,172020,160808,69783,522,305,28873,12898,15975,1243
9,185,District - Basti (54),Total,15-19,282348,142241,140107,56592,416,201,33949,12308,21641,6370
9,185,District - Basti (54),Total,20-24,202836,100983,101853,39909,324,157,42781,11585,31196,11024
9,185,District - Basti (54),Total,Adolescent (10-19),615176,314261,300915,126375,938,506,62822,25206,37616,7613
9,185,District - Basti (54),Total,Youth (15-24),485184,243224,241960,96501,740,358,76730,23893,52837,17394
9,185,District - Basti (54),Rural,All Ages,2326367,1182846,1143521,493904,3240,1668,1033048,419367,613681,93406
9,185,District - Basti (54),Rural,10-14,317527,163907,153620,67352,475,275,27515,12235,15280,1235
9,185,District - Basti (54),Rural,15-19,265195,133047,132148,53986,370,178,32359,11527,20832,6301
9,185,District - Basti (54),Rural,20-24,188130,93272,94858,37987,279,136,41223,10890,30333,10904
9,185,District - Basti (54),Rural,Adolescent (10-19),582722,296954,285768,121338,845,453,59874,23762,36112,7536
9,185,District - Basti (54),Rural,Youth (15-24),453325,226319,227006,91973,649,314,73582,22417,51165,17205
9,185,District - Basti (54),Urban,All Ages,138097,72426,65671,20055,380,208,37633,16186,21447,1076
9,185,District - Basti (54),Urban,10-14,15301,8113,7188,2431,47,30,1358,663,695,8
9,185,District - Basti (54),Urban,15-19,17153,9194,7959,2606,46,23,1590,781,809,69
9,185,District - Basti (54),Urban,20-24,14706,7711,6995,1922,45,21,1558,695,863,120
9,185,District - Basti (54),Urban,Adolescent (10-19),32454,17307,15147,5037,93,53,2948,1444,1504,77
9,185,District - Basti (54),Urban,Youth (15-24),31859,16905,14954,4528,91,44,3148,1476,1672,189
9,186,District - Sant Kabir Nagar (55),Total,All Ages,1715183,869656,845527,369039,1593,823,760234,302558,457676,72795
9,186,District - Sant Kabir Nagar (55),Total,10-14,234206,120818,113388,50469,222,117,22259,9852,12407,1326
9,186,District - Sant Kabir Nagar (55),Total,15-19,195757,98046,97711,40452,161,82,24196,8333,15863,5143
9,186,District - Sant Kabir Nagar (55),Total,20-24,138422,69436,68986,28646,137,65,30176,7755,22421,8504
9,186,District - Sant Kabir Nagar (55),Total,Adolescent (10-19),429963,218864,211099,90921,383,199,46455,18185,28270,6469
9,186,District - Sant Kabir Nagar (55),Total,Youth (15-24),334179,167482,166697,69098,298,147,54372,16088,38284,13647
9,186,District - Sant Kabir Nagar (55),Rural,All Ages,1586652,802609,784043,353460,1561,802,713850,282738,431112,71353
9,186,District - Sant Kabir Nagar (55),Rural,10-14,217700,112076,105624,48437,220,116,20582,9014,11568,1316
9,186,District - Sant Kabir Nagar (55),Rural,15-19,179773,89699,90074,38603,157,78,22238,7410,14828,5029
9,186,District - Sant Kabir Nagar (55),Rural,20-24,126064,62913,63151,27294,131,61,28204,6972,21232,8331
9,186,District - Sant Kabir Nagar (55),Rural,Adolescent (10-19),397473,201775,195698,87040,377,194,42820,16424,26396,6345
9,186,District - Sant Kabir Nagar (55),Rural,Youth (15-24),305837,152612,153225,65897,288,139,50442,14382,36060,13360
9,186,District - Sant Kabir Nagar (55),Urban,All Ages,128531,67047,61484,15579,32,21,46384,19820,26564,1442
9,186,District - Sant Kabir Nagar (55),Urban,10-14,16506,8742,7764,2032,2,1,1677,838,839,10
9,186,District - Sant Kabir Nagar (55),Urban,15-19,15984,8347,7637,1849,4,4,1958,923,1035,114
9,186,District - Sant Kabir Nagar (55),Urban,20-24,12358,6523,5835,1352,6,4,1972,783,1189,173
9,186,District - Sant Kabir Nagar (55),Urban,Adolescent (10-19),32490,17089,15401,3881,6,5,3635,1761,1874,124
9,186,District - Sant Kabir Nagar (55),Urban,Youth (15-24),28342,14870,13472,3201,10,8,3930,1706,2224,287
9,187,District - Mahrajganj (56),Total,All Ages,2684703,1381754,1302949,492976,16435,8361,1265559,500080,765479,154252
9,187,District - Mahrajganj (56),Total,10-14,359522,184890,174632,65565,2210,1131,40755,17230,23525,2846
9,187,District - Mahrajganj (56),Total,15-19,288136,152063,136073,51599,1809,895,41231,14240,26991,9671
9,187,District - Mahrajganj (56),Total,20-24,209779,108066,101713,37610,1357,690,55777,13315,42462,15851
9,187,District - Mahrajganj (56),Total,Adolescent (10-19),647658,336953,310705,117164,4019,2026,81986,31470,50516,12517
9,187,District - Mahrajganj (56),Total,Youth (15-24),497915,260129,237786,89209,3166,1585,97008,27555,69453,25522
9,187,District - Mahrajganj (56),Rural,All Ages,2549973,1312126,1237847,475865,15037,7652,1222797,482642,740155,151534
9,187,District - Mahrajganj (56),Rural,10-14,342689,176195,166494,63325,2015,1026,39283,16527,22756,2827
9,187,District - Mahrajganj (56),Rural,15-19,271778,143567,128211,49549,1616,809,39777,13559,26218,9520
9,187,District - Mahrajganj (56),Rural,20-24,196931,101257,95674,36140,1218,619,54166,12725,41441,15579
9,187,District - Mahrajganj (56),Rural,Adolescent (10-19),614467,319762,294705,112874,3631,1835,79060,30086,48974,12347
9,187,District - Mahrajganj (56),Rural,Youth (15-24),468709,244824,223885,85689,2834,1428,93943,26284,67659,25099
9,187,District - Mahrajganj (56),Urban,All Ages,134730,69628,65102,17111,1398,709,42762,17438,25324,2718
9,187,District - Mahrajganj (56),Urban,10-14,16833,8695,8138,2240,195,105,1472,703,769,19
9,187,District - Mahrajganj (56),Urban,15-19,16358,8496,7862,2050,193,86,1454,681,773,151
9,187,District - Mahrajganj (56),Urban,20-24,12848,6809,6039,1470,139,71,1611,590,1021,272
9,187,District - Mahrajganj (56),Urban,Adolescent (10-19),33191,17191,16000,4290,388,191,2926,1384,1542,170
9,187,District - Mahrajganj (56),Urban,Youth (15-24),29206,15305,13901,3520,332,157,3065,1271,1794,423
9,188,District - Gorakhpur (57),Total,All Ages,4440895,2277777,2163118,936061,18172,9261,1740567,683887,1056680,163544
9,188,District - Gorakhpur (57),Total,10-14,562933,291537,271396,124687,2187,1102,52605,23528,29077,2538
9,188,District - Gorakhpur (57),Total,15-19,519152,270711,248441,110779,2160,1120,55778,21871,33907,10437
9,188,District - Gorakhpur (57),Total,20-24,390991,201681,189310,77921,1720,859,69726,19848,49878,17563
9,188,District - Gorakhpur (57),Total,Adolescent (10-19),1082085,562248,519837,235466,4347,2222,108383,45399,62984,12975
9,188,District - Gorakhpur (57),Total,Youth (15-24),910143,472392,437751,188700,3880,1979,125504,41719,83785,28000
9,188,District - Gorakhpur (57),Rural,All Ages,3604766,1838726,1766040,849249,14499,7367,1518138,587816,930322,156437
9,188,District - Gorakhpur (57),Rural,10-14,472075,243709,228366,114389,1773,907,43741,19166,24575,2433
9,188,District - Gorakhpur (57),Rural,15-19,419097,217690,201407,99696,1709,891,46365,17128,29237,9986
9,188,District - Gorakhpur (57),Rural,20-24,303743,155203,148540,69071,1328,666,60214,15653,44561,16898
9,188,District - Gorakhpur (57),Rural,Adolescent (10-19),891172,461399,429773,214085,3482,1798,90106,36294,53812,12419
9,188,District - Gorakhpur (57),Rural,Youth (15-24),722840,372893,349947,168767,3037,1557,106579,32781,73798,26884
9,188,District - Gorakhpur (57),Urban,All Ages,836129,439051,397078,86812,3673,1894,222429,96071,126358,7107
9,188,District - Gorakhpur (57),Urban,10-14,90858,47828,43030,10298,414,195,8864,4362,4502,105
9,188,District - Gorakhpur (57),Urban,15-19,100055,53021,47034,11083,451,229,9413,4743,4670,451
9,188,District - Gorakhpur (57),Urban,20-24,87248,46478,40770,8850,392,193,9512,4195,5317,665
9,188,District - Gorakhpur (57),Urban,Adolescent (10-19),190913,100849,90064,21381,865,424,18277,9105,9172,556
9,188,District - Gorakhpur (57),Urban,Youth (15-24),187303,99499,87804,19933,843,422,18925,8938,9987,1116
9,189,District - Kushinagar (58),Total,All Ages,3564544,1818055,1746489,544231,80269,41003,1609724,634333,975391,177147
9,189,District - Kushinagar (58),Total,10-14,464583,238590,225993,70495,10601,5455,53875,22938,30937,2924
9,189,District - Kushinagar (58),Total,15-19,387712,201269,186443,56314,8843,4634,52791,18864,33927,10543
9,189,District - Kushinagar (58),Total,20-24,274817,141103,133714,39832,6028,3117,62963,16328,46635,17367
9,189,District - Kushinagar (58),Total,Adolescent (10-19),852295,439859,412436,126809,19444,10089,106666,41802,64864,13467
9,189,District - Kushinagar (58),Total,Youth (15-24),662529,342372,320157,96146,14871,7751,115754,35192,80562,27910
9,189,District - Kushinagar (58),Rural,All Ages,3396437,1730377,1666060,533210,76851,39171,1550686,608532,942154,172280
9,189,District - Kushinagar (58),Rural,10-14,444632,228109,216523,69085,10147,5208,50802,21413,29389,2889
9,189,District - Kushinagar (58),Rural,15-19,368282,191108,177174,55013,8432,4404,50031,17457,32574,10300
9,189,District - Kushinagar (58),Rural,20-24,258992,132598,126394,38875,5762,2963,60439,15214,45225,16923
9,189,District - Kushinagar (58),Rural,Adolescent (10-19),812914,419217,393697,124098,18579,9612,100833,38870,61963,13189
9,189,District - Kushinagar (58),Rural,Youth (15-24),627274,323706,303568,93888,14194,7367,110470,32671,77799,27223
9,189,District - Kushinagar (58),Urban,All Ages,168107,87678,80429,11021,3418,1832,59038,25801,33237,4867
9,189,District - Kushinagar (58),Urban,10-14,19951,10481,9470,1410,454,247,3073,1525,1548,35
9,189,District - Kushinagar (58),Urban,15-19,19430,10161,9269,1301,411,230,2760,1407,1353,243
9,189,District - Kushinagar (58),Urban,20-24,15825,8505,7320,957,266,154,2524,1114,1410,444
9,189,District - Kushinagar (58),Urban,Adolescent (10-19),39381,20642,18739,2711,865,477,5833,2932,2901,278
9,189,District - Kushinagar (58),Urban,Youth (15-24),35255,18666,16589,2258,677,384,5284,2521,2763,687
9,190,District - Deoria (59),Total,All Ages,3100946,1537436,1563510,468663,109894,54216,1225707,458148,767559,85751
9,190,District - Deoria (59),Total,10-14,408594,209615,198979,63410,15171,7681,28544,12486,16058,1187
9,190,District - Deoria (59),Total,15-19,363661,181260,182401,55139,13037,6441,32310,11230,21080,4744
9,190,District - Deoria (59),Total,20-24,253930,124295,129635,36880,8643,4189,41391,10258,31133,8341
9,190,District - Deoria (59),Total,Adolescent (10-19),772255,390875,381380,118549,28208,14122,60854,23716,37138,5931
9,190,District - Deoria (59),Total,Youth (15-24),617591,305555,312036,92019,21680,10630,73701,21488,52213,13085
9,190,District - Deoria (59),Rural,All Ages,2784143,1373111,1411032,440954,102946,50588,1129716,417822,711894,82573
9,190,District - Deoria (59),Rural,10-14,370808,189808,181000,59719,14275,7206,25240,10904,14336,1168
9,190,District - Deoria (59),Rural,15-19,325946,161567,164379,51749,12231,6019,28734,9475,19259,4577
9,190,District - Deoria (59),Rural,20-24,222845,107582,115263,34311,7996,3834,37886,8788,29098,8021
9,190,District - Deoria (59),Rural,Adolescent (10-19),696754,351375,345379,111468,26506,13225,53974,20379,33595,5745
9,190,District - Deoria (59),Rural,Youth (15-24),548791,269149,279642,86060,20227,9853,66620,18263,48357,12598
9,190,District - Deoria (59),Urban,All Ages,316803,164325,152478,27709,6948,3628,95991,40326,55665,3178
9,190,District - Deoria (59),Urban,10-14,37786,19807,17979,3691,896,475,3304,1582,1722,19
9,190,District - Deoria (59),Urban,15-19,37715,19693,18022,3390,806,422,3576,1755,1821,167
9,190,District - Deoria (59),Urban,20-24,31085,16713,14372,2569,647,355,3505,1470,2035,320
9,190,District - Deoria (59),Urban,Adolescent (10-19),75501,39500,36001,7081,1702,897,6880,3337,3543,186
9,190,District - Deoria (59),Urban,Youth (15-24),68800,36406,32394,5959,1453,777,7081,3225,3856,487
9,191,District - Azamgarh (60),Total,All Ages,4613913,2285004,2328909,1171378,9327,4690,1841996,725590,1116406,153665
9,191,District - Azamgarh (60),Total,10-14,626528,319795,306733,163790,1221,613,38795,17556,21239,2668
9,191,District - Azamgarh (60),Total,15-19,558680,275558,283122,146028,1099,573,44199,16687,27512,8668
9,191,District - Azamgarh (60),Total,20-24,376175,183985,192190,89131,749,371,56420,15906,40514,15123
9,191,District - Azamgarh (60),Total,Adolescent (10-19),1185208,595353,589855,309818,2320,1186,82994,34243,48751,11336
9,191,District - Azamgarh (60),Total,Youth (15-24),934855,459543,475312,235159,1848,944,100619,32593,68026,23791
9,191,District - Azamgarh (60),Rural,All Ages,4220512,2082707,2137805,1123453,8276,4148,1709369,666250,1043119,150567
9,191,District - Azamgarh (60),Rural,10-14,573710,292885,280825,157222,1110,561,32836,14609,18227,2619
9,191,District - Azamgarh (60),Rural,15-19,507798,249427,258371,139673,987,513,38452,13787,24665,8445
9,191,District - Azamgarh (60),Rural,20-24,336344,162731,173613,84784,631,310,50636,13219,37417,14795
9,191,District - Azamgarh (60),Rural,Adolescent (10-19),1081508,542312,539196,296895,2097,1074,71288,28396,42892,11064
9,191,District - Azamgarh (60),Rural,Youth (15-24),844142,412158,431984,224457,1618,823,89088,27006,62082,23240
9,191,District - Azamgarh (60),Urban,All Ages,393401,202297,191104,47925,1051,542,132627,59340,73287,3098
9,191,District - Azamgarh (60),Urban,10-14,52818,26910,25908,6568,111,52,5959,2947,3012,49
9,191,District - Azamgarh (60),Urban,15-19,50882,26131,24751,6355,112,60,5747,2900,2847,223
9,191,District - Azamgarh (60),Urban,20-24,39831,21254,18577,4347,118,61,5784,2687,3097,328
9,191,District - Azamgarh (60),Urban,Adolescent (10-19),103700,53041,50659,12923,223,112,11706,5847,5859,272
9,191,District - Azamgarh (60),Urban,Youth (15-24),90713,47385,43328,10702,230,121,11531,5587,5944,551
9,192,District - Mau (61),Total,All Ages,2205968,1114709,1091259,474537,22915,11464,842924,341627,501297,67343
9,192,District - Mau (61),Total,10-14,293821,150624,143197,63579,3035,1532,20027,9479,10548,999
9,192,District - Mau (61),Total,15-19,262360,132784,129576,57941,2730,1328,20479,8498,11981,3480
9,192,District - Mau (61),Total,20-24,182717,93229,89488,37212,1851,934,24462,7910,16552,6547
9,192,District - Mau (61),Total,Adolescent (10-19),556181,283408,272773,121520,5765,2860,40506,17977,22529,4479
9,192,District - Mau (61),Total,Youth (15-24),445077,226013,219064,95153,4581,2262,44941,16408,28533,10027
9,192,District - Mau (61),Rural,All Ages,1706760,858843,847917,422657,21302,10637,671008,265237,405771,62854
9,192,District - Mau (61),Rural,10-14,226251,116094,110157,56604,2836,1429,12566,5641,6925,932
9,192,District - Mau (61),Rural,15-19,198667,100318,98349,51119,2517,1225,13554,5157,8397,3214
9,192,District - Mau (61),Rural,20-24,132994,66943,66051,32767,1679,835,17664,4923,12741,6118
9,192,District - Mau (61),Rural,Adolescent (10-19),424918,216412,208506,107723,5353,2654,26120,10798,15322,4146
9,192,District - Mau (61),Rural,Youth (15-24),331661,167261,164400,83886,4196,2060,31218,10080,21138,9332
9,192,District - Mau (61),Urban,All Ages,499208,255866,243342,51880,1613,827,171916,76390,95526,4489
9,192,District - Mau (61),Urban,10-14,67570,34530,33040,6975,199,103,7461,3838,3623,67
9,192,District - Mau (61),Urban,15-19,63693,32466,31227,6822,213,103,6925,3341,3584,266
9,192,District - Mau (61),Urban,20-24,49723,26286,23437,4445,172,99,6798,2987,3811,429
9,192,District - Mau (61),Urban,Adolescent (10-19),131263,66996,64267,13797,412,206,14386,7179,7207,333
9,192,District - Mau (61),Urban,Youth (15-24),113416,58752,54664,11267,385,202,13723,6328,7395,695
9,193,District - Ballia (62),Total,All Ages,3239774,1672902,1566872,494698,110114,56817,1276184,511942,764242,161192
9,193,District - Ballia (62),Total,10-14,408496,214040,194456,65739,14787,7809,39319,17051,22268,3478
9,193,District - Ballia (62),Total,15-19,366063,195130,170933,58277,12216,6541,41256,16176,25080,9224
9,193,District - Ballia (62),Total,20-24,257479,135719,121760,37999,8684,4539,45995,13849,32146,14888
9,193,District - Ballia (62),Total,Adolescent (10-19),774559,409170,365389,124016,27003,14350,80575,33227,47348,12702
9,193,District - Ballia (62),Total,Youth (15-24),623542,330849,292693,96276,20900,11080,87251,30025,57226,24112
9,193,District - Ballia (62),Rural,All Ages,2935665,1514018,1421647,466723,99178,51047,1177030,468987,708043,154023
9,193,District - Ballia (62),Rural,10-14,372778,195178,177600,62036,13370,7063,35146,14988,20158,3350
9,193,District - Ballia (62),Rural,15-19,329665,175753,153912,54786,10935,5828,36986,14149,22837,8763
9,193,District - Ballia (62),Rural,20-24,229031,120287,108744,35728,7683,3969,42055,12203,29852,14191
9,193,District - Ballia (62),Rural,Adolescent (10-19),702443,370931,331512,116822,24305,12891,72132,29137,42995,12113
9,193,District - Ballia (62),Rural,Youth (15-24),558696,296040,262656,90514,18618,9797,79041,26352,52689,22954
9,193,District - Ballia (62),Urban,All Ages,304109,158884,145225,27975,10936,5770,99154,42955,56199,7169
9,193,District - Ballia (62),Urban,10-14,35718,18862,16856,3703,1417,746,4173,2063,2110,128
9,193,District - Ballia (62),Urban,15-19,36398,19377,17021,3491,1281,713,4270,2027,2243,461
9,193,District - Ballia (62),Urban,20-24,28448,15432,13016,2271,1001,570,3940,1646,2294,697
9,193,District - Ballia (62),Urban,Adolescent (10-19),72116,38239,33877,7194,2698,1459,8443,4090,4353,589
9,193,District - Ballia (62),Urban,Youth (15-24),64846,34809,30037,5762,2282,1283,8210,3673,4537,1158
9,194,District - Jaunpur (63),Total,All Ages,4494204,2220465,2273739,990345,4736,2363,1762527,655071,1107456,203295
9,194,District - Jaunpur (63),Total,10-14,598761,309313,289448,135800,626,328,36109,15826,20283,3661
9,194,District - Jaunpur (63),Total,15-19,527840,264143,263697,113043,479,232,41933,14577,27356,11842
9,194,District - Jaunpur (63),Total,20-24,372524,179487,193037,76423,354,160,59250,13690,45560,21154
9,194,District - Jaunpur (63),Total,Adolescent (10-19),1126601,573456,553145,248843,1105,560,78042,30403,47639,15503
9,194,District - Jaunpur (63),Total,Youth (15-24),900364,443630,456734,189466,833,392,101183,28267,72916,32996
9,194,District - Jaunpur (63),Rural,All Ages,4147624,2041217,2106407,959704,4486,2237,1656580,609019,1047561,197762
9,194,District - Jaunpur (63),Rural,10-14,557407,287778,269629,131797,593,315,32453,14001,18452,3582
9,194,District - Jaunpur (63),Rural,15-19,484491,241614,242877,109103,458,221,37770,12432,25338,11498
9,194,District - Jaunpur (63),Rural,20-24,335956,160151,175805,73527,327,148,54781,11746,43035,20516
9,194,District - Jaunpur (63),Rural,Adolescent (10-19),1041898,529392,512506,240900,1051,536,70223,26433,43790,15080
9,194,District - Jaunpur (63),Rural,Youth (15-24),820447,401765,418682,182630,785,369,92551,24178,68373,32014
9,194,District - Jaunpur (63),Urban,All Ages,346580,179248,167332,30641,250,126,105947,46052,59895,5533
9,194,District - Jaunpur (63),Urban,10-14,41354,21535,19819,4003,33,13,3656,1825,1831,79
9,194,District - Jaunpur (63),Urban,15-19,43349,22529,20820,3940,21,11,4163,2145,2018,344
9,194,District - Jaunpur (63),Urban,20-24,36568,19336,17232,2896,27,12,4469,1944,2525,638
9,194,District - Jaunpur (63),Urban,Adolescent (10-19),84703,44064,40639,7943,54,24,7819,3970,3849,423
9,194,District - Jaunpur (63),Urban,Youth (15-24),79917,41865,38052,6836,48,23,8632,4089,4543,982
9,195,District - Ghazipur (64),Total,All Ages,3620268,1855075,1765193,726641,28712,14664,1422719,561522,861197,219929
9,195,District - Ghazipur (64),Total,10-14,461695,240337,221358,95488,3597,1893,33076,14718,18358,4091
9,195,District - Ghazipur (64),Total,15-19,404767,213785,190982,81839,3165,1664,34215,12865,21350,11991
9,195,District - Ghazipur (64),Total,20-24,289036,150812,138224,54553,2320,1181,43816,11824,31992,22124
9,195,District - Ghazipur (64),Total,Adolescent (10-19),866462,454122,412340,177327,6762,3557,67291,27583,39708,16082
9,195,District - Ghazipur (64),Total,Youth (15-24),693803,364597,329206,136392,5485,2845,78031,24689,53342,34115
9,195,District - Ghazipur (64),Rural,All Ages,3345908,1711651,1634257,700013,27218,13873,1338167,525180,812987,215483
9,195,District - Ghazipur (64),Rural,10-14,429291,223260,206031,92161,3454,1823,30232,13255,16977,4012
9,195,District - Ghazipur (64),Rural,15-19,371242,196046,175196,78521,2984,1564,31376,11477,19899,11689
9,195,District - Ghazipur (64),Rural,20-24,262029,136131,125898,52205,2178,1099,40886,10582,30304,21650
9,195,District - Ghazipur (64),Rural,Adolescent (10-19),800533,419306,381227,170682,6438,3387,61608,24732,36876,15701
9,195,District - Ghazipur (64),Rural,Youth (15-24),633271,332177,301094,130726,5162,2663,72262,22059,50203,33339
9,195,District - Ghazipur (64),Urban,All Ages,274360,143424,130936,26628,1494,791,84552,36342,48210,4446
9,195,District - Ghazipur (64),Urban,10-14,32404,17077,15327,3327,143,70,2844,1463,1381,79
9,195,District - Ghazipur (64),Urban,15-19,33525,17739,15786,3318,181,100,2839,1388,1451,302
9,195,District - Ghazipur (64),Urban,20-24,27007,14681,12326,2348,142,82,2930,1242,1688,474
9,195,District - Ghazipur (64),Urban,Adolescent (10-19),65929,34816,31113,6645,324,170,5683,2851,2832,381
9,195,District - Ghazipur (64),Urban,Youth (15-24),60532,32420,28112,5666,323,182,5769,2630,3139,776
9,196,District - Chandauli (65),Total,All Ages,1952756,1017905,934851,446786,41725,21571,778150,318451,459699,81869
9,196,District - Chandauli (65),Total,10-14,247411,130193,117218,58044,5295,2720,19978,9332,10646,1121
9,196,District - Chandauli (65),Total,15-19,212657,114913,97744,47197,4484,2364,21515,8864,12651,4380
9,196,District - Chandauli (65),Total,20-24,164182,87445,76737,35174,3351,1755,28827,9026,19801,8396
9,196,District - Chandauli (65),Total,Adolescent (10-19),460068,245106,214962,105241,9779,5084,41493,18196,23297,5501
9,196,District - Chandauli (65),Total,Youth (15-24),376839,202358,174481,82371,7835,4119,50342,17890,32452,12776
9,196,District - Chandauli (65),Rural,All Ages,1710203,890630,819573,412719,37688,19482,696183,282067,414116,79962
9,196,District - Chandauli (65),Rural,10-14,217623,114617,103006,53830,4796,2466,15659,7192,8467,1108
9,196,District - Chandauli (65),Rural,15-19,183009,99241,83768,42942,3950,2074,17145,6678,10467,4271
9,196,District - Chandauli (65),Rural,20-24,140090,74218,65872,31961,2970,1560,24873,7166,17707,8181
9,196,District - Chandauli (65),Rural,Adolescent (10-19),400632,213858,186774,96772,8746,4540,32804,13870,18934,5379
9,196,District - Chandauli (65),Rural,Youth (15-24),323099,173459,149640,74903,6920,3634,42018,13844,28174,12452
9,196,District - Chandauli (65),Urban,All Ages,242553,127275,115278,34067,4037,2089,81967,36384,45583,1907
9,196,District - Chandauli (65),Urban,10-14,29788,15576,14212,4214,499,254,4319,2140,2179,13
9,196,District - Chandauli (65),Urban,15-19,29648,15672,13976,4255,534,290,4370,2186,2184,109
9,196,District - Chandauli (65),Urban,20-24,24092,13227,10865,3213,381,195,3954,1860,2094,215
9,196,District - Chandauli (65),Urban,Adolescent (10-19),59436,31248,28188,8469,1033,544,8689,4326,4363,122
9,196,District - Chandauli (65),Urban,Youth (15-24),53740,28899,24841,7468,915,485,8324,4046,4278,324
9,197,District - Varanasi (66),Total,All Ages,3676841,1921857,1754984,486958,28617,14992,1272938,532741,740197,98334
9,197,District - Varanasi (66),Total,10-14,453183,237732,215451,62837,3737,1920,37374,18327,19047,1284
9,197,District - Varanasi (66),Total,15-19,428313,229883,198430,56793,3359,1838,42591,20045,22546,5865
9,197,District - Varanasi (66),Total,20-24,346716,186901,159815,43571,2736,1464,50805,19565,31240,11386
9,197,District - Varanasi (66),Total,Adolescent (10-19),881496,467615,413881,119630,7096,3758,79965,38372,41593,7149
9,197,District - Varanasi (66),Total,Youth (15-24),775029,416784,358245,100364,6095,3302,93396,39610,53786,17251
9,197,District - Varanasi (66),Rural,All Ages,2079790,1076526,1003264,358612,19144,9912,778558,307070,471488,86557
9,197,District - Varanasi (66),Rural,10-14,273401,142844,130557,47563,2700,1393,12158,5569,6589,1051
9,197,District - Varanasi (66),Rural,15-19,239709,128948,110761,40707,2208,1214,15668,6221,9447,5028
9,197,District - Varanasi (66),Rural,20-24,180298,95254,85044,30019,1674,859,25716,7242,18474,10023
9,197,District - Varanasi (66),Rural,Adolescent (10-19),513110,271792,241318,88270,4908,2607,27826,11790,16036,6079
9,197,District - Varanasi (66),Rural,Youth (15-24),420007,224202,195805,70726,3882,2073,41384,13463,27921,15051
9,197,District - Varanasi (66),Urban,All Ages,1597051,845331,751720,128346,9473,5080,494380,225671,268709,11777
9,197,District - Varanasi (66),Urban,10-14,179782,94888,84894,15274,1037,527,25216,12758,12458,233
9,197,District - Varanasi (66),Urban,15-19,188604,100935,87669,16086,1151,624,26923,13824,13099,837
9,197,District - Varanasi (66),Urban,20-24,166418,91647,74771,13552,1062,605,25089,12323,12766,1363
9,197,District - Varanasi (66),Urban,Adolescent (10-19),368386,195823,172563,31360,2188,1151,52139,26582,25557,1070
9,197,District - Varanasi (66),Urban,Youth (15-24),355022,192582,162440,29638,2213,1229,52012,26147,25865,2200
9,198,District - Sant Ravidas Nagar (Bhadohi) (67),Total,All Ages,1578213,807099,771114,353103,1873,986,668067,260317,407750,36116
9,198,District - Sant Ravidas Nagar (Bhadohi) (67),Total,10-14,213157,112249,100908,48724,251,134,16610,7569,9041,407
9,198,District - Sant Ravidas Nagar (Bhadohi) (67),Total,15-19,183671,97372,86299,38378,216,111,18800,6704,12096,1855
9,198,District - Sant Ravidas Nagar (Bhadohi) (67),Total,20-24,139249,70831,68418,29290,172,94,30009,7117,22892,4134
9,198,District - Sant Ravidas Nagar (Bhadohi) (67),Total,Adolescent (10-19),396828,209621,187207,87102,467,245,35410,14273,21137,2262
9,198,District - Sant Ravidas Nagar (Bhadohi) (67),Total,Youth (15-24),322920,168203,154717,67668,388,205,48809,13821,34988,5989
9,198,District - Sant Ravidas Nagar (Bhadohi) (67),Rural,All Ages,1348911,686589,662322,322782,1758,920,581041,222637,358404,34313
9,198,District - Sant Ravidas Nagar (Bhadohi) (67),Rural,10-14,183422,96714,86708,44641,232,120,12817,5663,7154,389
9,198,District - Sant Ravidas Nagar (Bhadohi) (67),Rural,15-19,155031,82011,73020,34919,202,103,14945,4893,10052,1737
9,198,District - Sant Ravidas Nagar (Bhadohi) (67),Rural,20-24,116528,58258,58270,26724,167,90,25772,5350,20422,3917
9,198,District - Sant Ravidas Nagar (Bhadohi) (67),Rural,Adolescent (10-19),338453,178725,159728,79560,434,223,27762,10556,17206,2126
9,198,District - Sant Ravidas Nagar (Bhadohi) (67),Rural,Youth (15-24),271559,140269,131290,61643,369,193,40717,10243,30474,5654
9,198,District - Sant Ravidas Nagar (Bhadohi) (67),Urban,All Ages,229302,120510,108792,30321,115,66,87026,37680,49346,1803
9,198,District - Sant Ravidas Nagar (Bhadohi) (67),Urban,10-14,29735,15535,14200,4083,19,14,3793,1906,1887,18
9,198,District - Sant Ravidas Nagar (Bhadohi) (67),Urban,15-19,28640,15361,13279,3459,14,8,3855,1811,2044,118
9,198,District - Sant Ravidas Nagar (Bhadohi) (67),Urban,20-24,22721,12573,10148,2566,5,4,4237,1767,2470,217
9,198,District - Sant Ravidas Nagar (Bhadohi) (67),Urban,Adolescent (10-19),58375,30896,27479,7542,33,22,7648,3717,3931,136
9,198,District - Sant Ravidas Nagar (Bhadohi) (67),Urban,Youth (15-24),51361,27934,23427,6025,19,12,8092,3578,4514,335
9,199,District - Mirzapur (68),Total,All Ages,2496970,1312302,1184668,661129,20132,10480,1068287,446465,621822,151210
9,199,District - Mirzapur (68),Total,10-14,324099,171021,153078,88952,2757,1448,25079,11390,13689,2192
9,199,District - Mirzapur (68),Total,15-19,268119,148076,120043,67918,2011,1093,29018,11517,17501,9433
9,199,District - Mirzapur (68),Total,20-24,217387,118268,99119,54513,1595,824,46540,13165,33375,18164
9,199,District - Mirzapur (68),Total,Adolescent (10-19),592218,319097,273121,156870,4768,2541,54097,22907,31190,11625
9,199,District - Mirzapur (68),Total,Youth (15-24),485506,266344,219162,122431,3606,1917,75558,24682,50876,27597
9,199,District - Mirzapur (68),Rural,All Ages,2149403,1127138,1022265,613590,19188,9973,947819,393285,554534,147121
9,199,District - Mirzapur (68),Rural,10-14,283901,149629,134272,82797,2645,1391,20097,8838,11259,2124
9,199,District - Mirzapur (68),Rural,15-19,227722,125795,101927,62254,1905,1038,23681,8833,14848,9190
9,199,District - Mirzapur (68),Rural,20-24,182012,97954,84058,49919,1487,765,40789,10580,30209,17726
9,199,District - Mirzapur (68),Rural,Adolescent (10-19),511623,275424,236199,145051,4550,2429,43778,17671,26107,11314
9,199,District - Mirzapur (68),Rural,Youth (15-24),409734,223749,185985,112173,3392,1803,64470,19413,45057,26916
9,199,District - Mirzapur (68),Urban,All Ages,347567,185164,162403,47539,944,507,120468,53180,67288,4089
9,199,District - Mirzapur (68),Urban,10-14,40198,21392,18806,6155,112,57,4982,2552,2430,68
9,199,District - Mirzapur (68),Urban,15-19,40397,22281,18116,5664,106,55,5337,2684,2653,243
9,199,District - Mirzapur (68),Urban,20-24,35375,20314,15061,4594,108,59,5751,2585,3166,438
9,199,District - Mirzapur (68),Urban,Adolescent (10-19),80595,43673,36922,11819,218,112,10319,5236,5083,311
9,199,District - Mirzapur (68),Urban,Youth (15-24),75772,42595,33177,10258,214,114,11088,5269,5819,681
9,200,District - Sonbhadra (69),Total,All Ages,1862559,971344,891215,421661,385018,197825,876851,369356,507495,147315
9,200,District - Sonbhadra (69),Total,10-14,247413,128302,119111,57394,52277,26830,28559,11840,16719,2266
9,200,District - Sonbhadra (69),Total,15-19,188531,102164,86367,41514,35060,18868,27789,9849,17940,9155
9,200,District - Sonbhadra (69),Total,20-24,156577,81176,75401,33599,29868,14832,42172,11471,30701,18231
9,200,District - Sonbhadra (69),Total,Adolescent (10-19),435944,230466,205478,98908,87337,45698,56348,21689,34659,11421
9,200,District - Sonbhadra (69),Total,Youth (15-24),345108,183340,161768,75113,64928,33700,69961,21320,48641,27386
9,200,District - Sonbhadra (69),Rural,All Ages,1548217,803345,744872,384816,374916,192524,795341,335248,460093,144654
9,200,District - Sonbhadra (69),Rural,10-14,210991,108969,102022,52853,51046,26195,26261,10770,15491,2240
9,200,District - Sonbhadra (69),Rural,15-19,150936,81987,68949,37039,33904,18244,25570,8888,16682,8991
9,200,District - Sonbhadra (69),Rural,20-24,123840,63621,60219,29762,28873,14294,39358,10501,28857,17959
9,200,District - Sonbhadra (69),Rural,Adolescent (10-19),361927,190956,170971,89892,84950,44439,51831,19658,32173,11231
9,200,District - Sonbhadra (69),Rural,Youth (15-24),274776,145608,129168,66801,62777,32538,64928,19389,45539,26950
9,200,District - Sonbhadra (69),Urban,All Ages,314342,167999,146343,36845,10102,5301,81510,34108,47402,2661
9,200,District - Sonbhadra (69),Urban,10-14,36422,19333,17089,4541,1231,635,2298,1070,1228,26
9,200,District - Sonbhadra (69),Urban,15-19,37595,20177,17418,4475,1156,624,2219,961,1258,164
9,200,District - Sonbhadra (69),Urban,20-24,32737,17555,15182,3837,995,538,2814,970,1844,272
9,200,District - Sonbhadra (69),Urban,Adolescent (10-19),74017,39510,34507,9016,2387,1259,4517,2031,2486,190
9,200,District - Sonbhadra (69),Urban,Youth (15-24),70332,37732,32600,8312,2151,1162,5033,1931,3102,436
9,201,District - Etah (70),Total,All Ages,1774480,947339,827141,281011,140,87,719278,300297,418981,80122
9,201,District - Etah (70),Total,10-14,240411,131179,109232,39412,20,13,25990,12420,13570,1139
9,201,District - Etah (70),Total,15-19,210531,117601,92930,32903,10,5,25709,10974,14735,7413
9,201,District - Etah (70),Total,20-24,156459,86313,70146,24216,15,10,31537,10339,21198,12185
9,201,District - Etah (70),Total,Adolescent (10-19),450942,248780,202162,72315,30,18,51699,23394,28305,8552
9,201,District - Etah (70),Total,Youth (15-24),366990,203914,163076,57119,25,15,57246,21313,35933,19598
9,201,District - Etah (70),Rural,All Ages,1506338,805589,700749,245671,34,20,628622,259003,369619,74682
9,201,District - Etah (70),Rural,10-14,207637,113260,94377,34731,6,5,21102,9891,11211,1086
9,201,District - Etah (70),Rural,15-19,177980,100175,77805,28523,5,1,20671,8450,12221,6946
9,201,District - Etah (70),Rural,20-24,128821,71426,57395,20689,4,2,26640,8053,18587,11396
9,201,District - Etah (70),Rural,Adolescent (10-19),385617,213435,172182,63254,11,6,41773,18341,23432,8032
9,201,District - Etah (70),Rural,Youth (15-24),306801,171601,135200,49212,9,3,47311,16503,30808,18342
9,201,District - Etah (70),Urban,All Ages,268142,141750,126392,35340,106,67,90656,41294,49362,5440
9,201,District - Etah (70),Urban,10-14,32774,17919,14855,4681,14,8,4888,2529,2359,53
9,201,District - Etah (70),Urban,15-19,32551,17426,15125,4380,5,4,5038,2524,2514,467
9,201,District - Etah (70),Urban,20-24,27638,14887,12751,3527,11,8,4897,2286,2611,789
9,201,District - Etah (70),Urban,Adolescent (10-19),65325,35345,29980,9061,19,12,9926,5053,4873,520
9,201,District - Etah (70),Urban,Youth (15-24),60189,32313,27876,7907,16,12,9935,4810,5125,1256
9,202,District - Kanshiram Nagar (71),Total,All Ages,1436719,764165,672554,254299,150,80,711869,311362,400507,63666
9,202,District - Kanshiram Nagar (71),Total,10-14,199792,107678,92114,36882,20,11,35709,17298,18411,1145
9,202,District - Kanshiram Nagar (71),Total,15-19,168442,92803,75639,29082,16,6,36057,15999,20058,7725
9,202,District - Kanshiram Nagar (71),Total,20-24,122499,67386,55113,21030,10,7,38596,14251,24345,10375
9,202,District - Kanshiram Nagar (71),Total,Adolescent (10-19),368234,200481,167753,65964,36,17,71766,33297,38469,8870
9,202,District - Kanshiram Nagar (71),Total,Youth (15-24),290941,160189,130752,50112,26,13,74653,30250,44403,18100
9,202,District - Kanshiram Nagar (71),Rural,All Ages,1148512,612556,535956,222875,120,66,582984,251994,330990,55870
9,202,District - Kanshiram Nagar (71),Rural,10-14,162672,87764,74908,32484,14,9,26401,12546,13855,1034
9,202,District - Kanshiram Nagar (71),Rural,15-19,132978,74024,58954,25124,13,5,26846,11514,15332,6947
9,202,District - Kanshiram Nagar (71),Rural,20-24,93981,51949,42032,17939,8,6,30609,10504,20105,9120
9,202,District - Kanshiram Nagar (71),Rural,Adolescent (10-19),295650,161788,133862,57608,27,14,53247,24060,29187,7981
9,202,District - Kanshiram Nagar (71),Rural,Youth (15-24),226959,125973,100986,43063,21,11,57455,22018,35437,16067
9,202,District - Kanshiram Nagar (71),Urban,All Ages,288207,151609,136598,31424,30,14,128885,59368,69517,7796
9,202,District - Kanshiram Nagar (71),Urban,10-14,37120,19914,17206,4398,6,2,9308,4752,4556,111
9,202,District - Kanshiram Nagar (71),Urban,15-19,35464,18779,16685,3958,3,1,9211,4485,4726,778
9,202,District - Kanshiram Nagar (71),Urban,20-24,28518,15437,13081,3091,2,1,7987,3747,4240,1255
9,202,District - Kanshiram Nagar (71),Urban,Adolescent (10-19),72584,38693,33891,8356,9,3,18519,9237,9282,889
9,202,District - Kanshiram Nagar (71),Urban,Youth (15-24),63982,34216,29766,7049,5,2,17198,8232,8966,2033
10,0,State - BIHAR (10),Total,All Ages,104099452,54278157,49821295,16567325,1336573,682516,51594899,22670134,28924765,9537418
10,0,State - BIHAR (10),Total,10-14,13919882,7323831,6596051,2260712,181436,94152,2323371,1063679,1259692,151655
10,0,State - BIHAR (10),Total,15-19,9472695,5290581,4182114,1356347,120454,65915,2134176,962553,1171623,599921
10,0,State - BIHAR (10),Total,20-24,8064735,4210585,3854150,1235167,98236,49021,2725795,979683,1746112,1090689
10,0,State - BIHAR (10),Total,Adolescent (10-19),23392577,12614412,10778165,3617059,301890,160067,4457547,2026232,2431315,751576
10,0,State - BIHAR (10),Total,Youth (15-24),17537430,9501166,8036264,2591514,218690,114936,4859971,1942236,2917735,1690610
10,0,State - BIHAR (10),Rural,All Ages,92341436,48073850,44267586,15344215,1270851,648535,47529284,20832020,26697264,9225709
10,0,State - BIHAR (10),Rural,10-14,12472947,6563975,5908972,2099320,172618,89570,2144143,973866,1170277,148088
10,0,State - BIHAR (10),Rural,15-19,8243729,4622498,3621231,1232617,113112,61879,1965209,876423,1088786,580793
10,0,State - BIHAR (10),Rural,20-24,7011053,3644529,3366524,1130196,92399,45938,2534768,899008,1635760,1056658
10,0,State - BIHAR (10),Rural,Adolescent (10-19),20716676,11186473,9530203,3331937,285730,151449,4109352,1850289,2259063,728881
10,0,State - BIHAR (10),Rural,Youth (15-24),15254782,8267027,6987755,2362813,205511,107817,4499977,1775431,2724546,1637451
10,0,State - BIHAR (10),Urban,All Ages,11758016,6204307,5553709,1223110,65722,33981,4065615,1838114,2227501,311709
10,0,State - BIHAR (10),Urban,10-14,1446935,759856,687079,161392,8818,4582,179228,89813,89415,3567
10,0,State - BIHAR (10),Urban,15-19,1228966,668083,560883,123730,7342,4036,168967,86130,82837,19128
10,0,State - BIHAR (10),Urban,20-24,1053682,566056,487626,104971,5837,3083,191027,80675,110352,34031
10,0,State - BIHAR (10),Urban,Adolescent (10-19),2675901,1427939,1247962,285122,16160,8618,348195,175943,172252,22695
10,0,State - BIHAR (10),Urban,Youth (15-24),2282648,1234139,1048509,228701,13179,7119,359994,166805,193189,53159
10,203,District - Pashchim Champaran (01),Total,All Ages,3935042,2061110,1873932,553944,250046,127680,2175561,969884,1205677,464772
10,203,District - Pashchim Champaran (01),Total,10-14,526888,277964,248924,73460,33784,17310,98891,43748,55143,7632
10,203,District - Pashchim Champaran (01),Total,15-19,331086,189463,141623,41244,22296,11896,82669,37377,45292,28444
10,203,District - Pashchim Champaran (01),Total,20-24,278401,146737,131664,37194,17223,8453,109186,38574,70612,48878
10,203,District - Pashchim Champaran (01),Total,Adolescent (10-19),857974,467427,390547,114704,56080,29206,181560,81125,100435,36076
10,203,District - Pashchim Champaran (01),Total,Youth (15-24),609487,336200,273287,78438,39519,20349,191855,75951,115904,77322
10,203,District - Pashchim Champaran (01),Rural,All Ages,3541877,1853809,1688068,524727,245578,125327,2016473,897416,1119057,448353
10,203,District - Pashchim Champaran (01),Rural,10-14,476593,251845,224748,69613,33170,16981,92072,40389,51683,7483
10,203,District - Pashchim Champaran (01),Rural,15-19,290885,167335,123550,38438,21831,11645,76451,34063,42388,27495
10,203,District - Pashchim Champaran (01),Rural,20-24,244785,128210,116575,34912,16878,8260,101666,35373,66293,47121
10,203,District - Pashchim Champaran (01),Rural,Adolescent (10-19),767478,419180,348298,108051,55001,28626,168523,74452,94071,34978
10,203,District - Pashchim Champaran (01),Rural,Youth (15-24),535670,295545,240125,73350,38709,19905,178117,69436,108681,74616
10,203,District - Pashchim Champaran (01),Urban,All Ages,393165,207301,185864,29217,4468,2353,159088,72468,86620,16419
10,203,District - Pashchim Champaran (01),Urban,10-14,50295,26119,24176,3847,614,329,6819,3359,3460,149
10,203,District - Pashchim Champaran (01),Urban,15-19,40201,22128,18073,2806,465,251,6218,3314,2904,949
10,203,District - Pashchim Champaran (01),Urban,20-24,33616,18527,15089,2282,345,193,7520,3201,4319,1757
10,203,District - Pashchim Champaran (01),Urban,Adolescent (10-19),90496,48247,42249,6653,1079,580,13037,6673,6364,1098
10,203,District - Pashchim Champaran (01),Urban,Youth (15-24),73817,40655,33162,5088,810,444,13738,6515,7223,2706
10,204,District - Purba Champaran (02),Total,All Ages,5099371,2681209,2418162,649726,12461,6454,2822414,1273606,1548808,615189
10,204,District - Purba Champaran (02),Total,10-14,685087,365982,319105,87012,1641,873,130212,60190,70022,9665
10,204,District - Purba Champaran (02),Total,15-19,421622,248553,173069,48146,924,550,109564,53941,55623,37447
10,204,District - Purba Champaran (02),Total,20-24,365803,190512,175291,43745,819,429,149807,54501,95306,66382
10,204,District - Purba Champaran (02),Total,Adolescent (10-19),1106709,614535,492174,135158,2565,1423,239776,114131,125645,47112
10,204,District - Purba Champaran (02),Total,Youth (15-24),787425,439065,348360,91891,1743,979,259371,108442,150929,103829
10,204,District - Purba Champaran (02),Rural,All Ages,4698028,2468181,2229847,612980,11875,6148,2659248,1198281,1460967,594494
10,204,District - Purba Champaran (02),Rural,10-14,634009,338713,295296,82103,1553,829,123075,56509,66566,9444
10,204,District - Purba Champaran (02),Rural,15-19,382802,226575,156227,44939,865,519,103227,50422,52805,36005
10,204,District - Purba Champaran (02),Rural,20-24,332473,172445,160028,40891,778,406,141704,51138,90566,63958
10,204,District - Purba Champaran (02),Rural,Adolescent (10-19),1016811,565288,451523,127042,2418,1348,226302,106931,119371,45449
10,204,District - Purba Champaran (02),Rural,Youth (15-24),715275,399020,316255,85830,1643,925,244931,101560,143371,99963
10,204,District - Purba Champaran (02),Urban,All Ages,401343,213028,188315,36746,586,306,163166,75325,87841,20695
10,204,District - Purba Champaran (02),Urban,10-14,51078,27269,23809,4909,88,44,7137,3681,3456,221
10,204,District - Purba Champaran (02),Urban,15-19,38820,21978,16842,3207,59,31,6337,3519,2818,1442
10,204,District - Purba Champaran (02),Urban,20-24,33330,18067,15263,2854,41,23,8103,3363,4740,2424
10,204,District - Purba Champaran (02),Urban,Adolescent (10-19),89898,49247,40651,8116,147,75,13474,7200,6274,1663
10,204,District - Purba Champaran (02),Urban,Youth (15-24),72150,40045,32105,6061,100,54,14440,6882,7558,3866
10,205,District - Sheohar (03),Total,All Ages,656246,346673,309573,96655,318,177,372548,175028,197520,82108
10,205,District - Sheohar (03),Total,10-14,87688,46852,40836,13212,43,30,20277,9853,10424,1247
10,205,District - Sheohar (03),Total,15-19,55574,32259,23315,7104,21,12,16809,8799,8010,4840
10,205,District - Sheohar (03),Total,20-24,47865,25179,22686,6778,15,7,19802,8188,11614,8946
10,205,District - Sheohar (03),Total,Adolescent (10-19),143262,79111,64151,20316,64,42,37086,18652,18434,6087
10,205,District - Sheohar (03),Total,Youth (15-24),103439,57438,46001,13882,36,19,36611,16987,19624,13786
10,205,District - Sheohar (03),Rural,All Ages,628130,331792,296338,92917,296,167,358507,168631,189876,79061
10,205,District - Sheohar (03),Rural,10-14,83885,44817,39068,12683,40,28,19568,9505,10063,1208
10,205,District - Sheohar (03),Rural,15-19,52993,30814,22179,6803,19,12,16194,8480,7714,4649
10,205,District - Sheohar (03),Rural,20-24,45649,24008,21641,6515,15,7,19110,7910,11200,8599
10,205,District - Sheohar (03),Rural,Adolescent (10-19),136878,75631,61247,19486,59,40,35762,17985,17777,5857
10,205,District - Sheohar (03),Rural,Youth (15-24),98642,54822,43820,13318,34,19,35304,16390,18914,13248
10,205,District - Sheohar (03),Urban,All Ages,28116,14881,13235,3738,22,10,14041,6397,7644,3047
10,205,District - Sheohar (03),Urban,10-14,3803,2035,1768,529,3,2,709,348,361,39
10,205,District - Sheohar (03),Urban,15-19,2581,1445,1136,301,2,0,615,319,296,191
10,205,District - Sheohar (03),Urban,20-24,2216,1171,1045,263,0,0,692,278,414,347
10,205,District - Sheohar (03),Urban,Adolescent (10-19),6384,3480,2904,830,5,2,1324,667,657,230
10,205,District - Sheohar (03),Urban,Youth (15-24),4797,2616,2181,564,2,0,1307,597,710,538
10,206,District - Sitamarhi (04),Total,All Ages,3423574,1803252,1620322,405714,2989,1585,1986780,918064,1068716,390952
10,206,District - Sitamarhi (04),Total,10-14,459182,246079,213103,54822,398,208,118995,56817,62178,5915
10,206,District - Sitamarhi (04),Total,15-19,292234,169406,122828,30876,249,154,95745,48640,47105,25873
10,206,District - Sitamarhi (04),Total,20-24,256750,134693,122057,28999,232,115,113623,45217,68406,44102
10,206,District - Sitamarhi (04),Total,Adolescent (10-19),751416,415485,335931,85698,647,362,214740,105457,109283,31788
10,206,District - Sitamarhi (04),Total,Youth (15-24),548984,304099,244885,59875,481,269,209368,93857,115511,69975
10,206,District - Sitamarhi (04),Rural,All Ages,3233076,1701685,1531391,388240,2836,1502,1912107,883493,1028614,383575
10,206,District - Sitamarhi (04),Rural,10-14,435490,233514,201976,52620,368,191,115366,55028,60338,5833
10,206,District - Sitamarhi (04),Rural,15-19,273840,159068,114772,29281,237,148,92370,46847,45523,25407
10,206,District - Sitamarhi (04),Rural,20-24,240538,125999,114539,27519,226,113,109803,43618,66185,43254
10,206,District - Sitamarhi (04),Rural,Adolescent (10-19),709330,392582,316748,81901,605,339,207736,101875,105861,31240
10,206,District - Sitamarhi (04),Rural,Youth (15-24),514378,285067,229311,56800,463,261,202173,90465,111708,68661
10,206,District - Sitamarhi (04),Urban,All Ages,190498,101567,88931,17474,153,83,74673,34571,40102,7377
10,206,District - Sitamarhi (04),Urban,10-14,23692,12565,11127,2202,30,17,3629,1789,1840,82
10,206,District - Sitamarhi (04),Urban,15-19,18394,10338,8056,1595,12,6,3375,1793,1582,466
10,206,District - Sitamarhi (04),Urban,20-24,16212,8694,7518,1480,6,2,3820,1599,2221,848
10,206,District - Sitamarhi (04),Urban,Adolescent (10-19),42086,22903,19183,3797,42,23,7004,3582,3422,548
10,206,District - Sitamarhi (04),Urban,Youth (15-24),34606,19032,15574,3075,18,8,7195,3392,3803,1314
10,207,District - Madhubani (05),Total,All Ages,4487379,2329313,2158066,587158,3990,2056,2332041,989228,1342813,565141
10,207,District - Madhubani (05),Total,10-14,604694,316723,287971,82986,493,265,102524,43404,59120,9423
10,207,District - Madhubani (05),Total,15-19,392964,221114,171850,46517,381,194,101489,42233,59256,32830
10,207,District - Madhubani (05),Total,20-24,340878,177729,163149,42665,374,192,131580,43166,88414,63287
10,207,District - Madhubani (05),Total,Adolescent (10-19),997658,537837,459821,129503,874,459,204013,85637,118376,42253
10,207,District - Madhubani (05),Total,Youth (15-24),733842,398843,334999,89182,755,386,233069,85399,147670,96117
10,207,District - Madhubani (05),Rural,All Ages,4325884,2244287,2081597,572195,3859,1985,2266989,960662,1306327,557528
10,207,District - Madhubani (05),Rural,10-14,584313,305905,278408,80873,485,261,99172,41807,57365,9304
10,207,District - Madhubani (05),Rural,15-19,376847,212289,164558,45024,368,188,98160,40661,57499,32357
10,207,District - Madhubani (05),Rural,20-24,326796,170093,156703,41415,360,185,128036,41738,86298,62421
10,207,District - Madhubani (05),Rural,Adolescent (10-19),961160,518194,442966,125897,853,449,197332,82468,114864,41661
10,207,District - Madhubani (05),Rural,Youth (15-24),703643,382382,321261,86439,728,373,226196,82399,143797,94778
10,207,District - Madhubani (05),Urban,All Ages,161495,85026,76469,14963,131,71,65052,28566,36486,7613
10,207,District - Madhubani (05),Urban,10-14,20381,10818,9563,2113,8,4,3352,1597,1755,119
10,207,District - Madhubani (05),Urban,15-19,16117,8825,7292,1493,13,6,3329,1572,1757,473
10,207,District - Madhubani (05),Urban,20-24,14082,7636,6446,1250,14,7,3544,1428,2116,866
10,207,District - Madhubani (05),Urban,Adolescent (10-19),36498,19643,16855,3606,21,10,6681,3169,3512,592
10,207,District - Madhubani (05),Urban,Youth (15-24),30199,16461,13738,2743,27,13,6873,3000,3873,1339
10,208,District - Supaul (06),Total,All Ages,2229076,1155283,1073793,354249,10168,5242,1195793,507611,688182,251652
10,208,District - Supaul (06),Total,10-14,304876,161182,143694,48940,1502,792,47096,18528,28568,3745
10,208,District - Supaul (06),Total,15-19,175255,100021,75234,24160,882,483,44152,16415,27737,13816
10,208,District - Supaul (06),Total,20-24,164616,79092,85524,25526,665,306,69953,19507,50446,29199
10,208,District - Supaul (06),Total,Adolescent (10-19),480131,261203,218928,73100,2384,1275,91248,34943,56305,17561
10,208,District - Supaul (06),Total,Youth (15-24),339871,179113,160758,49686,1547,789,114105,35922,78183,43015
10,208,District - Supaul (06),Rural,All Ages,2123518,1099495,1024023,343484,10027,5163,1154174,489507,664667,247847
10,208,District - Supaul (06),Rural,10-14,290971,153867,137104,47402,1467,769,45659,17851,27808,3726
10,208,District - Supaul (06),Rural,15-19,165546,94541,71005,23206,865,473,42693,15759,26934,13648
10,208,District - Supaul (06),Rural,20-24,155676,74432,81244,24700,658,302,67746,18769,48977,28792
10,208,District - Supaul (06),Rural,Adolescent (10-19),456517,248408,208109,70608,2332,1242,88352,33610,54742,17374
10,208,District - Supaul (06),Rural,Youth (15-24),321222,168973,152249,47906,1523,775,110439,34528,75911,42440
10,208,District - Supaul (06),Urban,All Ages,105558,55788,49770,10765,141,79,41619,18104,23515,3805
10,208,District - Supaul (06),Urban,10-14,13905,7315,6590,1538,35,23,1437,677,760,19
10,208,District - Supaul (06),Urban,15-19,9709,5480,4229,954,17,10,1459,656,803,168
10,208,District - Supaul (06),Urban,20-24,8940,4660,4280,826,7,4,2207,738,1469,407
10,208,District - Supaul (06),Urban,Adolescent (10-19),23614,12795,10819,2492,52,33,2896,1333,1563,187
10,208,District - Supaul (06),Urban,Youth (15-24),18649,10140,8509,1780,24,14,3666,1394,2272,575
10,209,District - Araria (07),Total,All Ages,2811569,1463333,1348236,382654,38848,19887,1615801,735690,880111,414626
10,209,District - Araria (07),Total,10-14,384787,201419,183368,51775,5312,2747,79934,36867,43067,7334
10,209,District - Araria (07),Total,15-19,242051,137282,104769,26375,3359,1858,75683,34868,40815,30513
10,209,District - Araria (07),Total,20-24,208174,105196,102978,27288,2957,1406,95337,34543,60794,50093
10,209,District - Araria (07),Total,Adolescent (10-19),626838,338701,288137,78150,8671,4605,155617,71735,83882,37847
10,209,District - Araria (07),Total,Youth (15-24),450225,242478,207747,53663,6316,3264,171020,69411,101609,80606
10,209,District - Araria (07),Rural,All Ages,2642792,1374254,1268538,366088,38337,19609,1548389,704686,843703,407205
10,209,District - Araria (07),Rural,10-14,362975,189987,172988,49518,5228,2692,76887,35411,41476,7251
10,209,District - Araria (07),Rural,15-19,225289,128277,97012,24929,3318,1837,72914,33552,39362,29955
10,209,District - Araria (07),Rural,20-24,193564,97480,96084,25973,2927,1389,91917,33150,58767,49232
10,209,District - Araria (07),Rural,Adolescent (10-19),588264,318264,270000,74447,8546,4529,149801,68963,80838,37206
10,209,District - Araria (07),Rural,Youth (15-24),418853,225757,193096,50902,6245,3226,164831,66702,98129,79187
10,209,District - Araria (07),Urban,All Ages,168777,89079,79698,16566,511,278,67412,31004,36408,7421
10,209,District - Araria (07),Urban,10-14,21812,11432,10380,2257,84,55,3047,1456,1591,83
10,209,District - Araria (07),Urban,15-19,16762,9005,7757,1446,41,21,2769,1316,1453,558
10,209,District - Araria (07),Urban,20-24,14610,7716,6894,1315,30,17,3420,1393,2027,861
10,209,District - Araria (07),Urban,Adolescent (10-19),38574,20437,18137,3703,125,76,5816,2772,3044,641
10,209,District - Araria (07),Urban,Youth (15-24),31372,16721,14651,2761,71,38,6189,2709,3480,1419
10,210,District - Kishanganj (08),Total,All Ages,1690400,866970,823430,113118,64224,32506,945344,427049,518295,220301
10,210,District - Kishanganj (08),Total,10-14,235574,119952,115622,14556,7851,4117,42094,19334,22760,4087
10,210,District - Kishanganj (08),Total,15-19,164326,86245,78081,8663,4811,2711,50335,22518,27817,21161
10,210,District - Kishanganj (08),Total,20-24,126113,66333,59780,7964,4609,2169,53421,21701,31720,26879
10,210,District - Kishanganj (08),Total,Adolescent (10-19),399900,206197,193703,23219,12662,6828,92429,41852,50577,25248
10,210,District - Kishanganj (08),Total,Youth (15-24),290439,152578,137861,16627,9420,4880,103756,44219,59537,48040
10,210,District - Kishanganj (08),Rural,All Ages,1529277,783318,745959,95770,60968,30877,879811,397008,482803,212968
10,210,District - Kishanganj (08),Rural,10-14,215199,109635,105564,12462,7452,3914,39606,18121,21485,3962
10,210,District - Kishanganj (08),Rural,15-19,147569,77331,70238,6950,4503,2540,47435,21079,26356,20476
10,210,District - Kishanganj (08),Rural,20-24,112378,59208,53170,6509,4349,2052,50080,20353,29727,26011
10,210,District - Kishanganj (08),Rural,Adolescent (10-19),362768,186966,175802,19412,11955,6454,87041,39200,47841,24438
10,210,District - Kishanganj (08),Rural,Youth (15-24),259947,136539,123408,13459,8852,4592,97515,41432,56083,46487
10,210,District - Kishanganj (08),Urban,All Ages,161123,83652,77471,17348,3256,1629,65533,30041,35492,7333
10,210,District - Kishanganj (08),Urban,10-14,20375,10317,10058,2094,399,203,2488,1213,1275,125
10,210,District - Kishanganj (08),Urban,15-19,16757,8914,7843,1713,308,171,2900,1439,1461,685
10,210,District - Kishanganj (08),Urban,20-24,13735,7125,6610,1455,260,117,3341,1348,1993,868
10,210,District - Kishanganj (08),Urban,Adolescent (10-19),37132,19231,17901,3807,707,374,5388,2652,2736,810
10,210,District - Kishanganj (08),Urban,Youth (15-24),30492,16039,14453,3168,568,288,6241,2787,3454,1553
10,211,District - Purnia (09),Total,All Ages,3264619,1699370,1565249,390991,139490,71391,1932293,894109,1038184,474573
10,211,District - Purnia (09),Total,10-14,439691,230529,209162,52299,18921,9864,112773,52539,60234,8750
10,211,District - Purnia (09),Total,15-19,290647,161677,128970,28773,12431,7022,105344,48933,56411,35808
10,211,District - Purnia (09),Total,20-24,250487,127770,122717,28201,10644,5324,123250,48452,74798,57552
10,211,District - Purnia (09),Total,Adolescent (10-19),730338,392206,338132,81072,31352,16886,218117,101472,116645,44558
10,211,District - Purnia (09),Total,Youth (15-24),541134,289447,251687,56974,23075,12346,228594,97385,131209,93360
10,211,District - Purnia (09),Rural,All Ages,2921614,1519522,1402092,358546,121532,62203,1799989,833009,966980,460417
10,211,District - Purnia (09),Rural,10-14,397733,208576,189157,48218,16400,8568,106002,49127,56875,8543
10,211,District - Purnia (09),Rural,15-19,257437,143686,113751,25827,10581,5999,99443,46040,53403,34879
10,211,District - Purnia (09),Rural,20-24,220438,112192,108246,25477,9128,4531,116063,45569,70494,55941
10,211,District - Purnia (09),Rural,Adolescent (10-19),655170,352262,302908,74045,26981,14567,205445,95167,110278,43422
10,211,District - Purnia (09),Rural,Youth (15-24),477875,255878,221997,51304,19709,10530,215506,91609,123897,90820
10,211,District - Purnia (09),Urban,All Ages,343005,179848,163157,32445,17958,9188,132304,61100,71204,14156
10,211,District - Purnia (09),Urban,10-14,41958,21953,20005,4081,2521,1296,6771,3412,3359,207
10,211,District - Purnia (09),Urban,15-19,33210,17991,15219,2946,1850,1023,5901,2893,3008,929
10,211,District - Purnia (09),Urban,20-24,30049,15578,14471,2724,1516,793,7187,2883,4304,1611
10,211,District - Purnia (09),Urban,Adolescent (10-19),75168,39944,35224,7027,4371,2319,12672,6305,6367,1136
10,211,District - Purnia (09),Urban,Youth (15-24),63259,33569,29690,5670,3366,1816,13088,5776,7312,2540
10,212,District - Katihar (10),Total,All Ages,3071029,1600430,1470599,263100,179971,92190,1790839,838174,952665,399923
10,212,District - Katihar (10),Total,10-14,420901,218657,202244,35485,23847,12565,95067,46407,48660,6639
10,212,District - Katihar (10),Total,15-19,278480,157249,121231,21141,14846,8443,94974,47249,47725,32238
10,212,District - Katihar (10),Total,20-24,242945,127163,115782,20051,13566,6838,114384,47725,66659,50800
10,212,District - Katihar (10),Total,Adolescent (10-19),699381,375906,323475,56626,38693,21008,190041,93656,96385,38877
10,212,District - Katihar (10),Total,Youth (15-24),521425,284412,237013,41192,28412,15281,209358,94974,114384,83038
10,212,District - Katihar (10),Rural,All Ages,2797207,1455744,1341463,231323,174106,89095,1697450,795660,901790,392627
10,212,District - Katihar (10),Rural,10-14,388148,201637,186511,31418,23030,12148,91476,44560,46916,6592
10,212,District - Katihar (10),Rural,15-19,250236,141953,108283,17773,14169,8061,91134,45280,45854,31823
10,212,District - Katihar (10),Rural,20-24,217681,113590,104091,17078,13021,6531,109864,45820,64044,49971
10,212,District - Katihar (10),Rural,Adolescent (10-19),638384,343590,294794,49191,37199,20209,182610,89840,92770,38415
10,212,District - Katihar (10),Rural,Youth (15-24),467917,255543,212374,34851,27190,14592,200998,91100,109898,81794
10,212,District - Katihar (10),Urban,All Ages,273822,144686,129136,31777,5865,3095,93389,42514,50875,7296
10,212,District - Katihar (10),Urban,10-14,32753,17020,15733,4067,817,417,3591,1847,1744,47
10,212,District - Katihar (10),Urban,15-19,28244,15296,12948,3368,677,382,3840,1969,1871,415
10,212,District - Katihar (10),Urban,20-24,25264,13573,11691,2973,545,307,4520,1905,2615,829
10,212,District - Katihar (10),Urban,Adolescent (10-19),60997,32316,28681,7435,1494,799,7431,3816,3615,462
10,212,District - Katihar (10),Urban,Youth (15-24),53508,28869,24639,6341,1222,689,8360,3874,4486,1244
10,213,District - Madhepura (11),Total,All Ages,2001762,1047559,954203,346275,12532,6442,1167185,529893,637292,238882
10,213,District - Madhepura (11),Total,10-14,267793,143179,124614,47125,1743,923,61948,28425,33523,3593
10,213,District - Madhepura (11),Total,15-19,158110,91435,66675,22872,1199,643,49250,22334,26916,13503
10,213,District - Madhepura (11),Total,20-24,150313,73582,76731,24911,968,480,72921,24732,48189,28994
10,213,District - Madhepura (11),Total,Adolescent (10-19),425903,234614,191289,69997,2942,1566,111198,50759,60439,17096
10,213,District - Madhepura (11),Total,Youth (15-24),308423,165017,143406,47783,2167,1123,122171,47066,75105,42497
10,213,District - Madhepura (11),Rural,All Ages,1913301,1000760,912541,336576,12207,6269,1133220,514553,618667,235536
10,213,District - Madhepura (11),Rural,10-14,256658,137152,119506,45837,1708,900,60488,27685,32803,3567
10,213,District - Madhepura (11),Rural,15-19,149498,86607,62891,22002,1161,620,47925,21664,26261,13285
10,213,District - Madhepura (11),Rural,20-24,142847,69781,73066,24147,942,469,71261,24144,47117,28601
10,213,District - Madhepura (11),Rural,Adolescent (10-19),406156,223759,182397,67839,2869,1520,108413,49349,59064,16852
10,213,District - Madhepura (11),Rural,Youth (15-24),292345,156388,135957,46149,2103,1089,119186,45808,73378,41886
10,213,District - Madhepura (11),Urban,All Ages,88461,46799,41662,9699,325,173,33965,15340,18625,3346
10,213,District - Madhepura (11),Urban,10-14,11135,6027,5108,1288,35,23,1460,740,720,26
10,213,District - Madhepura (11),Urban,15-19,8612,4828,3784,870,38,23,1325,670,655,218
10,213,District - Madhepura (11),Urban,20-24,7466,3801,3665,764,26,11,1660,588,1072,393
10,213,District - Madhepura (11),Urban,Adolescent (10-19),19747,10855,8892,2158,73,46,2785,1410,1375,244
10,213,District - Madhepura (11),Urban,Youth (15-24),16078,8629,7449,1634,64,34,2985,1258,1727,611
10,214,District - Saharsa (12),Total,All Ages,1900661,997174,903487,317249,6009,3101,1095665,490800,604865,155772
10,214,District - Saharsa (12),Total,10-14,252545,136848,115697,43018,832,458,61173,27255,33918,2193
10,214,District - Saharsa (12),Total,15-19,150693,87255,63438,21462,529,296,47358,20834,26524,8631
10,214,District - Saharsa (12),Total,20-24,147119,72673,74446,23978,479,248,69420,23254,46166,19336
10,214,District - Saharsa (12),Total,Adolescent (10-19),403238,224103,179135,64480,1361,754,108531,48089,60442,10824
10,214,District - Saharsa (12),Total,Youth (15-24),297812,159928,137884,45440,1008,544,116778,44088,72690,27967
10,214,District - Saharsa (12),Rural,All Ages,1744121,913883,830238,304657,5593,2880,1038044,464789,573255,151803
10,214,District - Saharsa (12),Rural,10-14,233397,126609,106788,41326,770,424,58430,25936,32494,2153
10,214,District - Saharsa (12),Rural,15-19,135872,78999,56873,20287,476,270,45137,19788,25349,8434
10,214,District - Saharsa (12),Rural,20-24,133580,65690,67890,22856,434,219,66499,22236,44263,18877
10,214,District - Saharsa (12),Rural,Adolescent (10-19),369269,205608,163661,61613,1246,694,103567,45724,57843,10587
10,214,District - Saharsa (12),Rural,Youth (15-24),269452,144689,124763,43143,910,489,111636,42024,69612,27311
10,214,District - Saharsa (12),Urban,All Ages,156540,83291,73249,12592,416,221,57621,26011,31610,3969
10,214,District - Saharsa (12),Urban,10-14,19148,10239,8909,1692,62,34,2743,1319,1424,40
10,214,District - Saharsa (12),Urban,15-19,14821,8256,6565,1175,53,26,2221,1046,1175,197
10,214,District - Saharsa (12),Urban,20-24,13539,6983,6556,1122,45,29,2921,1018,1903,459
10,214,District - Saharsa (12),Urban,Adolescent (10-19),33969,18495,15474,2867,115,60,4964,2365,2599,237
10,214,District - Saharsa (12),Urban,Youth (15-24),28360,15239,13121,2297,98,55,5142,2064,3078,656
10,215,District - Darbhanga (13),Total,All Ages,3937385,2059949,1877436,615688,2772,1361,2120751,934383,1186368,301524
10,215,District - Darbhanga (13),Total,10-14,530531,280844,249687,86418,365,187,119228,52494,66734,4605
10,215,District - Darbhanga (13),Total,15-19,362906,206514,156392,53051,254,124,103540,47452,56088,18899
10,215,District - Darbhanga (13),Total,20-24,308335,164707,143628,46072,190,86,121597,45405,76192,35229
10,215,District - Darbhanga (13),Total,Adolescent (10-19),893437,487358,406079,139469,619,311,222768,99946,122822,23504
10,215,District - Darbhanga (13),Total,Youth (15-24),671241,371221,300020,99123,444,210,225137,92857,132280,54128
10,215,District - Darbhanga (13),Rural,All Ages,3554057,1858545,1695512,570735,2205,1088,1984164,874203,1109961,294902
10,215,District - Darbhanga (13),Rural,10-14,483784,256426,227358,80545,301,153,113377,49722,63655,4537
10,215,District - Darbhanga (13),Rural,15-19,322639,184776,137863,48367,191,99,97698,44581,53117,18560
10,215,District - Darbhanga (13),Rural,20-24,274181,145961,128220,42163,157,71,115068,42598,72470,34555
10,215,District - Darbhanga (13),Rural,Adolescent (10-19),806423,441202,365221,128912,492,252,211075,94303,116772,23097
10,215,District - Darbhanga (13),Rural,Youth (15-24),596820,330737,266083,90530,348,170,212766,87179,125587,53115
10,215,District - Darbhanga (13),Urban,All Ages,383328,201404,181924,44953,567,273,136587,60180,76407,6622
10,215,District - Darbhanga (13),Urban,10-14,46747,24418,22329,5873,64,34,5851,2772,3079,68
10,215,District - Darbhanga (13),Urban,15-19,40267,21738,18529,4684,63,25,5842,2871,2971,339
10,215,District - Darbhanga (13),Urban,20-24,34154,18746,15408,3909,33,15,6529,2807,3722,674
10,215,District - Darbhanga (13),Urban,Adolescent (10-19),87014,46156,40858,10557,127,59,11693,5643,6050,407
10,215,District - Darbhanga (13),Urban,Youth (15-24),74421,40484,33937,8593,96,40,12371,5678,6693,1013
10,216,District - Muzaffarpur (14),Total,All Ages,4801062,2527497,2273565,751975,5979,3124,2291830,1040380,1251450,366307
10,216,District - Muzaffarpur (14),Total,10-14,624324,329481,294843,101528,739,368,98020,47599,50421,4758
10,216,District - Muzaffarpur (14),Total,15-19,439487,253836,185651,63712,575,330,84191,44033,40158,21602
10,216,District - Muzaffarpur (14),Total,20-24,375457,202206,173251,56026,490,264,107878,42991,64887,39970
10,216,District - Muzaffarpur (14),Total,Adolescent (10-19),1063811,583317,480494,165240,1314,698,182211,91632,90579,26360
10,216,District - Muzaffarpur (14),Total,Youth (15-24),814944,456042,358902,119738,1065,594,192069,87024,105045,61572
10,216,District - Muzaffarpur (14),Rural,All Ages,4327625,2276812,2050813,708488,4759,2479,2147202,972806,1174396,359123
10,216,District - Muzaffarpur (14),Rural,10-14,570517,300923,269594,96041,598,302,91217,44036,47181,4669
10,216,District - Muzaffarpur (14),Rural,15-19,391080,227378,163702,59206,432,250,78316,40775,37541,21189
10,216,District - Muzaffarpur (14),Rural,20-24,332228,179015,153213,52102,385,202,101561,40078,61483,39282
10,216,District - Muzaffarpur (14),Rural,Adolescent (10-19),961597,528301,433296,155247,1030,552,169533,84811,84722,25858
10,216,District - Muzaffarpur (14),Rural,Youth (15-24),723308,406393,316915,111308,817,452,179877,80853,99024,60471
10,216,District - Muzaffarpur (14),Urban,All Ages,473437,250685,222752,43487,1220,645,144628,67574,77054,7184
10,216,District - Muzaffarpur (14),Urban,10-14,53807,28558,25249,5487,141,66,6803,3563,3240,89
10,216,District - Muzaffarpur (14),Urban,15-19,48407,26458,21949,4506,143,80,5875,3258,2617,413
10,216,District - Muzaffarpur (14),Urban,20-24,43229,23191,20038,3924,105,62,6317,2913,3404,688
10,216,District - Muzaffarpur (14),Urban,Adolescent (10-19),102214,55016,47198,9993,284,146,12678,6821,5857,502
10,216,District - Muzaffarpur (14),Urban,Youth (15-24),91636,49649,41987,8430,248,142,12192,6171,6021,1101
10,217,District - Gopalganj (15),Total,All Ages,2562012,1267666,1294346,320064,60807,29833,1179014,473761,705253,108576
10,217,District - Gopalganj (15),Total,10-14,360209,183266,176943,45500,8851,4465,38257,16249,22008,2102
10,217,District - Gopalganj (15),Total,15-19,259925,132373,127552,30856,6305,3243,39405,14781,24624,6948
10,217,District - Gopalganj (15),Total,20-24,184707,91622,93085,21956,4259,2041,46476,13911,32565,10938
10,217,District - Gopalganj (15),Total,Adolescent (10-19),620134,315639,304495,76356,15156,7708,77662,31030,46632,9050
10,217,District - Gopalganj (15),Total,Youth (15-24),444632,223995,220637,52812,10564,5284,85881,28692,57189,17886
10,217,District - Gopalganj (15),Rural,All Ages,2399207,1184967,1214240,304316,59447,29146,1119143,448688,670455,103663
10,217,District - Gopalganj (15),Rural,10-14,338427,172040,166387,43362,8661,4361,36279,15301,20978,2068
10,217,District - Gopalganj (15),Rural,15-19,242401,123209,119192,29204,6154,3162,37375,13861,23514,6645
10,217,District - Gopalganj (15),Rural,20-24,171401,84744,86657,20744,4145,1987,44185,13105,31080,10413
10,217,District - Gopalganj (15),Rural,Adolescent (10-19),580828,295249,285579,72566,14815,7523,73654,29162,44492,8713
10,217,District - Gopalganj (15),Rural,Youth (15-24),413802,207953,205849,49948,10299,5149,81560,26966,54594,17058
10,217,District - Gopalganj (15),Urban,All Ages,162805,82699,80106,15748,1360,687,59871,25073,34798,4913
10,217,District - Gopalganj (15),Urban,10-14,21782,11226,10556,2138,190,104,1978,948,1030,34
10,217,District - Gopalganj (15),Urban,15-19,17524,9164,8360,1652,151,81,2030,920,1110,303
10,217,District - Gopalganj (15),Urban,20-24,13306,6878,6428,1212,114,54,2291,806,1485,525
10,217,District - Gopalganj (15),Urban,Adolescent (10-19),39306,20390,18916,3790,341,185,4008,1868,2140,337
10,217,District - Gopalganj (15),Urban,Youth (15-24),30830,16042,14788,2864,265,135,4321,1726,2595,828
10,218,District - Siwan (16),Total,All Ages,3330464,1675090,1655374,386685,87000,43472,1400289,559184,841105,112244
10,218,District - Siwan (16),Total,10-14,465065,237207,227858,56183,12644,6289,38055,16617,21438,1560
10,218,District - Siwan (16),Total,15-19,350890,182602,168288,38761,9119,4744,43510,17100,26410,6964
10,218,District - Siwan (16),Total,20-24,250016,130831,119185,26957,6279,3267,50896,15854,35042,11591
10,218,District - Siwan (16),Total,Adolescent (10-19),815955,419809,396146,94944,21763,11033,81565,33717,47848,8524
10,218,District - Siwan (16),Total,Youth (15-24),600906,313433,287473,65718,15398,8011,94406,32954,61452,18555
10,218,District - Siwan (16),Rural,All Ages,3147551,1579685,1567866,375375,83773,41803,1340085,532769,807316,110058
10,218,District - Siwan (16),Rural,10-14,441317,224903,216414,54552,12170,6052,35253,15237,20016,1492
10,218,District - Siwan (16),Rural,15-19,329673,171409,158264,37443,8757,4540,41034,15836,25198,6780
10,218,District - Siwan (16),Rural,20-24,233145,121715,111430,26020,6021,3123,48447,14802,33645,11378
10,218,District - Siwan (16),Rural,Adolescent (10-19),770990,396312,374678,91995,20927,10592,76287,31073,45214,8272
10,218,District - Siwan (16),Rural,Youth (15-24),562818,293124,269694,63463,14778,7663,89481,30638,58843,18158
10,218,District - Siwan (16),Urban,All Ages,182913,95405,87508,11310,3227,1669,60204,26415,33789,2186
10,218,District - Siwan (16),Urban,10-14,23748,12304,11444,1631,474,237,2802,1380,1422,68
10,218,District - Siwan (16),Urban,15-19,21217,11193,10024,1318,362,204,2476,1264,1212,184
10,218,District - Siwan (16),Urban,20-24,16871,9116,7755,937,258,144,2449,1052,1397,213
10,218,District - Siwan (16),Urban,Adolescent (10-19),44965,23497,21468,2949,836,441,5278,2644,2634,252
10,218,District - Siwan (16),Urban,Youth (15-24),38088,20309,17779,2255,620,348,4925,2316,2609,397
10,219,District - Saran (17),Total,All Ages,3951862,2022821,1929041,474066,36786,18322,1794408,737054,1057354,172248
10,219,District - Saran (17),Total,10-14,544769,280696,264073,67267,5382,2752,76738,34177,42561,2553
10,219,District - Saran (17),Total,15-19,403131,218813,184318,45655,3802,2025,71358,30998,40360,10777
10,219,District - Saran (17),Total,20-24,293745,155523,138222,33301,2504,1259,78107,26657,51450,17604
10,219,District - Saran (17),Total,Adolescent (10-19),947900,499509,448391,112922,9184,4777,148096,65175,82921,13330
10,219,District - Saran (17),Total,Youth (15-24),696876,374336,322540,78956,6306,3284,149465,57655,91810,28381
10,219,District - Saran (17),Rural,All Ages,3598660,1838119,1760541,438183,35885,17846,1666071,681179,984892,163051
10,219,District - Saran (17),Rural,10-14,499975,257477,242498,62333,5255,2686,71208,31522,39686,2451
10,219,District - Saran (17),Rural,15-19,364478,197792,166686,41703,3678,1958,65858,28191,37667,10203
10,219,District - Saran (17),Rural,20-24,262944,138863,124081,30227,2429,1218,72309,24241,48068,16588
10,219,District - Saran (17),Rural,Adolescent (10-19),864453,455269,409184,104036,8933,4644,137066,59713,77353,12654
10,219,District - Saran (17),Rural,Youth (15-24),627422,336655,290767,71930,6107,3176,138167,52432,85735,26791
10,219,District - Saran (17),Urban,All Ages,353202,184702,168500,35883,901,476,128337,55875,72462,9197
10,219,District - Saran (17),Urban,10-14,44794,23219,21575,4934,127,66,5530,2655,2875,102
10,219,District - Saran (17),Urban,15-19,38653,21021,17632,3952,124,67,5500,2807,2693,574
10,219,District - Saran (17),Urban,20-24,30801,16660,14141,3074,75,41,5798,2416,3382,1016
10,219,District - Saran (17),Urban,Adolescent (10-19),83447,44240,39207,8886,251,133,11030,5462,5568,676
10,219,District - Saran (17),Urban,Youth (15-24),69454,37681,31773,7026,199,108,11298,5223,6075,1590
10,220,District - Vaishali (18),Total,All Ages,3495021,1844535,1650486,738031,2274,1232,1568281,691959,876322,285634
10,220,District - Vaishali (18),Total,10-14,455565,241265,214300,98743,309,178,52889,25761,27128,3410
10,220,District - Vaishali (18),Total,15-19,312449,182569,129880,59834,202,101,50605,26197,24408,16812
10,220,District - Vaishali (18),Total,20-24,281636,152136,129500,58076,162,100,74853,28512,46341,33576
10,220,District - Vaishali (18),Total,Adolescent (10-19),768014,423834,344180,158577,511,279,103494,51958,51536,20222
10,220,District - Vaishali (18),Total,Youth (15-24),594085,334705,259380,117910,364,201,125458,54709,70749,50388
10,220,District - Vaishali (18),Rural,All Ages,3261942,1721221,1540721,697630,2068,1113,1481955,652718,829237,277450
10,220,District - Vaishali (18),Rural,10-14,426292,225801,200491,93370,275,158,49489,24072,25417,3346
10,220,District - Vaishali (18),Rural,15-19,289273,169444,119829,56191,182,93,47427,24443,22984,16319
10,220,District - Vaishali (18),Rural,20-24,261345,141097,120248,54732,152,93,70786,26717,44069,32641
10,220,District - Vaishali (18),Rural,Adolescent (10-19),715565,395245,320320,149561,457,251,96916,48515,48401,19665
10,220,District - Vaishali (18),Rural,Youth (15-24),550618,310541,240077,110923,334,186,118213,51160,67053,48960
10,220,District - Vaishali (18),Urban,All Ages,233079,123314,109765,40401,206,119,86326,39241,47085,8184
10,220,District - Vaishali (18),Urban,10-14,29273,15464,13809,5373,34,20,3400,1689,1711,64
10,220,District - Vaishali (18),Urban,15-19,23176,13125,10051,3643,20,8,3178,1754,1424,493
10,220,District - Vaishali (18),Urban,20-24,20291,11039,9252,3344,10,7,4067,1795,2272,935
10,220,District - Vaishali (18),Urban,Adolescent (10-19),52449,28589,23860,9016,54,28,6578,3443,3135,557
10,220,District - Vaishali (18),Urban,Youth (15-24),43467,24164,19303,6987,30,15,7245,3549,3696,1428
10,221,District - Samastipur (19),Total,All Ages,4261566,2230003,2031563,803128,1884,975,2118686,936428,1182258,420585
10,221,District - Samastipur (19),Total,10-14,584896,308132,276764,113084,250,122,82074,38845,43229,4330
10,221,District - Samastipur (19),Total,15-19,371310,215162,156148,64385,196,107,79953,39223,40730,26093
10,221,District - Samastipur (19),Total,20-24,341312,177620,163692,62272,165,87,117256,42920,74336,52627
10,221,District - Samastipur (19),Total,Adolescent (10-19),956206,523294,432912,177469,446,229,162027,78068,83959,30423
10,221,District - Samastipur (19),Total,Youth (15-24),712622,392782,319840,126657,361,194,197209,82143,115066,78720
10,221,District - Samastipur (19),Rural,All Ages,4113769,2152273,1961496,779343,1316,696,2073187,916018,1157169,418108
10,221,District - Samastipur (19),Rural,10-14,566558,298508,268050,109820,170,86,80556,38054,42502,4313
10,221,District - Samastipur (19),Rural,15-19,356025,206860,149165,61889,119,67,78371,38382,39989,25910
10,221,District - Samastipur (19),Rural,20-24,327871,170388,157483,60195,114,61,115162,42023,73139,52339
10,221,District - Samastipur (19),Rural,Adolescent (10-19),922583,505368,417215,171709,289,153,158927,76436,82491,30223
10,221,District - Samastipur (19),Rural,Youth (15-24),683896,377248,306648,122084,233,128,193533,80405,113128,78249
10,221,District - Samastipur (19),Urban,All Ages,147797,77730,70067,23785,568,279,45499,20410,25089,2477
10,221,District - Samastipur (19),Urban,10-14,18338,9624,8714,3264,80,36,1518,791,727,17
10,221,District - Samastipur (19),Urban,15-19,15285,8302,6983,2496,77,40,1582,841,741,183
10,221,District - Samastipur (19),Urban,20-24,13441,7232,6209,2077,51,26,2094,897,1197,288
10,221,District - Samastipur (19),Urban,Adolescent (10-19),33623,17926,15697,5760,157,76,3100,1632,1468,200
10,221,District - Samastipur (19),Urban,Youth (15-24),28726,15534,13192,4573,128,66,3676,1738,1938,471
10,222,District - Begusarai (20),Total,All Ages,2970541,1567660,1402881,432270,1597,848,1421868,649153,772715,225638
10,222,District - Begusarai (20),Total,10-14,412088,217991,194097,61021,226,119,68770,33759,35011,2877
10,222,District - Begusarai (20),Total,15-19,265781,155379,110402,35455,173,103,57301,29687,27614,12539
10,222,District - Begusarai (20),Total,20-24,245902,129191,116711,34953,135,72,78959,31209,47750,26908
10,222,District - Begusarai (20),Total,Adolescent (10-19),677869,373370,304499,96476,399,222,126071,63446,62625,15416
10,222,District - Begusarai (20),Total,Youth (15-24),511683,284570,227113,70408,308,175,136260,60896,75364,39447
10,222,District - Begusarai (20),Rural,All Ages,2400718,1266308,1134410,371169,833,447,1194726,544428,650298,205878
10,222,District - Begusarai (20),Rural,10-14,336790,178338,158452,52720,113,60,57901,28213,29688,2653
10,222,District - Begusarai (20),Rural,15-19,209388,123350,86038,29544,71,45,47815,24556,23259,11466
10,222,District - Begusarai (20),Rural,20-24,195837,102528,93309,29451,73,39,67061,26161,40900,24592
10,222,District - Begusarai (20),Rural,Adolescent (10-19),546178,301688,244490,82264,184,105,105716,52769,52947,14119
10,222,District - Begusarai (20),Rural,Youth (15-24),405225,225878,179347,58995,144,84,114876,50717,64159,36058
10,222,District - Begusarai (20),Urban,All Ages,569823,301352,268471,61101,764,401,227142,104725,122417,19760
10,222,District - Begusarai (20),Urban,10-14,75298,39653,35645,8301,113,59,10869,5546,5323,224
10,222,District - Begusarai (20),Urban,15-19,56393,32029,24364,5911,102,58,9486,5131,4355,1073
10,222,District - Begusarai (20),Urban,20-24,50065,26663,23402,5502,62,33,11898,5048,6850,2316
10,222,District - Begusarai (20),Urban,Adolescent (10-19),131691,71682,60009,14212,215,117,20355,10677,9678,1297
10,222,District - Begusarai (20),Urban,Youth (15-24),106458,58692,47766,11413,164,91,21384,10179,11205,3389
10,223,District - Khagaria (21),Total,All Ages,1666886,883786,783100,247161,675,352,898858,422633,476225,145787
10,223,District - Khagaria (21),Total,10-14,230659,123627,107032,34424,83,42,49554,24107,25447,1964
10,223,District - Khagaria (21),Total,15-19,142900,84867,58033,18796,41,22,38712,19879,18833,8045
10,223,District - Khagaria (21),Total,20-24,130795,67910,62885,18990,52,22,51620,20544,31076,16904
10,223,District - Khagaria (21),Total,Adolescent (10-19),373559,208494,165065,53220,124,64,88266,43986,44280,10009
10,223,District - Khagaria (21),Total,Youth (15-24),273695,152777,120918,37786,93,44,90332,40423,49909,24949
10,223,District - Khagaria (21),Rural,All Ages,1579727,837281,742446,240583,579,304,867683,407981,459702,143812
10,223,District - Khagaria (21),Rural,10-14,219306,117751,101555,33473,66,36,48187,23421,24766,1937
10,223,District - Khagaria (21),Rural,15-19,134043,79940,54103,18119,29,14,37445,19223,18222,7934
10,223,District - Khagaria (21),Rural,20-24,122957,63696,59261,18444,45,19,50070,19842,30228,16688
10,223,District - Khagaria (21),Rural,Adolescent (10-19),353349,197691,155658,51592,95,50,85632,42644,42988,9871
10,223,District - Khagaria (21),Rural,Youth (15-24),257000,143636,113364,36563,74,33,87515,39065,48450,24622
10,223,District - Khagaria (21),Urban,All Ages,87159,46505,40654,6578,96,48,31175,14652,16523,1975
10,223,District - Khagaria (21),Urban,10-14,11353,5876,5477,951,17,6,1367,686,681,27
10,223,District - Khagaria (21),Urban,15-19,8857,4927,3930,677,12,8,1267,656,611,111
10,223,District - Khagaria (21),Urban,20-24,7838,4214,3624,546,7,3,1550,702,848,216
10,223,District - Khagaria (21),Urban,Adolescent (10-19),20210,10803,9407,1628,29,14,2634,1342,1292,138
10,223,District - Khagaria (21),Urban,Youth (15-24),16695,9141,7554,1223,19,11,2817,1358,1459,327
10,224,District - Bhagalpur (22),Total,All Ages,3037766,1615663,1422103,318569,67180,35545,1464700,677994,786706,186542
10,224,District - Bhagalpur (22),Total,10-14,399054,211531,187523,43654,9374,4977,75013,35626,39387,2399
10,224,District - Bhagalpur (22),Total,15-19,283976,165165,118811,28240,6592,3831,67771,34583,33188,10039
10,224,District - Bhagalpur (22),Total,20-24,246480,135459,111021,25160,4887,2752,80432,33613,46819,19773
10,224,District - Bhagalpur (22),Total,Adolescent (10-19),683030,376696,306334,71894,15966,8808,142784,70209,72575,12438
10,224,District - Bhagalpur (22),Total,Youth (15-24),530456,300624,229832,53400,11479,6583,148203,68196,80007,29812
10,224,District - Bhagalpur (22),Rural,All Ages,2435234,1295386,1139848,269088,65636,34788,1251528,578596,672932,175657
10,224,District - Bhagalpur (22),Rural,10-14,326422,173438,152984,37377,9194,4883,64224,30241,33983,2344
10,224,District - Bhagalpur (22),Rural,15-19,221045,131004,90041,23102,6349,3737,57850,29540,28310,9525
10,224,District - Bhagalpur (22),Rural,20-24,190394,104729,85665,20507,4737,2672,69467,28622,40845,18680
10,224,District - Bhagalpur (22),Rural,Adolescent (10-19),547467,304442,243025,60479,15543,8620,122074,59781,62293,11869
10,224,District - Bhagalpur (22),Rural,Youth (15-24),411439,235733,175706,43609,11086,6409,127317,58162,69155,28205
10,224,District - Bhagalpur (22),Urban,All Ages,602532,320277,282255,49481,1544,757,213172,99398,113774,10885
10,224,District - Bhagalpur (22),Urban,10-14,72632,38093,34539,6277,180,94,10789,5385,5404,55
10,224,District - Bhagalpur (22),Urban,15-19,62931,34161,28770,5138,243,94,9921,5043,4878,514
10,224,District - Bhagalpur (22),Urban,20-24,56086,30730,25356,4653,150,80,10965,4991,5974,1093
10,224,District - Bhagalpur (22),Urban,Adolescent (10-19),135563,72254,63309,11415,423,188,20710,10428,10282,569
10,224,District - Bhagalpur (22),Urban,Youth (15-24),119017,64891,54126,9791,393,174,20886,10034,10852,1607
10,225,District - Banka (23),Total,All Ages,2034763,1067140,967623,247858,90432,45901,1069442,476179,593263,183546
10,225,District - Banka (23),Total,10-14,260896,138720,122176,32435,11615,6133,48656,22520,26136,2725
10,225,District - Banka (23),Total,15-19,174756,101359,73397,19823,8012,4347,45504,20578,24926,10530
10,225,District - Banka (23),Total,20-24,157870,82760,75110,18774,7074,3414,60221,21669,38552,20622
10,225,District - Banka (23),Total,Adolescent (10-19),435652,240079,195573,52258,19627,10480,94160,43098,51062,13255
10,225,District - Banka (23),Total,Youth (15-24),332626,184119,148507,38597,15086,7761,105725,42247,63478,31152
10,225,District - Banka (23),Rural,All Ages,1963450,1029097,934353,240233,90210,45791,1041529,463165,578364,178964
10,225,District - Banka (23),Rural,10-14,252245,134148,118097,31480,11574,6119,47672,22050,25622,2703
10,225,District - Banka (23),Rural,15-19,167922,97536,70386,19130,7980,4332,44376,20005,24371,10265
10,225,District - Banka (23),Rural,20-24,151938,79508,72430,18169,7054,3405,58832,21067,37765,20120
10,225,District - Banka (23),Rural,Adolescent (10-19),420167,231684,188483,50610,19554,10451,92048,42055,49993,12968
10,225,District - Banka (23),Rural,Youth (15-24),319860,177044,142816,37299,15034,7737,103208,41072,62136,30385
10,225,District - Banka (23),Urban,All Ages,71313,38043,33270,7625,222,110,27913,13014,14899,4582
10,225,District - Banka (23),Urban,10-14,8651,4572,4079,955,41,14,984,470,514,22
10,225,District - Banka (23),Urban,15-19,6834,3823,3011,693,32,15,1128,573,555,265
10,225,District - Banka (23),Urban,20-24,5932,3252,2680,605,20,9,1389,602,787,502
10,225,District - Banka (23),Urban,Adolescent (10-19),15485,8395,7090,1648,73,29,2112,1043,1069,287
10,225,District - Banka (23),Urban,Youth (15-24),12766,7075,5691,1298,52,24,2517,1175,1342,767
10,226,District - Munger (24),Total,All Ages,1367765,729041,638724,183846,21404,10995,565948,255300,310648,76183
10,226,District - Munger (24),Total,10-14,174685,93543,81142,24789,3036,1574,23917,11779,12138,799
10,226,District - Munger (24),Total,15-19,131384,76179,55205,16604,1973,1094,21831,11095,10736,3610
10,226,District - Munger (24),Total,20-24,113935,62635,51300,14686,1609,778,27354,10945,16409,7576
10,226,District - Munger (24),Total,Adolescent (10-19),306069,169722,136347,41393,5009,2668,45748,22874,22874,4409
10,226,District - Munger (24),Total,Youth (15-24),245319,138814,106505,31290,3582,1872,49185,22040,27145,11186
10,226,District - Munger (24),Rural,All Ages,987645,527299,460346,148713,19548,10058,450624,203058,247566,70595
10,226,District - Munger (24),Rural,10-14,130302,70364,59938,20424,2785,1453,19357,9393,9964,777
10,226,District - Munger (24),Rural,15-19,90246,53604,36642,12686,1746,970,17552,8822,8730,3337
10,226,District - Munger (24),Rural,20-24,78185,43128,35057,11298,1422,695,22550,8799,13751,7044
10,226,District - Munger (24),Rural,Adolescent (10-19),220548,123968,96580,33110,4531,2423,36909,18215,18694,4114
10,226,District - Munger (24),Rural,Youth (15-24),168431,96732,71699,23984,3168,1665,40102,17621,22481,10381
10,226,District - Munger (24),Urban,All Ages,380120,201742,178378,35133,1856,937,115324,52242,63082,5588
10,226,District - Munger (24),Urban,10-14,44383,23179,21204,4365,251,121,4560,2386,2174,22
10,226,District - Munger (24),Urban,15-19,41138,22575,18563,3918,227,124,4279,2273,2006,273
10,226,District - Munger (24),Urban,20-24,35750,19507,16243,3388,187,83,4804,2146,2658,532
10,226,District - Munger (24),Urban,Adolescent (10-19),85521,45754,39767,8283,478,245,8839,4659,4180,295
10,226,District - Munger (24),Urban,Youth (15-24),76888,42082,34806,7306,414,207,9083,4419,4664,805
10,227,District - Lakhisarai (25),Total,All Ages,1000912,526345,474567,153209,8333,4247,493642,221163,272479,80407
10,227,District - Lakhisarai (25),Total,10-14,134594,71228,63366,20691,1155,602,21142,9788,11354,1426
10,227,District - Lakhisarai (25),Total,15-19,91127,51420,39707,12553,612,318,20922,9240,11682,5266
10,227,District - Lakhisarai (25),Total,20-24,78164,40838,37326,11651,681,310,26524,9829,16695,9299
10,227,District - Lakhisarai (25),Total,Adolescent (10-19),225721,122648,103073,33244,1767,920,42064,19028,23036,6692
10,227,District - Lakhisarai (25),Total,Youth (15-24),169291,92258,77033,24204,1293,628,47446,19069,28377,14565
10,227,District - Lakhisarai (25),Rural,All Ages,857901,450863,407038,138294,8125,4132,435279,194718,240561,74587
10,227,District - Lakhisarai (25),Rural,10-14,116133,61573,54560,18658,1113,579,18657,8554,10103,1234
10,227,District - Lakhisarai (25),Rural,15-19,76727,43542,33185,11135,601,310,18438,8028,10410,4841
10,227,District - Lakhisarai (25),Rural,20-24,65896,34355,31541,10483,671,304,23614,8639,14975,8614
10,227,District - Lakhisarai (25),Rural,Adolescent (10-19),192860,105115,87745,29793,1714,889,37095,16582,20513,6075
10,227,District - Lakhisarai (25),Rural,Youth (15-24),142623,77897,64726,21618,1272,614,42052,16667,25385,13455
10,227,District - Lakhisarai (25),Urban,All Ages,143011,75482,67529,14915,208,115,58363,26445,31918,5820
10,227,District - Lakhisarai (25),Urban,10-14,18461,9655,8806,2033,42,23,2485,1234,1251,192
10,227,District - Lakhisarai (25),Urban,15-19,14400,7878,6522,1418,11,8,2484,1212,1272,425
10,227,District - Lakhisarai (25),Urban,20-24,12268,6483,5785,1168,10,6,2910,1190,1720,685
10,227,District - Lakhisarai (25),Urban,Adolescent (10-19),32861,17533,15328,3451,53,31,4969,2446,2523,617
10,227,District - Lakhisarai (25),Urban,Youth (15-24),26668,14361,12307,2586,21,14,5394,2402,2992,1110
10,228,District - Sheikhpura (26),Total,All Ages,636342,329743,306599,131115,617,305,307666,133312,174354,65449
10,228,District - Sheikhpura (26),Total,10-14,86377,45600,40777,18300,89,45,13819,6092,7727,1354
10,228,District - Sheikhpura (26),Total,15-19,56663,30745,25918,10668,47,25,13154,5358,7796,4542
10,228,District - Sheikhpura (26),Total,20-24,48697,24819,23878,9699,38,26,16249,5510,10739,7814
10,228,District - Sheikhpura (26),Total,Adolescent (10-19),143040,76345,66695,28968,136,70,26973,11450,15523,5896
10,228,District - Sheikhpura (26),Total,Youth (15-24),105360,55564,49796,20367,85,51,29403,10868,18535,12356
10,228,District - Sheikhpura (26),Rural,All Ages,527340,272360,254980,113243,507,251,262845,113236,149609,61361
10,228,District - Sheikhpura (26),Rural,10-14,71632,37834,33798,15788,74,38,11867,5136,6731,1320
10,228,District - Sheikhpura (26),Rural,15-19,45831,24724,21107,9136,37,19,11296,4441,6855,4295
10,228,District - Sheikhpura (26),Rural,20-24,39785,20057,19728,8354,30,20,14080,4688,9392,7386
10,228,District - Sheikhpura (26),Rural,Adolescent (10-19),117463,62558,54905,24924,111,57,23163,9577,13586,5615
10,228,District - Sheikhpura (26),Rural,Youth (15-24),85616,44781,40835,17490,67,39,25376,9129,16247,11681
10,228,District - Sheikhpura (26),Urban,All Ages,109002,57383,51619,17872,110,54,44821,20076,24745,4088
10,228,District - Sheikhpura (26),Urban,10-14,14745,7766,6979,2512,15,7,1952,956,996,34
10,228,District - Sheikhpura (26),Urban,15-19,10832,6021,4811,1532,10,6,1858,917,941,247
10,228,District - Sheikhpura (26),Urban,20-24,8912,4762,4150,1345,8,6,2169,822,1347,428
10,228,District - Sheikhpura (26),Urban,Adolescent (10-19),25577,13787,11790,4044,25,13,3810,1873,1937,281
10,228,District - Sheikhpura (26),Urban,Youth (15-24),19744,10783,8961,2877,18,12,4027,1739,2288,675
10,229,District - Nalanda (27),Total,All Ages,2877653,1497060,1380593,607672,1442,728,1357720,577502,780218,342861
10,229,District - Nalanda (27),Total,10-14,375815,198200,177615,82570,183,91,61678,27667,34011,6355
10,229,District - Nalanda (27),Total,15-19,258764,140407,118357,48528,98,54,56078,22673,33405,20581
10,229,District - Nalanda (27),Total,20-24,224277,115678,108599,44649,98,47,72431,24221,48210,38063
10,229,District - Nalanda (27),Total,Adolescent (10-19),634579,338607,295972,131098,281,145,117756,50340,67416,26936
10,229,District - Nalanda (27),Total,Youth (15-24),483041,256085,226956,93177,196,101,128509,46894,81615,58644
10,229,District - Nalanda (27),Rural,All Ages,2419759,1257728,1162031,555144,1224,630,1187568,501205,686363,325188
10,229,District - Nalanda (27),Rural,10-14,316460,167348,149112,75376,150,75,53366,23467,29899,6093
10,229,District - Nalanda (27),Rural,15-19,210536,115024,95512,43602,76,44,48754,19155,29599,19613
10,229,District - Nalanda (27),Rural,20-24,184003,94429,89574,40541,78,40,64391,20861,43530,36310
10,229,District - Nalanda (27),Rural,Adolescent (10-19),526996,282372,244624,118978,226,119,102120,42622,59498,25706
10,229,District - Nalanda (27),Rural,Youth (15-24),394539,209453,185086,84143,154,84,113145,40016,73129,55923
10,229,District - Nalanda (27),Urban,All Ages,457894,239332,218562,52528,218,98,170152,76297,93855,17673
10,229,District - Nalanda (27),Urban,10-14,59355,30852,28503,7194,33,16,8312,4200,4112,262
10,229,District - Nalanda (27),Urban,15-19,48228,25383,22845,4926,22,10,7324,3518,3806,968
10,229,District - Nalanda (27),Urban,20-24,40274,21249,19025,4108,20,7,8040,3360,4680,1753
10,229,District - Nalanda (27),Urban,Adolescent (10-19),107583,56235,51348,12120,55,26,15636,7718,7918,1230
10,229,District - Nalanda (27),Urban,Youth (15-24),88502,46632,41870,9034,42,17,15364,6878,8486,2721
10,230,District - Patna (28),Total,All Ages,5838465,3078512,2759953,920918,9069,4717,2378786,1050465,1328321,399689
10,230,District - Patna (28),Total,10-14,723673,383717,339956,122891,997,517,114426,54877,59549,7602
10,230,District - Patna (28),Total,15-19,573514,315393,258121,82518,1056,616,105703,49645,56058,26097
10,230,District - Patna (28),Total,20-24,492670,260913,231757,73636,996,524,123053,47238,75815,45239
10,230,District - Patna (28),Total,Adolescent (10-19),1297187,699110,598077,205409,2053,1133,220129,104522,115607,33699
10,230,District - Patna (28),Total,Youth (15-24),1066184,576306,489878,156154,2052,1140,228756,96883,131873,71336
10,230,District - Patna (28),Rural,All Ages,3323875,1746025,1577850,664269,2156,1120,1633503,710552,922951,358989
10,230,District - Patna (28),Rural,10-14,434713,230844,203869,89450,271,127,81072,37816,43256,7099
10,230,District - Patna (28),Rural,15-19,304424,169173,135251,54643,204,116,73890,32927,40963,23445
10,230,District - Patna (28),Rural,20-24,258368,135309,123059,50224,165,93,89372,32462,56910,41012
10,230,District - Patna (28),Rural,Adolescent (10-19),739137,400017,339120,144093,475,243,154962,70743,84219,30544
10,230,District - Patna (28),Rural,Youth (15-24),562792,304482,258310,104867,369,209,163262,65389,97873,64457
10,230,District - Patna (28),Urban,All Ages,2514590,1332487,1182103,256649,6913,3597,745283,339913,405370,40700
10,230,District - Patna (28),Urban,10-14,288960,152873,136087,33441,726,390,33354,17061,16293,503
10,230,District - Patna (28),Urban,15-19,269090,146220,122870,27875,852,500,31813,16718,15095,2652
10,230,District - Patna (28),Urban,20-24,234302,125604,108698,23412,831,431,33681,14776,18905,4227
10,230,District - Patna (28),Urban,Adolescent (10-19),558050,299093,258957,61316,1578,890,65167,33779,31388,3155
10,230,District - Patna (28),Urban,Youth (15-24),503392,271824,231568,51287,1683,931,65494,31494,34000,6879
10,231,District - Bhojpur (29),Total,All Ages,2728407,1430380,1298027,425402,13977,7363,1129256,456894,672362,184314
10,231,District - Bhojpur (29),Total,10-14,357014,188855,168159,56734,1917,1047,46273,19511,26762,3165
10,231,District - Bhojpur (29),Total,15-19,268265,147836,120429,37849,1346,793,42621,16089,26532,10707
10,231,District - Bhojpur (29),Total,20-24,217957,117121,100836,32079,1063,570,51256,15750,35506,19804
10,231,District - Bhojpur (29),Total,Adolescent (10-19),625279,336691,288588,94583,3263,1840,88894,35600,53294,13872
10,231,District - Bhojpur (29),Total,Youth (15-24),486222,264957,221265,69928,2409,1363,93877,31839,62038,30511
10,231,District - Bhojpur (29),Rural,All Ages,2338546,1224274,1114272,387691,11759,6217,999483,399555,599928,175856
10,231,District - Bhojpur (29),Rural,10-14,308043,163245,144798,51542,1608,892,39837,16382,23455,3038
10,231,District - Bhojpur (29),Rural,15-19,225719,124696,101023,33795,1109,640,36824,13187,23637,10100
10,231,District - Bhojpur (29),Rural,20-24,182857,97975,84882,28944,861,462,45462,13289,32173,18890
10,231,District - Bhojpur (29),Rural,Adolescent (10-19),533762,287941,245821,85337,2717,1532,76661,29569,47092,13138
10,231,District - Bhojpur (29),Rural,Youth (15-24),408576,222671,185905,62739,1970,1102,82286,26476,55810,28990
10,231,District - Bhojpur (29),Urban,All Ages,389861,206106,183755,37711,2218,1146,129773,57339,72434,8458
10,231,District - Bhojpur (29),Urban,10-14,48971,25610,23361,5192,309,155,6436,3129,3307,127
10,231,District - Bhojpur (29),Urban,15-19,42546,23140,19406,4054,237,153,5797,2902,2895,607
10,231,District - Bhojpur (29),Urban,20-24,35100,19146,15954,3135,202,108,5794,2461,3333,914
10,231,District - Bhojpur (29),Urban,Adolescent (10-19),91517,48750,42767,9246,546,308,12233,6031,6202,734
10,231,District - Bhojpur (29),Urban,Youth (15-24),77646,42286,35360,7189,439,261,11591,5363,6228,1521
10,232,District - Buxar (30),Total,All Ages,1706352,887977,818375,251737,26824,14102,716545,294433,422112,114292
10,232,District - Buxar (30),Total,10-14,225520,119632,105888,34460,3770,2021,21992,9379,12613,1616
10,232,District - Buxar (30),Total,15-19,166539,91139,75400,21907,2645,1508,23370,8697,14673,6592
10,232,District - Buxar (30),Total,20-24,129313,67837,61476,17555,1980,1031,29559,8727,20832,11983
10,232,District - Buxar (30),Total,Adolescent (10-19),392059,210771,181288,56367,6415,3529,45362,18076,27286,8208
10,232,District - Buxar (30),Total,Youth (15-24),295852,158976,136876,39462,4625,2539,52929,17424,35505,18575
10,232,District - Buxar (30),Rural,All Ages,1541853,801086,740767,237430,23852,12514,663673,271003,392670,111199
10,232,District - Buxar (30),Rural,10-14,204617,108559,96058,32564,3357,1784,19876,8290,11586,1579
10,232,District - Buxar (30),Rural,15-19,147848,80892,66956,20302,2287,1312,21304,7633,13671,6402
10,232,District - Buxar (30),Rural,20-24,114944,60095,54849,16375,1759,904,27501,7838,19663,11680
10,232,District - Buxar (30),Rural,Adolescent (10-19),352465,189451,163014,52866,5644,3096,41180,15923,25257,7981
10,232,District - Buxar (30),Rural,Youth (15-24),262792,140987,121805,36677,4046,2216,48805,15471,33334,18082
10,232,District - Buxar (30),Urban,All Ages,164499,86891,77608,14307,2972,1588,52872,23430,29442,3093
10,232,District - Buxar (30),Urban,10-14,20903,11073,9830,1896,413,237,2116,1089,1027,37
10,232,District - Buxar (30),Urban,15-19,18691,10247,8444,1605,358,196,2066,1064,1002,190
10,232,District - Buxar (30),Urban,20-24,14369,7742,6627,1180,221,127,2058,889,1169,303
10,232,District - Buxar (30),Urban,Adolescent (10-19),39594,21320,18274,3501,771,433,4182,2153,2029,227
10,232,District - Buxar (30),Urban,Youth (15-24),33060,17989,15071,2785,579,323,4124,1953,2171,493
10,233,District - Kaimur (Bhabua) (31),Total,All Ages,1626384,847006,779378,369088,57981,29717,706108,297083,409025,116286
10,233,District - Kaimur (Bhabua) (31),Total,10-14,218916,115411,103505,50894,7850,4054,20567,8853,11714,1561
10,233,District - Kaimur (Bhabua) (31),Total,15-19,150967,82920,68047,31441,4815,2615,19084,6965,12119,5351
10,233,District - Kaimur (Bhabua) (31),Total,20-24,118335,61113,57222,25266,3986,1954,26755,7539,19216,11725
10,233,District - Kaimur (Bhabua) (31),Total,Adolescent (10-19),369883,198331,171552,82335,12665,6669,39651,15818,23833,6912
10,233,District - Kaimur (Bhabua) (31),Total,Youth (15-24),269302,144033,125269,56707,8801,4569,45839,14504,31335,17076
10,233,District - Kaimur (Bhabua) (31),Rural,All Ages,1560813,812298,748515,361112,56361,28874,686768,288573,398195,115055
10,233,District - Kaimur (Bhabua) (31),Rural,10-14,210171,110824,99347,49837,7639,3939,19962,8557,11405,1554
10,233,District - Kaimur (Bhabua) (31),Rural,15-19,143732,79036,64696,30642,4606,2516,18518,6672,11846,5288
10,233,District - Kaimur (Bhabua) (31),Rural,20-24,112708,58043,54665,24708,3858,1888,26126,7267,18859,11604
10,233,District - Kaimur (Bhabua) (31),Rural,Adolescent (10-19),353903,189860,164043,80479,12245,6455,38480,15229,23251,6842
10,233,District - Kaimur (Bhabua) (31),Rural,Youth (15-24),256440,137079,119361,55350,8464,4404,44644,13939,30705,16892
10,233,District - Kaimur (Bhabua) (31),Urban,All Ages,65571,34708,30863,7976,1620,843,19340,8510,10830,1231
10,233,District - Kaimur (Bhabua) (31),Urban,10-14,8745,4587,4158,1057,211,115,605,296,309,7
10,233,District - Kaimur (Bhabua) (31),Urban,15-19,7235,3884,3351,799,209,99,566,293,273,63
10,233,District - Kaimur (Bhabua) (31),Urban,20-24,5627,3070,2557,558,128,66,629,272,357,121
10,233,District - Kaimur (Bhabua) (31),Urban,Adolescent (10-19),15980,8471,7509,1856,420,214,1171,589,582,70
10,233,District - Kaimur (Bhabua) (31),Urban,Youth (15-24),12862,6954,5908,1357,337,165,1195,565,630,184
10,234,District - Rohtas (32),Total,All Ages,2959918,1543546,1416372,549546,31650,16399,1160086,481763,678323,172526
10,234,District - Rohtas (32),Total,10-14,395233,206459,188774,75225,4484,2371,32227,14767,17460,2067
10,234,District - Rohtas (32),Total,15-19,276877,151175,125702,45964,2795,1488,32224,13134,19090,8541
10,234,District - Rohtas (32),Total,20-24,233349,123179,110170,40703,2459,1245,45351,14449,30902,18160
10,234,District - Rohtas (32),Total,Adolescent (10-19),672110,357634,314476,121189,7279,3859,64451,27901,36550,10608
10,234,District - Rohtas (32),Total,Youth (15-24),510226,274354,235872,86667,5254,2733,77575,27583,49992,26701
10,234,District - Rohtas (32),Rural,All Ages,2532153,1318276,1213877,509105,28435,14732,1018106,419317,598789,163910
10,234,District - Rohtas (32),Rural,10-14,339989,177591,162398,69887,4042,2145,26265,11688,14577,1983
10,234,District - Rohtas (32),Rural,15-19,230263,126357,103906,41987,2436,1281,26428,10119,16309,8075
10,234,District - Rohtas (32),Rural,20-24,194726,101973,92753,37352,2153,1084,39292,11747,27545,17274
10,234,District - Rohtas (32),Rural,Adolescent (10-19),570252,303948,266304,111874,6478,3426,52693,21807,30886,10058
10,234,District - Rohtas (32),Rural,Youth (15-24),424989,228330,196659,79339,4589,2365,65720,21866,43854,25349
10,234,District - Rohtas (32),Urban,All Ages,427765,225270,202495,40441,3215,1667,141980,62446,79534,8616
10,234,District - Rohtas (32),Urban,10-14,55244,28868,26376,5338,442,226,5962,3079,2883,84
10,234,District - Rohtas (32),Urban,15-19,46614,24818,21796,3977,359,207,5796,3015,2781,466
10,234,District - Rohtas (32),Urban,20-24,38623,21206,17417,3351,306,161,6059,2702,3357,886
10,234,District - Rohtas (32),Urban,Adolescent (10-19),101858,53686,48172,9315,801,433,11758,6094,5664,550
10,234,District - Rohtas (32),Urban,Youth (15-24),85237,46024,39213,7328,665,368,11855,5717,6138,1352
10,235,District - Aurangabad (33),Total,All Ages,2540073,1318684,1221389,612064,1033,500,1074071,449951,624120,202346
10,235,District - Aurangabad (33),Total,10-14,342722,177723,164999,83960,147,67,33733,15052,18681,2831
10,235,District - Aurangabad (33),Total,15-19,236024,126222,109802,51043,78,33,32722,12520,20202,10291
10,235,District - Aurangabad (33),Total,20-24,195979,101220,94759,45552,56,25,45127,13660,31467,22120
10,235,District - Aurangabad (33),Total,Adolescent (10-19),578746,303945,274801,135003,225,100,66455,27572,38883,13122
10,235,District - Aurangabad (33),Total,Youth (15-24),432003,227442,204561,96595,134,58,77849,26180,51669,32411
10,235,District - Aurangabad (33),Rural,All Ages,2303219,1194619,1108600,583289,823,389,995181,415047,580134,197562
10,235,District - Aurangabad (33),Rural,10-14,311479,161335,150144,80082,118,56,30529,13463,17066,2789
10,235,District - Aurangabad (33),Rural,15-19,209941,112432,97509,48217,58,25,29759,11058,18701,10037
10,235,District - Aurangabad (33),Rural,20-24,175151,90183,84968,43247,43,19,42003,12353,29650,21642
10,235,District - Aurangabad (33),Rural,Adolescent (10-19),521420,273767,247653,128299,176,81,60288,24521,35767,12826
10,235,District - Aurangabad (33),Rural,Youth (15-24),385092,202615,182477,91464,101,44,71762,23411,48351,31679
10,235,District - Aurangabad (33),Urban,All Ages,236854,124065,112789,28775,210,111,78890,34904,43986,4784
10,235,District - Aurangabad (33),Urban,10-14,31243,16388,14855,3878,29,11,3204,1589,1615,42
10,235,District - Aurangabad (33),Urban,15-19,26083,13790,12293,2826,20,8,2963,1462,1501,254
10,235,District - Aurangabad (33),Urban,20-24,20828,11037,9791,2305,13,6,3124,1307,1817,478
10,235,District - Aurangabad (33),Urban,Adolescent (10-19),57326,30178,27148,6704,49,19,6167,3051,3116,296
10,235,District - Aurangabad (33),Urban,Youth (15-24),46911,24827,22084,5131,33,14,6087,2769,3318,732
10,236,District - Gaya (34),Total,All Ages,4391418,2266566,2124852,1334351,3098,1635,2093805,897763,1196042,411942
10,236,District - Gaya (34),Total,10-14,575742,300061,275681,178535,387,194,90735,40644,50091,8954
10,236,District - Gaya (34),Total,15-19,408426,213494,194932,110208,282,152,87767,33413,54354,26841
10,236,District - Gaya (34),Total,20-24,353243,181031,172212,104170,271,140,112670,37730,74940,49050
10,236,District - Gaya (34),Total,Adolescent (10-19),984168,513555,470613,288743,669,346,178502,74057,104445,35795
10,236,District - Gaya (34),Total,Youth (15-24),761669,394525,367144,214378,553,292,200437,71143,129294,75891
10,236,District - Gaya (34),Rural,All Ages,3809817,1960592,1849225,1264597,2434,1245,1913909,817175,1096734,402175
10,236,District - Gaya (34),Rural,10-14,508037,264686,243351,169794,323,157,83543,37087,46456,8824
10,236,District - Gaya (34),Rural,15-19,346398,180684,165714,103031,206,104,80436,29921,50515,26198
10,236,District - Gaya (34),Rural,20-24,299125,151819,147306,98244,195,89,104741,34403,70338,48011
10,236,District - Gaya (34),Rural,Adolescent (10-19),854435,445370,409065,272825,529,261,163979,67008,96971,35022
10,236,District - Gaya (34),Rural,Youth (15-24),645523,332503,313020,201275,401,193,185177,64324,120853,74209
10,236,District - Gaya (34),Urban,All Ages,581601,305974,275627,69754,664,390,179896,80588,99308,9767
10,236,District - Gaya (34),Urban,10-14,67705,35375,32330,8741,64,37,7192,3557,3635,130
10,236,District - Gaya (34),Urban,15-19,62028,32810,29218,7177,76,48,7331,3492,3839,643
10,236,District - Gaya (34),Urban,20-24,54118,29212,24906,5926,76,51,7929,3327,4602,1039
10,236,District - Gaya (34),Urban,Adolescent (10-19),129733,68185,61548,15918,140,85,14523,7049,7474,773
10,236,District - Gaya (34),Urban,Youth (15-24),116146,62022,54124,13103,152,99,15260,6819,8441,1682
10,237,District - Nawada (35),Total,All Ages,2219146,1144668,1074478,565112,2045,997,1128134,485194,642940,211681
10,237,District - Nawada (35),Total,10-14,301634,157375,144259,78163,289,130,61746,27529,34217,5032
10,237,District - Nawada (35),Total,15-19,211784,110110,101674,48195,177,90,55603,21546,34057,15124
10,237,District - Nawada (35),Total,20-24,178115,90908,87207,44595,168,69,64823,22482,42341,25717
10,237,District - Nawada (35),Total,Adolescent (10-19),513418,267485,245933,126358,466,220,117349,49075,68274,20156
10,237,District - Nawada (35),Total,Youth (15-24),389899,201018,188881,92790,345,159,120426,44028,76398,40841
10,237,District - Nawada (35),Rural,All Ages,2003567,1031656,971911,540032,1878,916,1049475,449576,599899,204141
10,237,District - Nawada (35),Rural,10-14,273147,142497,130650,74657,267,118,57844,25566,32278,4941
10,237,District - Nawada (35),Rural,15-19,188264,97810,90454,45883,160,81,52088,19901,32187,14661
10,237,District - Nawada (35),Rural,20-24,158753,80620,78133,42638,144,56,61143,20929,40214,24833
10,237,District - Nawada (35),Rural,Adolescent (10-19),461411,240307,221104,120540,427,199,109932,45467,64465,19602
10,237,District - Nawada (35),Rural,Youth (15-24),347017,178430,168587,88521,304,137,113231,40830,72401,39494
10,237,District - Nawada (35),Urban,All Ages,215579,113012,102567,25080,167,81,78659,35618,43041,7540
10,237,District - Nawada (35),Urban,10-14,28487,14878,13609,3506,22,12,3902,1963,1939,91
10,237,District - Nawada (35),Urban,15-19,23520,12300,11220,2312,17,9,3515,1645,1870,463
10,237,District - Nawada (35),Urban,20-24,19362,10288,9074,1957,24,13,3680,1553,2127,884
10,237,District - Nawada (35),Urban,Adolescent (10-19),52007,27178,24829,5818,39,21,7417,3608,3809,554
10,237,District - Nawada (35),Urban,Youth (15-24),42882,22588,20294,4269,41,22,7195,3198,3997,1347
10,238,District - Jamui (36),Total,All Ages,1760405,916064,844341,302649,78793,40185,901817,381679,520138,179628
10,238,District - Jamui (36),Total,10-14,226568,120157,106411,39132,10711,5549,33538,13985,19553,2792
10,238,District - Jamui (36),Total,15-19,158297,85975,72322,24793,7181,3808,38485,13305,25180,12069
10,238,District - Jamui (36),Total,20-24,143841,73967,69874,23780,5945,2913,53395,16627,36768,22486
10,238,District - Jamui (36),Total,Adolescent (10-19),384865,206132,178733,63925,17892,9357,72023,27290,44733,14861
10,238,District - Jamui (36),Total,Youth (15-24),302138,159942,142196,48573,13126,6721,91880,29932,61948,34555
10,238,District - Jamui (36),Rural,All Ages,1615072,839776,775296,283426,78201,39903,847761,358592,489169,173829
10,238,District - Jamui (36),Rural,10-14,208487,110656,97831,36721,10628,5511,31869,13204,18665,2742
10,238,District - Jamui (36),Rural,15-19,143328,78089,65239,22806,7117,3777,36422,12489,23933,11715
10,238,District - Jamui (36),Rural,20-24,130776,67008,63768,22064,5879,2884,50661,15682,34979,21745
10,238,District - Jamui (36),Rural,Adolescent (10-19),351815,188745,163070,59527,17745,9288,68291,25693,42598,14457
10,238,District - Jamui (36),Rural,Youth (15-24),274104,145097,129007,44870,12996,6661,87083,28171,58912,33460
10,238,District - Jamui (36),Urban,All Ages,145333,76288,69045,19223,592,282,54056,23087,30969,5799
10,238,District - Jamui (36),Urban,10-14,18081,9501,8580,2411,83,38,1669,781,888,50
10,238,District - Jamui (36),Urban,15-19,14969,7886,7083,1987,64,31,2063,816,1247,354
10,238,District - Jamui (36),Urban,20-24,13065,6959,6106,1716,66,29,2734,945,1789,741
10,238,District - Jamui (36),Urban,Adolescent (10-19),33050,17387,15663,4398,147,69,3732,1597,2135,404
10,238,District - Jamui (36),Urban,Youth (15-24),28034,14845,13189,3703,130,60,4797,1761,3036,1095
10,239,District - Jehanabad (37),Total,All Ages,1125313,585582,539731,222974,1285,667,506432,211170,295262,109146
10,239,District - Jehanabad (37),Total,10-14,149896,78660,71236,30426,159,80,18680,8136,10544,1379
10,239,District - Jehanabad (37),Total,15-19,100927,53471,47456,17143,108,54,18762,6496,12266,5458
10,239,District - Jehanabad (37),Total,20-24,87943,45094,42849,17031,85,39,25953,7949,18004,12023
10,239,District - Jehanabad (37),Total,Adolescent (10-19),250823,132131,118692,47569,267,134,37442,14632,22810,6837
10,239,District - Jehanabad (37),Total,Youth (15-24),188870,98565,90305,34174,193,93,44715,14445,30270,17481
10,239,District - Jehanabad (37),Rural,All Ages,990117,514154,475963,203509,1111,579,458676,190014,268662,104760
10,239,District - Jehanabad (37),Rural,10-14,132057,69209,62848,27730,144,73,16828,7221,9607,1340
10,239,District - Jehanabad (37),Rural,15-19,86287,45558,40729,15232,97,49,16809,5557,11252,5243
10,239,District - Jehanabad (37),Rural,20-24,76186,38843,37343,15419,66,30,23611,7038,16573,11569
10,239,District - Jehanabad (37),Rural,Adolescent (10-19),218344,114767,103577,42962,241,122,33637,12778,20859,6583
10,239,District - Jehanabad (37),Rural,Youth (15-24),162473,84401,78072,30651,163,79,40420,12595,27825,16812
10,239,District - Jehanabad (37),Urban,All Ages,135196,71428,63768,19465,174,88,47756,21156,26600,4386
10,239,District - Jehanabad (37),Urban,10-14,17839,9451,8388,2696,15,7,1852,915,937,39
10,239,District - Jehanabad (37),Urban,15-19,14640,7913,6727,1911,11,5,1953,939,1014,215
10,239,District - Jehanabad (37),Urban,20-24,11757,6251,5506,1612,19,9,2342,911,1431,454
10,239,District - Jehanabad (37),Urban,Adolescent (10-19),32479,17364,15115,4607,26,12,3805,1854,1951,254
10,239,District - Jehanabad (37),Urban,Youth (15-24),26397,14164,12233,3523,30,14,4295,1850,2445,669
10,240,District - Arwal (38),Total,All Ages,700843,363497,337346,141314,590,283,314492,128218,186274,88146
10,240,District - Arwal (38),Total,10-14,93731,49084,44647,18995,57,26,10660,4499,6161,1216
10,240,District - Arwal (38),Total,15-19,62584,33497,29087,11032,42,28,10628,3725,6903,4499
10,240,District - Arwal (38),Total,20-24,53198,27608,25590,10278,53,19,14316,4182,10134,9440
10,240,District - Arwal (38),Total,Adolescent (10-19),156315,82581,73734,30027,99,54,21288,8224,13064,5715
10,240,District - Arwal (38),Total,Youth (15-24),115782,61105,54677,21310,95,47,24944,7907,17037,13939
10,240,District - Arwal (38),Rural,All Ages,648994,336420,312574,131715,512,249,294759,120153,174606,84422
10,240,District - Arwal (38),Rural,10-14,86676,45400,41276,17664,51,22,10107,4244,5863,1196
10,240,District - Arwal (38),Rural,15-19,57404,30704,26700,10163,37,26,10043,3485,6558,4334
10,240,District - Arwal (38),Rural,20-24,48944,25320,23624,9559,47,16,13524,3939,9585,8990
10,240,District - Arwal (38),Rural,Adolescent (10-19),144080,76104,67976,27827,88,48,20150,7729,12421,5530
10,240,District - Arwal (38),Rural,Youth (15-24),106348,56024,50324,19722,84,42,23567,7424,16143,13324
10,240,District - Arwal (38),Urban,All Ages,51849,27077,24772,9599,78,34,19733,8065,11668,3724
10,240,District - Arwal (38),Urban,10-14,7055,3684,3371,1331,6,4,553,255,298,20
10,240,District - Arwal (38),Urban,15-19,5180,2793,2387,869,5,2,585,240,345,165
10,240,District - Arwal (38),Urban,20-24,4254,2288,1966,719,6,3,792,243,549,450
10,240,District - Arwal (38),Urban,Adolescent (10-19),12235,6477,5758,2200,11,6,1138,495,643,185
10,240,District - Arwal (38),Urban,Youth (15-24),9434,5081,4353,1588,11,5,1377,483,894,615
11,0,State - SIKKIM (11),Total,All Ages,610577,323070,287507,28275,206360,105261,165625,71801,93824,11582
11,0,State - SIKKIM (11),Total,10-14,66923,33965,32958,3224,23904,12046,3213,1600,1613,171
11,0,State - SIKKIM (11),Total,15-19,66937,33998,32939,3257,23353,11716,3296,1559,1737,844
11,0,State - SIKKIM (11),Total,20-24,67297,35146,32151,3208,21707,10758,4483,1910,2573,1520
11,0,State - SIKKIM (11),Total,Adolescent (10-19),133860,67963,65897,6481,47257,23762,6509,3159,3350,1015
11,0,State - SIKKIM (11),Total,Youth (15-24),134234,69144,65090,6465,45060,22474,7779,3469,4310,2364
11,0,State - SIKKIM (11),Rural,All Ages,456999,242797,214202,20335,167146,86059,135069,58552,76517,11154
11,0,State - SIKKIM (11),Rural,10-14,52191,26588,25603,2443,20047,10152,2483,1299,1184,165
11,0,State - SIKKIM (11),Rural,15-19,50759,25943,24816,2355,19241,9732,2407,1238,1169,829
11,0,State - SIKKIM (11),Rural,20-24,49839,26301,23538,2312,17528,8803,3542,1507,2035,1485
11,0,State - SIKKIM (11),Rural,Adolescent (10-19),102950,52531,50419,4798,39288,19884,4890,2537,2353,994
11,0,State - SIKKIM (11),Rural,Youth (15-24),100598,52244,48354,4667,36769,18535,5949,2745,3204,2314
11,0,State - SIKKIM (11),Urban,All Ages,153578,80273,73305,7940,39214,19202,30556,13249,17307,428
11,0,State - SIKKIM (11),Urban,10-14,14732,7377,7355,781,3857,1894,730,301,429,6
11,0,State - SIKKIM (11),Urban,15-19,16178,8055,8123,902,4112,1984,889,321,568,15
11,0,State - SIKKIM (11),Urban,20-24,17458,8845,8613,896,4179,1955,941,403,538,35
11,0,State - SIKKIM (11),Urban,Adolescent (10-19),30910,15432,15478,1683,7969,3878,1619,622,997,21
11,0,State - SIKKIM (11),Urban,Youth (15-24),33636,16900,16736,1798,8291,3939,1830,724,1106,50
11,241,District - North  District (01),Total,All Ages,43709,24730,18979,982,28715,14741,13259,6151,7108,1015
11,241,District - North  District (01),Total,10-14,4952,2455,2497,100,3665,1815,298,155,143,27
11,241,District - North  District (01),Total,15-19,4841,2581,2260,135,3404,1752,374,207,167,63
11,241,District - North  District (01),Total,20-24,4983,2918,2065,122,2871,1432,557,278,279,120
11,241,District - North  District (01),Total,Adolescent (10-19),9793,5036,4757,235,7069,3567,672,362,310,90
11,241,District - North  District (01),Total,Youth (15-24),9824,5499,4325,257,6275,3184,931,485,446,183
11,241,District - North  District (01),Rural,All Ages,39065,22274,16791,804,26695,13751,12017,5580,6437,957
11,241,District - North  District (01),Rural,10-14,4321,2134,2187,81,3346,1667,254,134,120,26
11,241,District - North  District (01),Rural,15-19,4234,2261,1973,114,3109,1605,332,188,144,60
11,241,District - North  District (01),Rural,20-24,4521,2676,1845,99,2717,1359,500,247,253,113
11,241,District - North  District (01),Rural,Adolescent (10-19),8555,4395,4160,195,6455,3272,586,322,264,86
11,241,District - North  District (01),Rural,Youth (15-24),8755,4937,3818,213,5826,2964,832,435,397,173
11,241,District - North  District (01),Urban,All Ages,4644,2456,2188,178,2020,990,1242,571,671,58
11,241,District - North  District (01),Urban,10-14,631,321,310,19,319,148,44,21,23,1
11,241,District - North  District (01),Urban,15-19,607,320,287,21,295,147,42,19,23,3
11,241,District - North  District (01),Urban,20-24,462,242,220,23,154,73,57,31,26,7
11,241,District - North  District (01),Urban,Adolescent (10-19),1238,641,597,40,614,295,86,40,46,4
11,241,District - North  District (01),Urban,Youth (15-24),1069,562,507,44,449,220,99,50,49,10
11,242,District - West District (02),Total,All Ages,136435,70238,66197,5935,57817,29485,43003,18250,24753,3984
11,242,District - West District (02),Total,10-14,16863,8570,8293,808,7312,3717,787,428,359,63
11,242,District - West District (02),Total,15-19,15536,7916,7620,689,6694,3328,702,351,351,341
11,242,District - West District (02),Total,20-24,14336,7169,7167,628,6103,3022,1141,411,730,605
11,242,District - West District (02),Total,Adolescent (10-19),32399,16486,15913,1497,14006,7045,1489,779,710,404
11,242,District - West District (02),Total,Youth (15-24),29872,15085,14787,1317,12797,6350,1843,762,1081,946
11,242,District - West District (02),Rural,All Ages,131187,67528,63659,5663,56394,28773,41962,17817,24145,3960
11,242,District - West District (02),Rural,10-14,16305,8299,8006,774,7182,3659,773,421,352,62
11,242,District - West District (02),Rural,15-19,14918,7608,7310,649,6534,3257,681,346,335,340
11,242,District - West District (02),Rural,20-24,13746,6872,6874,599,5926,2934,1120,401,719,603
11,242,District - West District (02),Rural,Adolescent (10-19),31223,15907,15316,1423,13716,6916,1454,767,687,402
11,242,District - West District (02),Rural,Youth (15-24),28664,14480,14184,1248,12460,6191,1801,747,1054,943
11,242,District - West District (02),Urban,All Ages,5248,2710,2538,272,1423,712,1041,433,608,24
11,242,District - West District (02),Urban,10-14,558,271,287,34,130,58,14,7,7,1
11,242,District - West District (02),Urban,15-19,618,308,310,40,160,71,21,5,16,1
11,242,District - West District (02),Urban,20-24,590,297,293,29,177,88,21,10,11,2
11,242,District - West District (02),Urban,Adolescent (10-19),1176,579,597,74,290,129,35,12,23,2
11,242,District - West District (02),Urban,Youth (15-24),1208,605,603,69,337,159,42,15,27,3
11,243,District - South District (03),Total,All Ages,146850,76670,70180,6053,41392,21556,40109,17313,22796,1456
11,243,District - South District (03),Total,10-14,16837,8557,8280,715,4835,2435,659,321,338,29
11,243,District - South District (03),Total,15-19,16412,8310,8102,723,4527,2282,596,282,314,117
11,243,District - South District (03),Total,20-24,15829,8291,7538,659,4247,2194,930,403,527,187
11,243,District - South District (03),Total,Adolescent (10-19),33249,16867,16382,1438,9362,4717,1255,603,652,146
11,243,District - South District (03),Total,Youth (15-24),32241,16601,15640,1382,8774,4476,1526,685,841,304
11,243,District - South District (03),Rural,All Ages,125651,65848,59803,5042,36909,19365,35885,15509,20376,1415
11,243,District - South District (03),Rural,10-14,14607,7409,7198,609,4348,2183,542,277,265,29
11,243,District - South District (03),Rural,15-19,14087,7124,6963,597,4053,2038,482,232,250,115
11,243,District - South District (03),Rural,20-24,13481,7135,6346,572,3775,1987,789,345,444,186
11,243,District - South District (03),Rural,Adolescent (10-19),28694,14533,14161,1206,8401,4221,1024,509,515,144
11,243,District - South District (03),Rural,Youth (15-24),27568,14259,13309,1169,7828,4025,1271,577,694,301
11,243,District - South District (03),Urban,All Ages,21199,10822,10377,1011,4483,2191,4224,1804,2420,41
11,243,District - South District (03),Urban,10-14,2230,1148,1082,106,487,252,117,44,73,0
11,243,District - South District (03),Urban,15-19,2325,1186,1139,126,474,244,114,50,64,2
11,243,District - South District (03),Urban,20-24,2348,1156,1192,87,472,207,141,58,83,1
11,243,District - South District (03),Urban,Adolescent (10-19),4555,2334,2221,232,961,496,231,94,137,2
11,243,District - South District (03),Urban,Youth (15-24),4673,2342,2331,213,946,451,255,108,147,3
11,244,District - East District (04),Total,All Ages,283583,151432,132151,15305,78436,39479,69254,30087,39167,5127
11,244,District - East District (04),Total,10-14,28271,14383,13888,1601,8092,4079,1469,696,773,52
11,244,District - East District (04),Total,15-19,30148,15191,14957,1710,8728,4354,1624,719,905,323
11,244,District - East District (04),Total,20-24,32149,16768,15381,1799,8486,4110,1855,818,1037,608
11,244,District - East District (04),Total,Adolescent (10-19),58419,29574,28845,3311,16820,8433,3093,1415,1678,375
11,244,District - East District (04),Total,Youth (15-24),62297,31959,30338,3509,17214,8464,3479,1537,1942,931
11,244,District - East District (04),Rural,All Ages,161096,87147,73949,8826,47148,24170,45205,19646,25559,4822
11,244,District - East District (04),Rural,10-14,16958,8746,8212,979,5171,2643,914,467,447,48
11,244,District - East District (04),Rural,15-19,17520,8950,8570,995,5545,2832,912,472,440,314
11,244,District - East District (04),Rural,20-24,18091,9618,8473,1042,5110,2523,1133,514,619,583
11,244,District - East District (04),Rural,Adolescent (10-19),34478,17696,16782,1974,10716,5475,1826,939,887,362
11,244,District - East District (04),Rural,Youth (15-24),35611,18568,17043,2037,10655,5355,2045,986,1059,897
11,244,District - East District (04),Urban,All Ages,122487,64285,58202,6479,31288,15309,24049,10441,13608,305
11,244,District - East District (04),Urban,10-14,11313,5637,5676,622,2921,1436,555,229,326,4
11,244,District - East District (04),Urban,15-19,12628,6241,6387,715,3183,1522,712,247,465,9
11,244,District - East District (04),Urban,20-24,14058,7150,6908,757,3376,1587,722,304,418,25
11,244,District - East District (04),Urban,Adolescent (10-19),23941,11878,12063,1337,6104,2958,1267,476,791,13
11,244,District - East District (04),Urban,Youth (15-24),26686,13391,13295,1472,6559,3109,1434,551,883,34
12,0,State - ARUNACHAL PRADESH (12),Total,All Ages,1383727,713912,669815,0,951821,468390,617722,274044,343678,20259
12,0,State - ARUNACHAL PRADESH (12),Total,10-14,179359,90439,88920,0,132453,66071,31855,14402,17453,378
12,0,State - ARUNACHAL PRADESH (12),Total,15-19,155968,78673,77295,0,113716,55953,24976,10342,14634,1417
12,0,State - ARUNACHAL PRADESH (12),Total,20-24,131696,66033,65663,0,86742,40305,30580,11537,19043,2462
12,0,State - ARUNACHAL PRADESH (12),Total,Adolescent (10-19),335327,169112,166215,0,246169,122024,56831,24744,32087,1795
12,0,State - ARUNACHAL PRADESH (12),Total,Youth (15-24),287664,144706,142958,0,200458,96258,55556,21879,33677,3879
12,0,State - ARUNACHAL PRADESH (12),Rural,All Ages,1066358,546011,520347,0,789846,390625,530456,236621,293835,18776
12,0,State - ARUNACHAL PRADESH (12),Rural,10-14,140026,70980,69046,0,109012,54853,28101,12911,15190,355
12,0,State - ARUNACHAL PRADESH (12),Rural,15-19,116064,58961,57103,0,89817,44749,21609,9196,12413,1330
12,0,State - ARUNACHAL PRADESH (12),Rural,20-24,97891,49023,48868,0,69729,32808,26770,10239,16531,2331
12,0,State - ARUNACHAL PRADESH (12),Rural,Adolescent (10-19),256090,129941,126149,0,198829,99602,49710,22107,27603,1685
12,0,State - ARUNACHAL PRADESH (12),Rural,Youth (15-24),213955,107984,105971,0,159546,77557,48379,19435,28944,3661
12,0,State - ARUNACHAL PRADESH (12),Urban,All Ages,317369,167901,149468,0,161975,77765,87266,37423,49843,1483
12,0,State - ARUNACHAL PRADESH (12),Urban,10-14,39333,19459,19874,0,23441,11218,3754,1491,2263,23
12,0,State - ARUNACHAL PRADESH (12),Urban,15-19,39904,19712,20192,0,23899,11204,3367,1146,2221,87
12,0,State - ARUNACHAL PRADESH (12),Urban,20-24,33805,17010,16795,0,17013,7497,3810,1298,2512,131
12,0,State - ARUNACHAL PRADESH (12),Urban,Adolescent (10-19),79237,39171,40066,0,47340,22422,7121,2637,4484,110
12,0,State - ARUNACHAL PRADESH (12),Urban,Youth (15-24),73709,36722,36987,0,40912,18701,7177,2444,4733,218
12,245,District - Tawang (01),Total,All Ages,49977,29151,20826,0,34811,16770,23904,11431,12473,594
12,245,District - Tawang (01),Total,10-14,5045,2390,2655,0,4354,2037,884,387,497,4
12,245,District - Tawang (01),Total,15-19,4870,2525,2345,0,3766,1742,1274,654,620,26
12,245,District - Tawang (01),Total,20-24,5865,3769,2096,0,3365,1589,2180,1137,1043,83
12,245,District - Tawang (01),Total,Adolescent (10-19),9915,4915,5000,0,8120,3779,2158,1041,1117,30
12,245,District - Tawang (01),Total,Youth (15-24),10735,6294,4441,0,7131,3331,3454,1791,1663,109
12,245,District - Tawang (01),Rural,All Ages,38775,20792,17983,0,31105,15024,22256,10757,11499,573
12,245,District - Tawang (01),Rural,10-14,4427,2120,2307,0,3937,1869,845,369,476,4
12,245,District - Tawang (01),Rural,15-19,4225,2236,1989,0,3367,1594,1231,641,590,24
12,245,District - Tawang (01),Rural,20-24,4455,2660,1795,0,3027,1446,2079,1102,977,77
12,245,District - Tawang (01),Rural,Adolescent (10-19),8652,4356,4296,0,7304,3463,2076,1010,1066,28
12,245,District - Tawang (01),Rural,Youth (15-24),8680,4896,3784,0,6394,3040,3310,1743,1567,101
12,245,District - Tawang (01),Urban,All Ages,11202,8359,2843,0,3706,1746,1648,674,974,21
12,245,District - Tawang (01),Urban,10-14,618,270,348,0,417,168,39,18,21,0
12,245,District - Tawang (01),Urban,15-19,645,289,356,0,399,148,43,13,30,2
12,245,District - Tawang (01),Urban,20-24,1410,1109,301,0,338,143,101,35,66,6
12,245,District - Tawang (01),Urban,Adolescent (10-19),1263,559,704,0,816,316,82,31,51,2
12,245,District - Tawang (01),Urban,Youth (15-24),2055,1398,657,0,737,291,144,48,96,8
12,246,District - West Kameng (02),Total,All Ages,83947,46155,37792,0,46380,22771,35455,16589,18866,817
12,246,District - West Kameng (02),Total,10-14,9297,4631,4666,0,5940,2896,1542,728,814,15
12,246,District - West Kameng (02),Total,15-19,8329,4157,4172,0,5033,2386,1483,669,814,65
12,246,District - West Kameng (02),Total,20-24,9049,4905,4144,0,4631,2084,2122,945,1177,94
12,246,District - West Kameng (02),Total,Adolescent (10-19),17626,8788,8838,0,10973,5282,3025,1397,1628,80
12,246,District - West Kameng (02),Total,Youth (15-24),17378,9062,8316,0,9664,4470,3605,1614,1991,159
12,246,District - West Kameng (02),Rural,All Ages,68015,37809,30206,0,38846,19104,30552,14456,16096,672
12,246,District - West Kameng (02),Rural,10-14,7432,3650,3782,0,4995,2385,1298,616,682,12
12,246,District - West Kameng (02),Rural,15-19,6349,3164,3185,0,4049,1919,1254,582,672,49
12,246,District - West Kameng (02),Rural,20-24,7283,4051,3232,0,3779,1714,1914,861,1053,76
12,246,District - West Kameng (02),Rural,Adolescent (10-19),13781,6814,6967,0,9044,4304,2552,1198,1354,61
12,246,District - West Kameng (02),Rural,Youth (15-24),13632,7215,6417,0,7828,3633,3168,1443,1725,125
12,246,District - West Kameng (02),Urban,All Ages,15932,8346,7586,0,7534,3667,4903,2133,2770,145
12,246,District - West Kameng (02),Urban,10-14,1865,981,884,0,945,511,244,112,132,3
12,246,District - West Kameng (02),Urban,15-19,1980,993,987,0,984,467,229,87,142,16
12,246,District - West Kameng (02),Urban,20-24,1766,854,912,0,852,370,208,84,124,18
12,246,District - West Kameng (02),Urban,Adolescent (10-19),3845,1974,1871,0,1929,978,473,199,274,19
12,246,District - West Kameng (02),Urban,Youth (15-24),3746,1847,1899,0,1836,837,437,171,266,34
12,247,District - East Kameng (03),Total,All Ages,78690,38775,39915,0,72400,35266,40241,17176,23065,443
12,247,District - East Kameng (03),Total,10-14,11623,5747,5876,0,10806,5311,1551,704,847,10
12,247,District - East Kameng (03),Total,15-19,8537,4302,4235,0,7892,3984,1169,460,709,33
12,247,District - East Kameng (03),Total,20-24,5897,2756,3141,0,5298,2462,1607,505,1102,48
12,247,District - East Kameng (03),Total,Adolescent (10-19),20160,10049,10111,0,18698,9295,2720,1164,1556,43
12,247,District - East Kameng (03),Total,Youth (15-24),14434,7058,7376,0,13190,6446,2776,965,1811,81
12,247,District - East Kameng (03),Rural,All Ages,60340,29506,30834,0,57797,28146,33426,14403,19023,368
12,247,District - East Kameng (03),Rural,10-14,8767,4323,4444,0,8454,4165,1340,634,706,9
12,247,District - East Kameng (03),Rural,15-19,6344,3247,3097,0,6093,3121,1006,416,590,26
12,247,District - East Kameng (03),Rural,20-24,4343,2040,2303,0,4120,1944,1371,444,927,39
12,247,District - East Kameng (03),Rural,Adolescent (10-19),15111,7570,7541,0,14547,7286,2346,1050,1296,35
12,247,District - East Kameng (03),Rural,Youth (15-24),10687,5287,5400,0,10213,5065,2377,860,1517,65
12,247,District - East Kameng (03),Urban,All Ages,18350,9269,9081,0,14603,7120,6815,2773,4042,75
12,247,District - East Kameng (03),Urban,10-14,2856,1424,1432,0,2352,1146,211,70,141,1
12,247,District - East Kameng (03),Urban,15-19,2193,1055,1138,0,1799,863,163,44,119,7
12,247,District - East Kameng (03),Urban,20-24,1554,716,838,0,1178,518,236,61,175,9
12,247,District - East Kameng (03),Urban,Adolescent (10-19),5049,2479,2570,0,4151,2009,374,114,260,8
12,247,District - East Kameng (03),Urban,Youth (15-24),3747,1771,1976,0,2977,1381,399,105,294,16
12,248,District - Papum Pare (04),Total,All Ages,176573,89182,87391,0,117216,56469,55525,23388,32137,921
12,248,District - Papum Pare (04),Total,10-14,22949,11189,11760,0,16946,8137,2468,1002,1466,22
12,248,District - Papum Pare (04),Total,15-19,22569,10967,11602,0,16258,7738,2096,688,1408,53
12,248,District - Papum Pare (04),Total,20-24,20182,9843,10339,0,13081,5859,2320,732,1588,75
12,248,District - Papum Pare (04),Total,Adolescent (10-19),45518,22156,23362,0,33204,15875,4564,1690,2874,75
12,248,District - Papum Pare (04),Total,Youth (15-24),42751,20810,21941,0,29339,13597,4416,1420,2996,128
12,248,District - Papum Pare (04),Rural,All Ages,79610,39935,39675,0,61451,29711,30009,12662,17347,727
12,248,District - Papum Pare (04),Rural,10-14,11301,5578,5723,0,9394,4608,1258,567,691,17
12,248,District - Papum Pare (04),Rural,15-19,9945,4811,5134,0,8107,3887,986,365,621,41
12,248,District - Papum Pare (04),Rural,20-24,8572,4338,4234,0,6191,2810,1188,397,791,64
12,248,District - Papum Pare (04),Rural,Adolescent (10-19),21246,10389,10857,0,17501,8495,2244,932,1312,58
12,248,District - Papum Pare (04),Rural,Youth (15-24),18517,9149,9368,0,14298,6697,2174,762,1412,105
12,248,District - Papum Pare (04),Urban,All Ages,96963,49247,47716,0,55765,26758,25516,10726,14790,194
12,248,District - Papum Pare (04),Urban,10-14,11648,5611,6037,0,7552,3529,1210,435,775,5
12,248,District - Papum Pare (04),Urban,15-19,12624,6156,6468,0,8151,3851,1110,323,787,12
12,248,District - Papum Pare (04),Urban,20-24,11610,5505,6105,0,6890,3049,1132,335,797,11
12,248,District - Papum Pare (04),Urban,Adolescent (10-19),24272,11767,12505,0,15703,7380,2320,758,1562,17
12,248,District - Papum Pare (04),Urban,Youth (15-24),24234,11661,12573,0,15041,6900,2242,658,1584,23
12,249,District - Upper Subansiri (05),Total,All Ages,83448,41758,41690,0,78323,38570,38170,16951,21219,619
12,249,District - Upper Subansiri (05),Total,10-14,11891,6067,5824,0,11374,5789,2073,982,1091,12
12,249,District - Upper Subansiri (05),Total,15-19,10669,5199,5470,0,10162,4916,1515,663,852,31
12,249,District - Upper Subansiri (05),Total,20-24,7919,3808,4111,0,7419,3491,1649,633,1016,69
12,249,District - Upper Subansiri (05),Total,Adolescent (10-19),22560,11266,11294,0,21536,10705,3588,1645,1943,43
12,249,District - Upper Subansiri (05),Total,Youth (15-24),18588,9007,9581,0,17581,8407,3164,1296,1868,100
12,249,District - Upper Subansiri (05),Rural,All Ages,70043,34840,35203,0,67960,33550,33984,15225,18759,588
12,249,District - Upper Subansiri (05),Rural,10-14,9942,5097,4845,0,9744,4992,1937,927,1010,12
12,249,District - Upper Subansiri (05),Rural,15-19,8693,4217,4476,0,8492,4112,1402,626,776,29
12,249,District - Upper Subansiri (05),Rural,20-24,6609,3168,3441,0,6403,3033,1496,593,903,65
12,249,District - Upper Subansiri (05),Rural,Adolescent (10-19),18635,9314,9321,0,18236,9104,3339,1553,1786,41
12,249,District - Upper Subansiri (05),Rural,Youth (15-24),15302,7385,7917,0,14895,7145,2898,1219,1679,94
12,249,District - Upper Subansiri (05),Urban,All Ages,13405,6918,6487,0,10363,5020,4186,1726,2460,31
12,249,District - Upper Subansiri (05),Urban,10-14,1949,970,979,0,1630,797,136,55,81,0
12,249,District - Upper Subansiri (05),Urban,15-19,1976,982,994,0,1670,804,113,37,76,2
12,249,District - Upper Subansiri (05),Urban,20-24,1310,640,670,0,1016,458,153,40,113,4
12,249,District - Upper Subansiri (05),Urban,Adolescent (10-19),3925,1952,1973,0,3300,1601,249,92,157,2
12,249,District - Upper Subansiri (05),Urban,Youth (15-24),3286,1622,1664,0,2686,1262,266,77,189,6
12,250,District - West Siang (06),Total,All Ages,112274,58168,54106,0,92783,45746,47528,21391,26137,617
12,250,District - West Siang (06),Total,10-14,15038,7490,7548,0,13159,6495,2631,1211,1420,9
12,250,District - West Siang (06),Total,15-19,13006,6478,6528,0,11204,5473,1568,699,869,43
12,250,District - West Siang (06),Total,20-24,10048,5135,4913,0,7838,3637,1821,725,1096,63
12,250,District - West Siang (06),Total,Adolescent (10-19),28044,13968,14076,0,24363,11968,4199,1910,2289,52
12,250,District - West Siang (06),Total,Youth (15-24),23054,11613,11441,0,19042,9110,3389,1424,1965,106
12,250,District - West Siang (06),Rural,All Ages,87306,44687,42619,0,78260,38874,41432,18754,22678,525
12,250,District - West Siang (06),Rural,10-14,11973,6001,5972,0,11121,5551,2359,1103,1256,5
12,250,District - West Siang (06),Rural,15-19,9550,4780,4770,0,8720,4297,1317,617,700,36
12,250,District - West Siang (06),Rural,20-24,7523,3795,3728,0,6414,3016,1580,653,927,54
12,250,District - West Siang (06),Rural,Adolescent (10-19),21523,10781,10742,0,19841,9848,3676,1720,1956,41
12,250,District - West Siang (06),Rural,Youth (15-24),17073,8575,8498,0,15134,7313,2897,1270,1627,90
12,250,District - West Siang (06),Urban,All Ages,24968,13481,11487,0,14523,6872,6096,2637,3459,92
12,250,District - West Siang (06),Urban,10-14,3065,1489,1576,0,2038,944,272,108,164,4
12,250,District - West Siang (06),Urban,15-19,3456,1698,1758,0,2484,1176,251,82,169,7
12,250,District - West Siang (06),Urban,20-24,2525,1340,1185,0,1424,621,241,72,169,9
12,250,District - West Siang (06),Urban,Adolescent (10-19),6521,3187,3334,0,4522,2120,523,190,333,11
12,250,District - West Siang (06),Urban,Youth (15-24),5981,3038,2943,0,3908,1797,492,154,338,16
12,251,District - East Siang (07),Total,All Ages,99214,50116,49098,0,69979,34533,36638,15906,20732,2600
12,251,District - East Siang (07),Total,10-14,12885,6475,6410,0,9333,4667,1830,876,954,39
12,251,District - East Siang (07),Total,15-19,11594,5793,5801,0,8357,4122,1255,511,744,181
12,251,District - East Siang (07),Total,20-24,9583,4605,4978,0,6857,3232,1485,577,908,338
12,251,District - East Siang (07),Total,Adolescent (10-19),24479,12268,12211,0,17690,8789,3085,1387,1698,220
12,251,District - East Siang (07),Total,Youth (15-24),21177,10398,10779,0,15214,7354,2740,1088,1652,519
12,251,District - East Siang (07),Rural,All Ages,71579,36147,35432,0,57744,28785,28515,12453,16062,2447
12,251,District - East Siang (07),Rural,10-14,9234,4697,4537,0,7520,3809,1480,727,753,36
12,251,District - East Siang (07),Rural,15-19,7997,4065,3932,0,6458,3259,939,406,533,174
12,251,District - East Siang (07),Rural,20-24,6776,3290,3486,0,5555,2663,1117,445,672,327
12,251,District - East Siang (07),Rural,Adolescent (10-19),17231,8762,8469,0,13978,7068,2419,1133,1286,210
12,251,District - East Siang (07),Rural,Youth (15-24),14773,7355,7418,0,12013,5922,2056,851,1205,501
12,251,District - East Siang (07),Urban,All Ages,27635,13969,13666,0,12235,5748,8123,3453,4670,153
12,251,District - East Siang (07),Urban,10-14,3651,1778,1873,0,1813,858,350,149,201,3
12,251,District - East Siang (07),Urban,15-19,3597,1728,1869,0,1899,863,316,105,211,7
12,251,District - East Siang (07),Urban,20-24,2807,1315,1492,0,1302,569,368,132,236,11
12,251,District - East Siang (07),Urban,Adolescent (10-19),7248,3506,3742,0,3712,1721,666,254,412,10
12,251,District - East Siang (07),Urban,Youth (15-24),6404,3043,3361,0,3201,1432,684,237,447,18
12,252,District - Upper Siang (08),Total,All Ages,35320,18699,16621,0,28468,14413,17125,7976,9149,611
12,252,District - Upper Siang (08),Total,10-14,4489,2278,2211,0,3742,1890,1079,546,533,6
12,252,District - Upper Siang (08),Total,15-19,3489,1772,1717,0,2916,1454,527,257,270,15
12,252,District - Upper Siang (08),Total,20-24,2901,1526,1375,0,2211,1081,572,221,351,44
12,252,District - Upper Siang (08),Total,Adolescent (10-19),7978,4050,3928,0,6658,3344,1606,803,803,21
12,252,District - Upper Siang (08),Total,Youth (15-24),6390,3298,3092,0,5127,2535,1099,478,621,59
12,252,District - Upper Siang (08),Rural,All Ages,28780,15335,13445,0,24498,12492,15062,7055,8007,500
12,252,District - Upper Siang (08),Rural,10-14,3566,1828,1738,0,3152,1603,958,495,463,5
12,252,District - Upper Siang (08),Rural,15-19,2670,1374,1296,0,2384,1215,450,226,224,9
12,252,District - Upper Siang (08),Rural,20-24,2358,1285,1073,0,1894,948,499,200,299,38
12,252,District - Upper Siang (08),Rural,Adolescent (10-19),6236,3202,3034,0,5536,2818,1408,721,687,14
12,252,District - Upper Siang (08),Rural,Youth (15-24),5028,2659,2369,0,4278,2163,949,426,523,47
12,252,District - Upper Siang (08),Urban,All Ages,6540,3364,3176,0,3970,1921,2063,921,1142,111
12,252,District - Upper Siang (08),Urban,10-14,923,450,473,0,590,287,121,51,70,1
12,252,District - Upper Siang (08),Urban,15-19,819,398,421,0,532,239,77,31,46,6
12,252,District - Upper Siang (08),Urban,20-24,543,241,302,0,317,133,73,21,52,6
12,252,District - Upper Siang (08),Urban,Adolescent (10-19),1742,848,894,0,1122,526,198,82,116,7
12,252,District - Upper Siang (08),Urban,Youth (15-24),1362,639,723,0,849,372,150,52,98,12
12,253,District - Changlang (09),Total,All Ages,148226,76948,71278,0,53878,27061,75052,32921,42131,2473
12,253,District - Changlang (09),Total,10-14,17934,9187,8747,0,6640,3372,3907,1609,2298,74
12,253,District - Changlang (09),Total,15-19,14862,7833,7029,0,5784,2964,3658,1418,2240,228
12,253,District - Changlang (09),Total,20-24,13512,6630,6882,0,5035,2374,4522,1593,2929,324
12,253,District - Changlang (09),Total,Adolescent (10-19),32796,17020,15776,0,12424,6336,7565,3027,4538,302
12,253,District - Changlang (09),Total,Youth (15-24),28374,14463,13911,0,10819,5338,8180,3011,5169,552
12,253,District - Changlang (09),Rural,All Ages,128998,66283,62715,0,48221,24246,70251,30860,39391,2361
12,253,District - Changlang (09),Rural,10-14,15746,8038,7708,0,5791,2917,3722,1545,2177,74
12,253,District - Changlang (09),Rural,15-19,12719,6670,6049,0,5039,2589,3479,1345,2134,224
12,253,District - Changlang (09),Rural,20-24,11470,5520,5950,0,4464,2116,4285,1500,2785,316
12,253,District - Changlang (09),Rural,Adolescent (10-19),28465,14708,13757,0,10830,5506,7201,2890,4311,298
12,253,District - Changlang (09),Rural,Youth (15-24),24189,12190,11999,0,9503,4705,7764,2845,4919,540
12,253,District - Changlang (09),Urban,All Ages,19228,10665,8563,0,5657,2815,4801,2061,2740,112
12,253,District - Changlang (09),Urban,10-14,2188,1149,1039,0,849,455,185,64,121,0
12,253,District - Changlang (09),Urban,15-19,2143,1163,980,0,745,375,179,73,106,4
12,253,District - Changlang (09),Urban,20-24,2042,1110,932,0,571,258,237,93,144,8
12,253,District - Changlang (09),Urban,Adolescent (10-19),4331,2312,2019,0,1594,830,364,137,227,4
12,253,District - Changlang (09),Urban,Youth (15-24),4185,2273,1912,0,1316,633,416,166,250,12
12,254,District - Tirap (10),Total,All Ages,111975,57604,54371,0,98372,49365,64001,28291,35710,949
12,254,District - Tirap (10),Total,10-14,14304,7352,6952,0,13057,6693,4161,1882,2279,10
12,254,District - Tirap (10),Total,15-19,10992,5572,5420,0,9854,4962,2538,873,1665,40
12,254,District - Tirap (10),Total,20-24,8739,4292,4447,0,7471,3549,2758,811,1947,95
12,254,District - Tirap (10),Total,Adolescent (10-19),25296,12924,12372,0,22911,11655,6699,2755,3944,50
12,254,District - Tirap (10),Total,Youth (15-24),19731,9864,9867,0,17325,8511,5296,1684,3612,135
12,254,District - Tirap (10),Rural,All Ages,91165,46185,44980,0,87509,44101,57866,25557,32309,752
12,254,District - Tirap (10),Rural,10-14,11807,6130,5677,0,11452,5943,3834,1731,2103,10
12,254,District - Tirap (10),Rural,15-19,8635,4415,4220,0,8341,4254,2362,805,1557,37
12,254,District - Tirap (10),Rural,20-24,6770,3253,3517,0,6482,3103,2533,738,1795,81
12,254,District - Tirap (10),Rural,Adolescent (10-19),20442,10545,9897,0,19793,10197,6196,2536,3660,47
12,254,District - Tirap (10),Rural,Youth (15-24),15405,7668,7737,0,14823,7357,4895,1543,3352,118
12,254,District - Tirap (10),Urban,All Ages,20810,11419,9391,0,10863,5264,6135,2734,3401,197
12,254,District - Tirap (10),Urban,10-14,2497,1222,1275,0,1605,750,327,151,176,0
12,254,District - Tirap (10),Urban,15-19,2357,1157,1200,0,1513,708,176,68,108,3
12,254,District - Tirap (10),Urban,20-24,1969,1039,930,0,989,446,225,73,152,14
12,254,District - Tirap (10),Urban,Adolescent (10-19),4854,2379,2475,0,3118,1458,503,219,284,3
12,254,District - Tirap (10),Urban,Youth (15-24),4326,2196,2130,0,2502,1154,401,141,260,17
12,255,District - Lower Subansiri (11),Total,All Ages,83030,41843,41187,0,72911,35803,28973,12373,16600,826
12,255,District - Lower Subansiri (11),Total,10-14,11147,5702,5445,0,10093,5126,1480,682,798,4
12,255,District - Lower Subansiri (11),Total,15-19,11592,5709,5883,0,10552,5136,949,385,564,24
12,255,District - Lower Subansiri (11),Total,20-24,8913,4341,4572,0,7863,3730,987,367,620,70
12,255,District - Lower Subansiri (11),Total,Adolescent (10-19),22739,11411,11328,0,20645,10262,2429,1067,1362,28
12,255,District - Lower Subansiri (11),Total,Youth (15-24),20505,10050,10455,0,18415,8866,1936,752,1184,94
12,255,District - Lower Subansiri (11),Rural,All Ages,70224,35460,34764,0,64374,31912,25896,11084,14812,800
12,255,District - Lower Subansiri (11),Rural,10-14,9446,4858,4588,0,8827,4523,1348,633,715,3
12,255,District - Lower Subansiri (11),Rural,15-19,9698,4844,4854,0,9102,4513,813,341,472,21
12,255,District - Lower Subansiri (11),Rural,20-24,7560,3723,3837,0,6976,3366,872,318,554,67
12,255,District - Lower Subansiri (11),Rural,Adolescent (10-19),19144,9702,9442,0,17929,9036,2161,974,1187,24
12,255,District - Lower Subansiri (11),Rural,Youth (15-24),17258,8567,8691,0,16078,7879,1685,659,1026,88
12,255,District - Lower Subansiri (11),Urban,All Ages,12806,6383,6423,0,8537,3891,3077,1289,1788,26
12,255,District - Lower Subansiri (11),Urban,10-14,1701,844,857,0,1266,603,132,49,83,1
12,255,District - Lower Subansiri (11),Urban,15-19,1894,865,1029,0,1450,623,136,44,92,3
12,255,District - Lower Subansiri (11),Urban,20-24,1353,618,735,0,887,364,115,49,66,3
12,255,District - Lower Subansiri (11),Urban,Adolescent (10-19),3595,1709,1886,0,2716,1226,268,93,175,4
12,255,District - Lower Subansiri (11),Urban,Youth (15-24),3247,1483,1764,0,2337,987,251,93,158,6
12,256,District - Kurung Kumey (12),Total,All Ages,92076,45318,46758,0,90764,44459,55470,25060,30410,962
12,256,District - Kurung Kumey (12),Total,10-14,13916,7041,6875,0,13798,6990,4117,1964,2153,34
12,256,District - Kurung Kumey (12),Total,15-19,11124,5672,5452,0,11012,5609,2839,1311,1528,53
12,256,District - Kurung Kumey (12),Total,20-24,7240,3357,3883,0,7063,3235,2764,1062,1702,114
12,256,District - Kurung Kumey (12),Total,Adolescent (10-19),25040,12713,12327,0,24810,12599,6956,3275,3681,87
12,256,District - Kurung Kumey (12),Total,Youth (15-24),18364,9029,9335,0,18075,8844,5603,2373,3230,167
12,256,District - Kurung Kumey (12),Rural,All Ages,89731,44072,45659,0,88658,43406,54432,24586,29846,939
12,256,District - Kurung Kumey (12),Rural,10-14,13602,6887,6715,0,13492,6840,4065,1944,2121,34
12,256,District - Kurung Kumey (12),Rural,15-19,10881,5564,5317,0,10789,5513,2796,1296,1500,53
12,256,District - Kurung Kumey (12),Rural,20-24,7042,3255,3787,0,6898,3160,2728,1048,1680,111
12,256,District - Kurung Kumey (12),Rural,Adolescent (10-19),24483,12451,12032,0,24281,12353,6861,3240,3621,87
12,256,District - Kurung Kumey (12),Rural,Youth (15-24),17923,8819,9104,0,17687,8673,5524,2344,3180,164
12,256,District - Kurung Kumey (12),Urban,All Ages,2345,1246,1099,0,2106,1053,1038,474,564,23
12,256,District - Kurung Kumey (12),Urban,10-14,314,154,160,0,306,150,52,20,32,0
12,256,District - Kurung Kumey (12),Urban,15-19,243,108,135,0,223,96,43,15,28,0
12,256,District - Kurung Kumey (12),Urban,20-24,198,102,96,0,165,75,36,14,22,3
12,256,District - Kurung Kumey (12),Urban,Adolescent (10-19),557,262,295,0,529,246,95,35,60,0
12,256,District - Kurung Kumey (12),Urban,Youth (15-24),441,210,231,0,388,171,79,29,50,3
12,257,District - Dibang Valley (13),Total,All Ages,8004,4414,3590,0,5701,2850,3568,1800,1768,51
12,257,District - Dibang Valley (13),Total,10-14,949,468,481,0,750,371,158,69,89,0
12,257,District - Dibang Valley (13),Total,15-19,859,423,436,0,650,299,110,57,53,0
12,257,District - Dibang Valley (13),Total,20-24,871,511,360,0,558,286,185,110,75,7
12,257,District - Dibang Valley (13),Total,Adolescent (10-19),1808,891,917,0,1400,670,268,126,142,0
12,257,District - Dibang Valley (13),Total,Youth (15-24),1730,934,796,0,1208,585,295,167,128,7
12,257,District - Dibang Valley (13),Rural,All Ages,5620,3098,2522,0,4480,2285,2928,1511,1417,42
12,257,District - Dibang Valley (13),Rural,10-14,669,344,325,0,589,305,113,53,60,0
12,257,District - Dibang Valley (13),Rural,15-19,597,301,296,0,490,228,95,54,41,0
12,257,District - Dibang Valley (13),Rural,20-24,616,359,257,0,442,235,168,105,63,6
12,257,District - Dibang Valley (13),Rural,Adolescent (10-19),1266,645,621,0,1079,533,208,107,101,0
12,257,District - Dibang Valley (13),Rural,Youth (15-24),1213,660,553,0,932,463,263,159,104,6
12,257,District - Dibang Valley (13),Urban,All Ages,2384,1316,1068,0,1221,565,640,289,351,9
12,257,District - Dibang Valley (13),Urban,10-14,280,124,156,0,161,66,45,16,29,0
12,257,District - Dibang Valley (13),Urban,15-19,262,122,140,0,160,71,15,3,12,0
12,257,District - Dibang Valley (13),Urban,20-24,255,152,103,0,116,51,17,5,12,1
12,257,District - Dibang Valley (13),Urban,Adolescent (10-19),542,246,296,0,321,137,60,19,41,0
12,257,District - Dibang Valley (13),Urban,Youth (15-24),517,274,243,0,276,122,32,8,24,1
12,258,District - Lower Dibang Valley (14),Total,All Ages,54080,28053,26027,0,25974,12649,22231,9966,12265,2559
12,258,District - Lower Dibang Valley (14),Total,10-14,7003,3582,3421,0,3699,1835,866,383,483,48
12,258,District - Lower Dibang Valley (14),Total,15-19,6173,3160,3013,0,3257,1613,857,361,496,198
12,258,District - Lower Dibang Valley (14),Total,20-24,5244,2559,2685,0,2447,1144,1245,451,794,342
12,258,District - Lower Dibang Valley (14),Total,Adolescent (10-19),13176,6742,6434,0,6956,3448,1723,744,979,246
12,258,District - Lower Dibang Valley (14),Total,Youth (15-24),11417,5719,5698,0,5704,2757,2102,812,1290,540
12,258,District - Lower Dibang Valley (14),Rural,All Ages,42691,21989,20702,0,22579,11024,19886,8910,10976,2515
12,258,District - Lower Dibang Valley (14),Rural,10-14,5253,2712,2541,0,2925,1453,796,358,438,46
12,258,District - Lower Dibang Valley (14),Rural,15-19,4559,2339,2220,0,2521,1259,769,326,443,193
12,258,District - Lower Dibang Valley (14),Rural,20-24,4241,2050,2191,0,2198,1035,1148,409,739,340
12,258,District - Lower Dibang Valley (14),Rural,Adolescent (10-19),9812,5051,4761,0,5446,2712,1565,684,881,239
12,258,District - Lower Dibang Valley (14),Rural,Youth (15-24),8800,4389,4411,0,4719,2294,1917,735,1182,533
12,258,District - Lower Dibang Valley (14),Urban,All Ages,11389,6064,5325,0,3395,1625,2345,1056,1289,44
12,258,District - Lower Dibang Valley (14),Urban,10-14,1750,870,880,0,774,382,70,25,45,2
12,258,District - Lower Dibang Valley (14),Urban,15-19,1614,821,793,0,736,354,88,35,53,5
12,258,District - Lower Dibang Valley (14),Urban,20-24,1003,509,494,0,249,109,97,42,55,2
12,258,District - Lower Dibang Valley (14),Urban,Adolescent (10-19),3364,1691,1673,0,1510,736,158,60,98,7
12,258,District - Lower Dibang Valley (14),Urban,Youth (15-24),2617,1330,1287,0,985,463,185,77,108,7
12,259,District - Lohit (15),Total,All Ages,145726,76221,69505,0,47410,23457,62664,27841,34823,5134
12,259,District - Lohit (15),Total,10-14,18187,9333,8854,0,6386,3125,2657,1165,1492,91
12,259,District - Lohit (15),Total,15-19,15267,7992,7275,0,5356,2673,2673,1127,1546,423
12,259,District - Lohit (15),Total,20-24,13737,6912,6825,0,4318,1988,3613,1376,2237,682
12,259,District - Lohit (15),Total,Adolescent (10-19),33454,17325,16129,0,11742,5798,5330,2292,3038,514
12,259,District - Lohit (15),Total,Youth (15-24),29004,14904,14100,0,9674,4661,6286,2503,3783,1105
12,259,District - Lohit (15),Rural,All Ages,113296,58991,54305,0,40355,19964,53044,23539,29505,4884
12,259,District - Lohit (15),Rural,10-14,14354,7295,7059,0,5394,2616,2302,999,1303,88
12,259,District - Lohit (15),Rural,15-19,11348,5930,5418,0,4308,2158,2269,964,1305,410
12,259,District - Lohit (15),Rural,20-24,10409,5255,5154,0,3618,1662,3085,1171,1914,656
12,259,District - Lohit (15),Rural,Adolescent (10-19),25702,13225,12477,0,9702,4774,4571,1963,2608,498
12,259,District - Lohit (15),Rural,Youth (15-24),21757,11185,10572,0,7926,3820,5354,2135,3219,1066
12,259,District - Lohit (15),Urban,All Ages,32430,17230,15200,0,7055,3493,9620,4302,5318,250
12,259,District - Lohit (15),Urban,10-14,3833,2038,1795,0,992,509,355,166,189,3
12,259,District - Lohit (15),Urban,15-19,3919,2062,1857,0,1048,515,404,163,241,13
12,259,District - Lohit (15),Urban,20-24,3328,1657,1671,0,700,326,528,205,323,26
12,259,District - Lohit (15),Urban,Adolescent (10-19),7752,4100,3652,0,2040,1024,759,329,430,16
12,259,District - Lohit (15),Urban,Youth (15-24),7247,3719,3528,0,1748,841,932,368,564,39
12,260,District - Anjaw (16),Total,All Ages,21167,11507,9660,0,16451,8208,11177,4984,6193,83
12,260,District - Anjaw (16),Total,10-14,2702,1507,1195,0,2376,1337,451,212,239,0
12,260,District - Anjaw (16),Total,15-19,2036,1119,917,0,1663,882,465,209,256,4
12,260,District - Anjaw (16),Total,20-24,1996,1084,912,0,1287,564,750,292,458,14
12,260,District - Anjaw (16),Total,Adolescent (10-19),4738,2626,2112,0,4039,2219,916,421,495,4
12,260,District - Anjaw (16),Total,Youth (15-24),4032,2203,1829,0,2950,1446,1215,501,714,18
12,260,District - Anjaw (16),Rural,All Ages,20185,10882,9303,0,16009,8001,10917,4809,6108,83
12,260,District - Anjaw (16),Rural,10-14,2507,1422,1085,0,2225,1274,446,210,236,0
12,260,District - Anjaw (16),Rural,15-19,1854,1004,850,0,1557,831,441,186,255,4
12,260,District - Anjaw (16),Rural,20-24,1864,981,883,0,1268,557,707,255,452,14
12,260,District - Anjaw (16),Rural,Adolescent (10-19),4361,2426,1935,0,3782,2105,887,396,491,4
12,260,District - Anjaw (16),Rural,Youth (15-24),3718,1985,1733,0,2825,1388,1148,441,707,18
12,260,District - Anjaw (16),Urban,All Ages,982,625,357,0,442,207,260,175,85,0
12,260,District - Anjaw (16),Urban,10-14,195,85,110,0,151,63,5,2,3,0
12,260,District - Anjaw (16),Urban,15-19,182,115,67,0,106,51,24,23,1,0
12,260,District - Anjaw (16),Urban,20-24,132,103,29,0,19,7,43,37,6,0
12,260,District - Anjaw (16),Urban,Adolescent (10-19),377,200,177,0,257,114,29,25,4,0
12,260,District - Anjaw (16),Urban,Youth (15-24),314,218,96,0,125,58,67,60,7,0
13,0,State - NAGALAND (13),Total,All Ages,1978502,1024649,953853,0,1710973,866027,636068,300692,335376,22571
13,0,State - NAGALAND (13),Total,10-14,248671,129237,119434,0,221854,114884,31370,15925,15445,506
13,0,State - NAGALAND (13),Total,15-19,229622,117994,111628,0,204853,103976,24749,12167,12582,2145
13,0,State - NAGALAND (13),Total,20-24,204363,103769,100594,0,175830,86972,26418,12005,14413,3408
13,0,State - NAGALAND (13),Total,Adolescent (10-19),478293,247231,231062,0,426707,218860,56119,28092,28027,2651
13,0,State - NAGALAND (13),Total,Youth (15-24),433985,221763,212222,0,380683,190948,51167,24172,26995,5553
13,0,State - NAGALAND (13),Rural,All Ages,1407536,725472,682064,0,1306838,665351,510873,241451,269422,19970
13,0,State - NAGALAND (13),Rural,10-14,181149,94658,86491,0,170014,88621,27113,13873,13240,484
13,0,State - NAGALAND (13),Rural,15-19,161926,83359,78567,0,152575,78086,21139,10374,10765,1981
13,0,State - NAGALAND (13),Rural,20-24,139581,70944,68637,0,128991,64486,22306,10181,12125,3108
13,0,State - NAGALAND (13),Rural,Adolescent (10-19),343075,178017,165058,0,322589,166707,48252,24247,24005,2465
13,0,State - NAGALAND (13),Rural,Youth (15-24),301507,154303,147204,0,281566,142572,43445,20555,22890,5089
13,0,State - NAGALAND (13),Urban,All Ages,570966,299177,271789,0,404135,200676,125195,59241,65954,2601
13,0,State - NAGALAND (13),Urban,10-14,67522,34579,32943,0,51840,26263,4257,2052,2205,22
13,0,State - NAGALAND (13),Urban,15-19,67696,34635,33061,0,52278,25890,3610,1793,1817,164
13,0,State - NAGALAND (13),Urban,20-24,64782,32825,31957,0,46839,22486,4112,1824,2288,300
13,0,State - NAGALAND (13),Urban,Adolescent (10-19),135218,69214,66004,0,104118,52153,7867,3845,4022,186
13,0,State - NAGALAND (13),Urban,Youth (15-24),132478,67460,65018,0,99117,48376,7722,3617,4105,464
13,261,District - Mon (01),Total,All Ages,250260,131753,118507,0,238285,124343,130634,64321,66313,3947
13,261,District - Mon (01),Total,10-14,33959,18162,15797,0,32724,17496,10044,5277,4767,101
13,261,District - Mon (01),Total,15-19,31835,16572,15263,0,30817,15956,9226,4684,4542,460
13,261,District - Mon (01),Total,20-24,24987,13209,11778,0,23823,12505,8482,4270,4212,602
13,261,District - Mon (01),Total,Adolescent (10-19),65794,34734,31060,0,63541,33452,19270,9961,9309,561
13,261,District - Mon (01),Total,Youth (15-24),56822,29781,27041,0,54640,28461,17708,8954,8754,1062
13,261,District - Mon (01),Rural,All Ages,215816,113469,102347,0,209012,109343,120885,59531,61354,3770
13,261,District - Mon (01),Rural,10-14,29141,15619,13522,0,28382,15212,9628,5047,4581,101
13,261,District - Mon (01),Rural,15-19,27245,14267,12978,0,26669,13932,8917,4514,4403,448
13,261,District - Mon (01),Rural,20-24,21279,11325,9954,0,20672,10964,8109,4102,4007,578
13,261,District - Mon (01),Rural,Adolescent (10-19),56386,29886,26500,0,55051,29144,18545,9561,8984,549
13,261,District - Mon (01),Rural,Youth (15-24),48524,25592,22932,0,47341,24896,17026,8616,8410,1026
13,261,District - Mon (01),Urban,All Ages,34444,18284,16160,0,29273,15000,9749,4790,4959,177
13,261,District - Mon (01),Urban,10-14,4818,2543,2275,0,4342,2284,416,230,186,0
13,261,District - Mon (01),Urban,15-19,4590,2305,2285,0,4148,2024,309,170,139,12
13,261,District - Mon (01),Urban,20-24,3708,1884,1824,0,3151,1541,373,168,205,24
13,261,District - Mon (01),Urban,Adolescent (10-19),9408,4848,4560,0,8490,4308,725,400,325,12
13,261,District - Mon (01),Urban,Youth (15-24),8298,4189,4109,0,7299,3565,682,338,344,36
13,262,District - Mokokchung (02),Total,All Ages,194622,101092,93530,0,178431,90567,35128,17613,17515,4863
13,262,District - Mokokchung (02),Total,10-14,22283,11749,10534,0,20762,10855,1115,624,491,90
13,262,District - Mokokchung (02),Total,15-19,20982,11084,9898,0,19480,10129,787,496,291,512
13,262,District - Mokokchung (02),Total,20-24,18975,9925,9050,0,17256,8832,896,489,407,784
13,262,District - Mokokchung (02),Total,Adolescent (10-19),43265,22833,20432,0,40242,20984,1902,1120,782,602
13,262,District - Mokokchung (02),Total,Youth (15-24),39957,21009,18948,0,36736,18961,1683,985,698,1296
13,262,District - Mokokchung (02),Rural,All Ages,138897,71373,67524,0,131619,66954,26286,13066,13220,4195
13,262,District - Mokokchung (02),Rural,10-14,15606,8141,7465,0,14866,7729,836,466,370,85
13,262,District - Mokokchung (02),Rural,15-19,14919,7836,7083,0,14197,7401,605,374,231,479
13,262,District - Mokokchung (02),Rural,20-24,13253,6856,6397,0,12552,6444,684,372,312,734
13,262,District - Mokokchung (02),Rural,Adolescent (10-19),30525,15977,14548,0,29063,15130,1441,840,601,564
13,262,District - Mokokchung (02),Rural,Youth (15-24),28172,14692,13480,0,26749,13845,1289,746,543,1213
13,262,District - Mokokchung (02),Urban,All Ages,55725,29719,26006,0,46812,23613,8842,4547,4295,668
13,262,District - Mokokchung (02),Urban,10-14,6677,3608,3069,0,5896,3126,279,158,121,5
13,262,District - Mokokchung (02),Urban,15-19,6063,3248,2815,0,5283,2728,182,122,60,33
13,262,District - Mokokchung (02),Urban,20-24,5722,3069,2653,0,4704,2388,212,117,95,50
13,262,District - Mokokchung (02),Urban,Adolescent (10-19),12740,6856,5884,0,11179,5854,461,280,181,38
13,262,District - Mokokchung (02),Urban,Youth (15-24),11785,6317,5468,0,9987,5116,394,239,155,83
13,263,District - Zunheboto (03),Total,All Ages,140757,71217,69540,0,136561,68071,37876,17713,20163,1763
13,263,District - Zunheboto (03),Total,10-14,18764,9617,9147,0,18480,9453,1305,664,641,34
13,263,District - Zunheboto (03),Total,15-19,16714,8382,8332,0,16448,8207,962,472,490,134
13,263,District - Zunheboto (03),Total,20-24,14006,6815,7191,0,13537,6454,1070,518,552,205
13,263,District - Zunheboto (03),Total,Adolescent (10-19),35478,17999,17479,0,34928,17660,2267,1136,1131,168
13,263,District - Zunheboto (03),Total,Youth (15-24),30720,15197,15523,0,29985,14661,2032,990,1042,339
13,263,District - Zunheboto (03),Rural,All Ages,113160,56786,56374,0,111875,55946,33011,15409,17602,1583
13,263,District - Zunheboto (03),Rural,10-14,14837,7668,7169,0,14726,7603,1141,582,559,33
13,263,District - Zunheboto (03),Rural,15-19,13103,6637,6466,0,12984,6565,831,411,420,125
13,263,District - Zunheboto (03),Rural,20-24,10957,5220,5737,0,10848,5147,954,451,503,185
13,263,District - Zunheboto (03),Rural,Adolescent (10-19),27940,14305,13635,0,27710,14168,1972,993,979,158
13,263,District - Zunheboto (03),Rural,Youth (15-24),24060,11857,12203,0,23832,11712,1785,862,923,310
13,263,District - Zunheboto (03),Urban,All Ages,27597,14431,13166,0,24686,12125,4865,2304,2561,180
13,263,District - Zunheboto (03),Urban,10-14,3927,1949,1978,0,3754,1850,164,82,82,1
13,263,District - Zunheboto (03),Urban,15-19,3611,1745,1866,0,3464,1642,131,61,70,9
13,263,District - Zunheboto (03),Urban,20-24,3049,1595,1454,0,2689,1307,116,67,49,20
13,263,District - Zunheboto (03),Urban,Adolescent (10-19),7538,3694,3844,0,7218,3492,295,143,152,10
13,263,District - Zunheboto (03),Urban,Youth (15-24),6660,3340,3320,0,6153,2949,247,128,119,29
13,264,District - Wokha (04),Total,All Ages,166343,84505,81838,0,156621,78816,38135,17120,21015,2375
13,264,District - Wokha (04),Total,10-14,21037,10657,10380,0,20008,10114,1215,571,644,59
13,264,District - Wokha (04),Total,15-19,21484,11069,10415,0,20545,10582,1005,443,562,228
13,264,District - Wokha (04),Total,20-24,18977,9411,9566,0,17976,8833,1163,484,679,387
13,264,District - Wokha (04),Total,Adolescent (10-19),42521,21726,20795,0,40553,20696,2220,1014,1206,287
13,264,District - Wokha (04),Total,Youth (15-24),40461,20480,19981,0,38521,19415,2168,927,1241,615
13,264,District - Wokha (04),Rural,All Ages,131339,66435,64904,0,125051,63008,33118,14768,18350,2340
13,264,District - Wokha (04),Rural,10-14,16871,8608,8263,0,16058,8183,1101,518,583,59
13,264,District - Wokha (04),Rural,15-19,16513,8538,7975,0,15842,8200,845,380,465,227
13,264,District - Wokha (04),Rural,20-24,14349,7150,7199,0,13777,6854,1053,438,615,383
13,264,District - Wokha (04),Rural,Adolescent (10-19),33384,17146,16238,0,31900,16383,1946,898,1048,286
13,264,District - Wokha (04),Rural,Youth (15-24),30862,15688,15174,0,29619,15054,1898,818,1080,610
13,264,District - Wokha (04),Urban,All Ages,35004,18070,16934,0,31570,15808,5017,2352,2665,35
13,264,District - Wokha (04),Urban,10-14,4166,2049,2117,0,3950,1931,114,53,61,0
13,264,District - Wokha (04),Urban,15-19,4971,2531,2440,0,4703,2382,160,63,97,1
13,264,District - Wokha (04),Urban,20-24,4628,2261,2367,0,4199,1979,110,46,64,4
13,264,District - Wokha (04),Urban,Adolescent (10-19),9137,4580,4557,0,8653,4313,274,116,158,1
13,264,District - Wokha (04),Urban,Youth (15-24),9599,4792,4807,0,8902,4361,270,109,161,5
13,265,District - Dimapur (05),Total,All Ages,378811,197394,181417,0,223989,110892,100774,47252,53522,4506
13,265,District - Dimapur (05),Total,10-14,43127,21985,21142,0,26886,13489,4416,2066,2350,101
13,265,District - Dimapur (05),Total,15-19,42075,21432,20643,0,27480,13498,3548,1618,1930,389
13,265,District - Dimapur (05),Total,20-24,43510,21892,21618,0,27384,13117,4200,1640,2560,625
13,265,District - Dimapur (05),Total,Adolescent (10-19),85202,43417,41785,0,54366,26987,7964,3684,4280,490
13,265,District - Dimapur (05),Total,Youth (15-24),85585,43324,42261,0,54864,26615,7748,3258,4490,1014
13,265,District - Dimapur (05),Rural,All Ages,180942,93435,87507,0,130996,65667,54120,25095,29025,3948
13,265,District - Dimapur (05),Rural,10-14,22575,11508,11067,0,16514,8322,2625,1228,1397,97
13,265,District - Dimapur (05),Rural,15-19,21135,10723,10412,0,16193,8010,2089,933,1156,350
13,265,District - Dimapur (05),Rural,20-24,20787,10779,10008,0,15388,7662,2338,886,1452,567
13,265,District - Dimapur (05),Rural,Adolescent (10-19),43710,22231,21479,0,32707,16332,4714,2161,2553,447
13,265,District - Dimapur (05),Rural,Youth (15-24),41922,21502,20420,0,31581,15672,4427,1819,2608,917
13,265,District - Dimapur (05),Urban,All Ages,197869,103959,93910,0,92993,45225,46654,22157,24497,558
13,265,District - Dimapur (05),Urban,10-14,20552,10477,10075,0,10372,5167,1791,838,953,4
13,265,District - Dimapur (05),Urban,15-19,20940,10709,10231,0,11287,5488,1459,685,774,39
13,265,District - Dimapur (05),Urban,20-24,22723,11113,11610,0,11996,5455,1862,754,1108,58
13,265,District - Dimapur (05),Urban,Adolescent (10-19),41492,21186,20306,0,21659,10655,3250,1523,1727,43
13,265,District - Dimapur (05),Urban,Youth (15-24),43663,21822,21841,0,23283,10943,3321,1439,1882,97
13,266,District - Phek (06),Total,All Ages,163418,83743,79675,0,157146,79536,57525,25817,31708,1311
13,266,District - Phek (06),Total,10-14,21423,11151,10272,0,20940,10891,1732,829,903,31
13,266,District - Phek (06),Total,15-19,17525,8885,8640,0,17024,8580,1398,619,779,90
13,266,District - Phek (06),Total,20-24,15008,7390,7618,0,14309,6941,2007,752,1255,203
13,266,District - Phek (06),Total,Adolescent (10-19),38948,20036,18912,0,37964,19471,3130,1448,1682,121
13,266,District - Phek (06),Total,Youth (15-24),32533,16275,16258,0,31333,15521,3405,1371,2034,293
13,266,District - Phek (06),Rural,All Ages,138843,70529,68314,0,136351,68920,51610,23192,28418,1274
13,266,District - Phek (06),Rural,10-14,18207,9495,8712,0,17987,9371,1597,756,841,31
13,266,District - Phek (06),Rural,15-19,14567,7368,7199,0,14367,7241,1285,559,726,89
13,266,District - Phek (06),Rural,20-24,12441,6021,6420,0,12196,5861,1853,691,1162,198
13,266,District - Phek (06),Rural,Adolescent (10-19),32774,16863,15911,0,32354,16612,2882,1315,1567,120
13,266,District - Phek (06),Rural,Youth (15-24),27008,13389,13619,0,26563,13102,3138,1250,1888,287
13,266,District - Phek (06),Urban,All Ages,24575,13214,11361,0,20795,10616,5915,2625,3290,37
13,266,District - Phek (06),Urban,10-14,3216,1656,1560,0,2953,1520,135,73,62,0
13,266,District - Phek (06),Urban,15-19,2958,1517,1441,0,2657,1339,113,60,53,1
13,266,District - Phek (06),Urban,20-24,2567,1369,1198,0,2113,1080,154,61,93,5
13,266,District - Phek (06),Urban,Adolescent (10-19),6174,3173,3001,0,5610,2859,248,133,115,1
13,266,District - Phek (06),Urban,Youth (15-24),5525,2886,2639,0,4770,2419,267,121,146,6
13,267,District - Tuensang (07),Total,All Ages,196596,101933,94663,0,190916,98212,79085,38280,40805,945
13,267,District - Tuensang (07),Total,10-14,26653,14022,12631,0,26194,13771,4651,2413,2238,16
13,267,District - Tuensang (07),Total,15-19,22388,11684,10704,0,21933,11410,2856,1500,1356,110
13,267,District - Tuensang (07),Total,20-24,18111,9069,9042,0,17517,8723,2816,1327,1489,187
13,267,District - Tuensang (07),Total,Adolescent (10-19),49041,25706,23335,0,48127,25181,7507,3913,3594,126
13,267,District - Tuensang (07),Total,Youth (15-24),40499,20753,19746,0,39450,20133,5672,2827,2845,297
13,267,District - Tuensang (07),Rural,All Ages,159822,82462,77360,0,157448,81043,70870,34349,36521,539
13,267,District - Tuensang (07),Rural,10-14,21699,11448,10251,0,21483,11335,4450,2325,2125,11
13,267,District - Tuensang (07),Rural,15-19,17631,9235,8396,0,17391,9083,2716,1420,1296,74
13,267,District - Tuensang (07),Rural,20-24,14004,6955,7049,0,13755,6826,2674,1270,1404,121
13,267,District - Tuensang (07),Rural,Adolescent (10-19),39330,20683,18647,0,38874,20418,7166,3745,3421,85
13,267,District - Tuensang (07),Rural,Youth (15-24),31635,16190,15445,0,31146,15909,5390,2690,2700,195
13,267,District - Tuensang (07),Urban,All Ages,36774,19471,17303,0,33468,17169,8215,3931,4284,406
13,267,District - Tuensang (07),Urban,10-14,4954,2574,2380,0,4711,2436,201,88,113,5
13,267,District - Tuensang (07),Urban,15-19,4757,2449,2308,0,4542,2327,140,80,60,36
13,267,District - Tuensang (07),Urban,20-24,4107,2114,1993,0,3762,1897,142,57,85,66
13,267,District - Tuensang (07),Urban,Adolescent (10-19),9711,5023,4688,0,9253,4763,341,168,173,41
13,267,District - Tuensang (07),Urban,Youth (15-24),8864,4563,4301,0,8304,4224,282,137,145,102
13,268,District - Longleng (08),Total,All Ages,50484,26502,23982,0,48615,25268,20625,10363,10262,278
13,268,District - Longleng (08),Total,10-14,6522,3433,3089,0,6334,3311,944,527,417,17
13,268,District - Longleng (08),Total,15-19,5200,2648,2552,0,5036,2543,561,303,258,33
13,268,District - Longleng (08),Total,20-24,4966,2519,2447,0,4748,2370,859,398,461,52
13,268,District - Longleng (08),Total,Adolescent (10-19),11722,6081,5641,0,11370,5854,1505,830,675,50
13,268,District - Longleng (08),Total,Youth (15-24),10166,5167,4999,0,9784,4913,1420,701,719,85
13,268,District - Longleng (08),Rural,All Ages,42871,22511,20360,0,41778,21787,18853,9495,9358,197
13,268,District - Longleng (08),Rural,10-14,5487,2905,2582,0,5373,2827,907,507,400,16
13,268,District - Longleng (08),Rural,15-19,4272,2168,2104,0,4185,2103,532,284,248,27
13,268,District - Longleng (08),Rural,20-24,4104,2072,2032,0,3985,1996,816,371,445,35
13,268,District - Longleng (08),Rural,Adolescent (10-19),9759,5073,4686,0,9558,4930,1439,791,648,43
13,268,District - Longleng (08),Rural,Youth (15-24),8376,4240,4136,0,8170,4099,1348,655,693,62
13,268,District - Longleng (08),Urban,All Ages,7613,3991,3622,0,6837,3481,1772,868,904,81
13,268,District - Longleng (08),Urban,10-14,1035,528,507,0,961,484,37,20,17,1
13,268,District - Longleng (08),Urban,15-19,928,480,448,0,851,440,29,19,10,6
13,268,District - Longleng (08),Urban,20-24,862,447,415,0,763,374,43,27,16,17
13,268,District - Longleng (08),Urban,Adolescent (10-19),1963,1008,955,0,1812,924,66,39,27,7
13,268,District - Longleng (08),Urban,Youth (15-24),1790,927,863,0,1614,814,72,46,26,23
13,269,District - Kiphire (09),Total,All Ages,74004,37830,36174,0,71429,36217,32772,15155,17617,440
13,269,District - Kiphire (09),Total,10-14,10170,5365,4805,0,9878,5188,1801,900,901,27
13,269,District - Kiphire (09),Total,15-19,8779,4422,4357,0,8498,4254,1451,636,815,54
13,269,District - Kiphire (09),Total,20-24,6890,3361,3529,0,6607,3157,1447,589,858,79
13,269,District - Kiphire (09),Total,Adolescent (10-19),18949,9787,9162,0,18376,9442,3252,1536,1716,81
13,269,District - Kiphire (09),Total,Youth (15-24),15669,7783,7886,0,15105,7411,2898,1225,1673,133
13,269,District - Kiphire (09),Rural,All Ages,57517,29243,28274,0,56131,28404,28130,12988,15142,365
13,269,District - Kiphire (09),Rural,10-14,7749,4101,3648,0,7571,3996,1628,811,817,25
13,269,District - Kiphire (09),Rural,15-19,6439,3219,3220,0,6264,3113,1330,574,756,49
13,269,District - Kiphire (09),Rural,20-24,5178,2502,2676,0,5021,2387,1348,541,807,65
13,269,District - Kiphire (09),Rural,Adolescent (10-19),14188,7320,6868,0,13835,7109,2958,1385,1573,74
13,269,District - Kiphire (09),Rural,Youth (15-24),11617,5721,5896,0,11285,5500,2678,1115,1563,114
13,269,District - Kiphire (09),Urban,All Ages,16487,8587,7900,0,15298,7813,4642,2167,2475,75
13,269,District - Kiphire (09),Urban,10-14,2421,1264,1157,0,2307,1192,173,89,84,2
13,269,District - Kiphire (09),Urban,15-19,2340,1203,1137,0,2234,1141,121,62,59,5
13,269,District - Kiphire (09),Urban,20-24,1712,859,853,0,1586,770,99,48,51,14
13,269,District - Kiphire (09),Urban,Adolescent (10-19),4761,2467,2294,0,4541,2333,294,151,143,7
13,269,District - Kiphire (09),Urban,Youth (15-24),4052,2062,1990,0,3820,1911,220,110,110,19
13,270,District - Kohima (10),Total,All Ages,267988,138966,129022,0,224738,110617,70499,31928,38571,911
13,270,District - Kohima (10),Total,10-14,31840,16200,15640,0,28111,14196,2575,1251,1324,12
13,270,District - Kohima (10),Total,15-19,31364,16008,15356,0,27327,13514,1900,915,985,45
13,270,District - Kohima (10),Total,20-24,29633,15417,14216,0,24360,11814,2300,1056,1244,111
13,270,District - Kohima (10),Total,Adolescent (10-19),63204,32208,30996,0,55438,27710,4475,2166,2309,57
13,270,District - Kohima (10),Total,Youth (15-24),60997,31425,29572,0,51687,25328,4200,1971,2229,156
13,270,District - Kohima (10),Rural,All Ages,146900,76369,70531,0,133572,66258,44916,20098,24818,729
13,270,District - Kohima (10),Rural,10-14,17999,9244,8755,0,17108,8725,1763,889,874,11
13,270,District - Kohima (10),Rural,15-19,16414,8340,8074,0,15562,7790,1014,476,538,37
13,270,District - Kohima (10),Rural,20-24,15362,7978,7384,0,13693,6690,1407,606,801,91
13,270,District - Kohima (10),Rural,Adolescent (10-19),34413,17584,16829,0,32670,16515,2777,1365,1412,48
13,270,District - Kohima (10),Rural,Youth (15-24),31776,16318,15458,0,29255,14480,2421,1082,1339,128
13,270,District - Kohima (10),Urban,All Ages,121088,62597,58491,0,91166,44359,25583,11830,13753,182
13,270,District - Kohima (10),Urban,10-14,13841,6956,6885,0,11003,5471,812,362,450,1
13,270,District - Kohima (10),Urban,15-19,14950,7668,7282,0,11765,5724,886,439,447,8
13,270,District - Kohima (10),Urban,20-24,14271,7439,6832,0,10667,5124,893,450,443,20
13,270,District - Kohima (10),Urban,Adolescent (10-19),28791,14624,14167,0,22768,11195,1698,801,897,9
13,270,District - Kohima (10),Urban,Youth (15-24),29221,15107,14114,0,22432,10848,1779,889,890,28
13,271,District - Peren (11),Total,All Ages,95219,49714,45505,0,84242,43488,33015,15130,17885,1232
13,271,District - Peren (11),Total,10-14,12893,6896,5997,0,11537,6120,1572,803,769,18
13,271,District - Peren (11),Total,15-19,11276,5808,5468,0,10265,5303,1055,481,574,90
13,271,District - Peren (11),Total,20-24,9300,4761,4539,0,8313,4226,1178,482,696,173
13,271,District - Peren (11),Total,Adolescent (10-19),24169,12704,11465,0,21802,11423,2627,1284,1343,108
13,271,District - Peren (11),Total,Youth (15-24),20576,10569,10007,0,18578,9529,2233,963,1270,263
13,271,District - Peren (11),Rural,All Ages,81429,42860,38569,0,73005,38021,29074,13460,15614,1030
13,271,District - Peren (11),Rural,10-14,10978,5921,5057,0,9946,5318,1437,744,693,15
13,271,District - Peren (11),Rural,15-19,9688,5028,4660,0,8921,4648,975,449,526,76
13,271,District - Peren (11),Rural,20-24,7867,4086,3781,0,7104,3655,1070,453,617,151
13,271,District - Peren (11),Rural,Adolescent (10-19),20666,10949,9717,0,18867,9966,2412,1193,1219,91
13,271,District - Peren (11),Rural,Youth (15-24),17555,9114,8441,0,16025,8303,2045,902,1143,227
13,271,District - Peren (11),Urban,All Ages,13790,6854,6936,0,11237,5467,3941,1670,2271,202
13,271,District - Peren (11),Urban,10-14,1915,975,940,0,1591,802,135,59,76,3
13,271,District - Peren (11),Urban,15-19,1588,780,808,0,1344,655,80,32,48,14
13,271,District - Peren (11),Urban,20-24,1433,675,758,0,1209,571,108,29,79,22
13,271,District - Peren (11),Urban,Adolescent (10-19),3503,1755,1748,0,2935,1457,215,91,124,17
13,271,District - Peren (11),Urban,Youth (15-24),3021,1455,1566,0,2553,1226,188,61,127,36
14,0,State - MANIPUR (14),Total,All Ages,2855794,1438586,1417208,97328,1167422,588279,947318,398728,548590,45609
14,0,State - MANIPUR (14),Total,10-14,313763,161146,152617,9959,138386,71732,39368,19060,20308,458
14,0,State - MANIPUR (14),Total,15-19,287008,144495,142513,8265,137799,69840,30462,12981,17481,2174
14,0,State - MANIPUR (14),Total,20-24,281782,139587,142195,8624,126099,62503,38385,14659,23726,5004
14,0,State - MANIPUR (14),Total,Adolescent (10-19),600771,305641,295130,18224,276185,141572,69830,32041,37789,2632
14,0,State - MANIPUR (14),Total,Youth (15-24),568790,284082,284708,16889,263898,132343,68847,27640,41207,7178
14,0,State - MANIPUR (14),Rural,All Ages,2021640,1026884,994756,47849,1055808,533856,738781,316750,422031,36208
14,0,State - MANIPUR (14),Rural,10-14,230842,119214,111628,5008,125084,64982,33781,16471,17310,403
14,0,State - MANIPUR (14),Rural,15-19,213039,107906,105133,4094,124930,63629,26979,11714,15265,1883
14,0,State - MANIPUR (14),Rural,20-24,204739,102223,102516,4456,114608,56867,33976,13289,20687,4144
14,0,State - MANIPUR (14),Rural,Adolescent (10-19),443881,227120,216761,9102,250014,128611,60760,28185,32575,2286
14,0,State - MANIPUR (14),Rural,Youth (15-24),417778,210129,207649,8550,239538,120496,60955,25003,35952,6027
14,0,State - MANIPUR (14),Urban,All Ages,834154,411702,422452,49479,111614,54423,208537,81978,126559,9401
14,0,State - MANIPUR (14),Urban,10-14,82921,41932,40989,4951,13302,6750,5587,2589,2998,55
14,0,State - MANIPUR (14),Urban,15-19,73969,36589,37380,4171,12869,6211,3483,1267,2216,291
14,0,State - MANIPUR (14),Urban,20-24,77043,37364,39679,4168,11491,5636,4409,1370,3039,860
14,0,State - MANIPUR (14),Urban,Adolescent (10-19),156890,78521,78369,9122,26171,12961,9070,3856,5214,346
14,0,State - MANIPUR (14),Urban,Youth (15-24),151012,73953,77059,8339,24360,11847,7892,2637,5255,1151
14,272,District - Senapati (01),Total,All Ages,479148,247323,231825,1000,419210,214519,214671,99311,115360,5039
14,272,District - Senapati (01),Total,10-14,59880,31499,28381,138,52256,27432,12777,6422,6355,87
14,272,District - Senapati (01),Total,15-19,59851,31240,28611,129,53295,27748,11834,5647,6187,353
14,272,District - Senapati (01),Total,20-24,54558,28047,26511,102,48147,24486,15030,6664,8366,679
14,272,District - Senapati (01),Total,Adolescent (10-19),119731,62739,56992,267,105551,55180,24611,12069,12542,440
14,272,District - Senapati (01),Total,Youth (15-24),114409,59287,55122,231,101442,52234,26864,12311,14553,1032
14,272,District - Senapati (01),Rural,All Ages,471672,243603,228069,997,413555,211741,212694,98474,114220,5028
14,272,District - Senapati (01),Rural,10-14,58967,31025,27942,138,51584,27086,12742,6409,6333,87
14,272,District - Senapati (01),Rural,15-19,58989,30812,28177,129,52629,27412,11811,5643,6168,352
14,272,District - Senapati (01),Rural,20-24,53793,27678,26115,102,47544,24204,14995,6655,8340,677
14,272,District - Senapati (01),Rural,Adolescent (10-19),117956,61837,56119,267,104213,54498,24553,12052,12501,439
14,272,District - Senapati (01),Rural,Youth (15-24),112782,58490,54292,231,100173,51616,26806,12298,14508,1029
14,272,District - Senapati (01),Urban,All Ages,7476,3720,3756,3,5655,2778,1977,837,1140,11
14,272,District - Senapati (01),Urban,10-14,913,474,439,0,672,346,35,13,22,0
14,272,District - Senapati (01),Urban,15-19,862,428,434,0,666,336,23,4,19,1
14,272,District - Senapati (01),Urban,20-24,765,369,396,0,603,282,35,9,26,2
14,272,District - Senapati (01),Urban,Adolescent (10-19),1775,902,873,0,1338,682,58,17,41,1
14,272,District - Senapati (01),Urban,Youth (15-24),1627,797,830,0,1269,618,58,13,45,3
14,273,District - Tamenglong (02),Total,All Ages,140651,72371,68280,22,134626,68226,55645,24968,30677,1023
14,273,District - Tamenglong (02),Total,10-14,16618,8635,7983,3,16174,8398,3330,1659,1671,19
14,273,District - Tamenglong (02),Total,15-19,16380,8277,8103,0,15958,8067,2398,1120,1278,68
14,273,District - Tamenglong (02),Total,20-24,15139,7721,7418,1,14493,7262,2709,1190,1519,122
14,273,District - Tamenglong (02),Total,Adolescent (10-19),32998,16912,16086,3,32132,16465,5728,2779,2949,87
14,273,District - Tamenglong (02),Total,Youth (15-24),31519,15998,15521,1,30451,15329,5107,2310,2797,190
14,273,District - Tamenglong (02),Rural,All Ages,121288,62534,58754,18,116023,58989,50786,22805,27981,955
14,273,District - Tamenglong (02),Rural,10-14,14009,7335,6674,2,13618,7130,3062,1521,1541,19
14,273,District - Tamenglong (02),Rural,15-19,14115,7193,6922,0,13732,7003,2325,1087,1238,68
14,273,District - Tamenglong (02),Rural,20-24,13194,6746,6448,1,12630,6354,2636,1163,1473,121
14,273,District - Tamenglong (02),Rural,Adolescent (10-19),28124,14528,13596,2,27350,14133,5387,2608,2779,87
14,273,District - Tamenglong (02),Rural,Youth (15-24),27309,13939,13370,1,26362,13357,4961,2250,2711,189
14,273,District - Tamenglong (02),Urban,All Ages,19363,9837,9526,4,18603,9237,4859,2163,2696,68
14,273,District - Tamenglong (02),Urban,10-14,2609,1300,1309,1,2556,1268,268,138,130,0
14,273,District - Tamenglong (02),Urban,15-19,2265,1084,1181,0,2226,1064,73,33,40,0
14,273,District - Tamenglong (02),Urban,20-24,1945,975,970,0,1863,908,73,27,46,1
14,273,District - Tamenglong (02),Urban,Adolescent (10-19),4874,2384,2490,1,4782,2332,341,171,170,0
14,273,District - Tamenglong (02),Urban,Youth (15-24),4210,2059,2151,0,4089,1972,146,60,86,1
14,274,District - Churachandpur (03),Total,All Ages,274143,138820,135323,443,254787,126328,78208,34807,43401,3885
14,274,District - Churachandpur (03),Total,10-14,30003,15361,14642,48,28427,14531,3006,1505,1501,49
14,274,District - Churachandpur (03),Total,15-19,29608,14599,15009,44,28124,13792,2362,1047,1315,266
14,274,District - Churachandpur (03),Total,20-24,29144,14563,14581,28,26505,12643,2735,1060,1675,514
14,274,District - Churachandpur (03),Total,Adolescent (10-19),59611,29960,29651,92,56551,28323,5368,2552,2816,315
14,274,District - Churachandpur (03),Total,Youth (15-24),58752,29162,29590,72,54629,26435,5097,2107,2990,780
14,274,District - Churachandpur (03),Rural,All Ages,255786,129659,126127,424,240718,119591,74268,33155,41113,3813
14,274,District - Churachandpur (03),Rural,10-14,28151,14420,13731,47,26975,13792,2868,1442,1426,49
14,274,District - Churachandpur (03),Rural,15-19,27740,13680,14060,42,26603,13042,2291,1021,1270,258
14,274,District - Churachandpur (03),Rural,20-24,27348,13671,13677,26,25128,11984,2630,1016,1614,505
14,274,District - Churachandpur (03),Rural,Adolescent (10-19),55891,28100,27791,89,53578,26834,5159,2463,2696,307
14,274,District - Churachandpur (03),Rural,Youth (15-24),55088,27351,27737,68,51731,25026,4921,2037,2884,763
14,274,District - Churachandpur (03),Urban,All Ages,18357,9161,9196,19,14069,6737,3940,1652,2288,72
14,274,District - Churachandpur (03),Urban,10-14,1852,941,911,1,1452,739,138,63,75,0
14,274,District - Churachandpur (03),Urban,15-19,1868,919,949,2,1521,750,71,26,45,8
14,274,District - Churachandpur (03),Urban,20-24,1796,892,904,2,1377,659,105,44,61,9
14,274,District - Churachandpur (03),Urban,Adolescent (10-19),3720,1860,1860,3,2973,1489,209,89,120,8
14,274,District - Churachandpur (03),Urban,Youth (15-24),3664,1811,1853,4,2898,1409,176,70,106,17
14,275,District - Bishnupur (04),Total,All Ages,237399,118782,118617,22113,3287,1625,81066,31469,49597,4745
14,275,District - Bishnupur (04),Total,10-14,25466,13058,12408,2195,340,174,2488,1080,1408,36
14,275,District - Bishnupur (04),Total,15-19,20847,10381,10466,1760,365,165,1878,612,1266,183
14,275,District - Bishnupur (04),Total,20-24,21058,10253,10805,1945,324,168,2558,712,1846,483
14,275,District - Bishnupur (04),Total,Adolescent (10-19),46313,23439,22874,3955,705,339,4366,1692,2674,219
14,275,District - Bishnupur (04),Total,Youth (15-24),41905,20634,21271,3705,689,333,4436,1324,3112,666
14,275,District - Bishnupur (04),Rural,All Ages,149894,75171,74723,21834,1512,766,54336,21140,33196,3027
14,275,District - Bishnupur (04),Rural,10-14,16398,8444,7954,2157,155,78,1697,737,960,16
14,275,District - Bishnupur (04),Rural,15-19,13293,6640,6653,1734,176,80,1273,412,861,126
14,275,District - Bishnupur (04),Rural,20-24,13269,6483,6786,1916,154,84,1790,507,1283,314
14,275,District - Bishnupur (04),Rural,Adolescent (10-19),29691,15084,14607,3891,331,158,2970,1149,1821,142
14,275,District - Bishnupur (04),Rural,Youth (15-24),26562,13123,13439,3650,330,164,3063,919,2144,440
14,275,District - Bishnupur (04),Urban,All Ages,87505,43611,43894,279,1775,859,26730,10329,16401,1718
14,275,District - Bishnupur (04),Urban,10-14,9068,4614,4454,38,185,96,791,343,448,20
14,275,District - Bishnupur (04),Urban,15-19,7554,3741,3813,26,189,85,605,200,405,57
14,275,District - Bishnupur (04),Urban,20-24,7789,3770,4019,29,170,84,768,205,563,169
14,275,District - Bishnupur (04),Urban,Adolescent (10-19),16622,8355,8267,64,374,181,1396,543,853,77
14,275,District - Bishnupur (04),Urban,Youth (15-24),15343,7511,7832,55,359,169,1373,405,968,226
14,276,District - Thoubal (05),Total,All Ages,422168,210845,211323,40593,1808,929,152864,58228,94636,12151
14,276,District - Thoubal (05),Total,10-14,47934,24405,23529,4101,179,104,5016,2211,2805,98
14,276,District - Thoubal (05),Total,15-19,39220,19397,19823,3105,161,74,3780,1204,2576,506
14,276,District - Thoubal (05),Total,20-24,38265,18605,19660,3091,231,140,4836,1258,3578,1294
14,276,District - Thoubal (05),Total,Adolescent (10-19),87154,43802,43352,7206,340,178,8796,3415,5381,604
14,276,District - Thoubal (05),Total,Youth (15-24),77485,38002,39483,6196,392,214,8616,2462,6154,1800
14,276,District - Thoubal (05),Rural,All Ages,270835,135470,135365,4397,853,406,106465,40756,65709,8816
14,276,District - Thoubal (05),Rural,10-14,31711,16240,15471,512,80,43,3864,1723,2141,93
14,276,District - Thoubal (05),Rural,15-19,25692,12739,12953,382,102,48,3015,959,2056,422
14,276,District - Thoubal (05),Rural,20-24,24538,11927,12611,387,110,58,3818,985,2833,1020
14,276,District - Thoubal (05),Rural,Adolescent (10-19),57403,28979,28424,894,182,91,6879,2682,4197,515
14,276,District - Thoubal (05),Rural,Youth (15-24),50230,24666,25564,769,212,106,6833,1944,4889,1442
14,276,District - Thoubal (05),Urban,All Ages,151333,75375,75958,36196,955,523,46399,17472,28927,3335
14,276,District - Thoubal (05),Urban,10-14,16223,8165,8058,3589,99,61,1152,488,664,5
14,276,District - Thoubal (05),Urban,15-19,13528,6658,6870,2723,59,26,765,245,520,84
14,276,District - Thoubal (05),Urban,20-24,13727,6678,7049,2704,121,82,1018,273,745,274
14,276,District - Thoubal (05),Urban,Adolescent (10-19),29751,14823,14928,6312,158,87,1917,733,1184,89
14,276,District - Thoubal (05),Urban,Youth (15-24),27255,13336,13919,5427,180,108,1783,518,1265,358
14,277,District - Imphal West (06),Total,All Ages,517992,255054,262938,16530,24161,11560,125366,49069,76297,5044
14,277,District - Imphal West (06),Total,10-14,49402,25195,24207,1593,2502,1261,2902,1405,1497,40
14,277,District - Imphal West (06),Total,15-19,43346,21712,21634,1551,2626,1260,1701,650,1051,172
14,277,District - Imphal West (06),Total,20-24,47328,22876,24452,1798,2697,1332,2383,785,1598,444
14,277,District - Imphal West (06),Total,Adolescent (10-19),92748,46907,45841,3144,5128,2521,4603,2055,2548,212
14,277,District - Imphal West (06),Total,Youth (15-24),90674,44588,46086,3349,5323,2592,4084,1435,2649,616
14,277,District - Imphal West (06),Rural,All Ages,195113,96948,98165,11711,4240,2037,55722,21979,33743,2756
14,277,District - Imphal West (06),Rural,10-14,20328,10487,9841,1187,494,262,1424,686,738,26
14,277,District - Imphal West (06),Rural,15-19,16950,8567,8383,980,534,244,860,337,523,95
14,277,District - Imphal West (06),Rural,20-24,17989,8696,9293,1184,426,208,1273,420,853,226
14,277,District - Imphal West (06),Rural,Adolescent (10-19),37278,19054,18224,2167,1028,506,2284,1023,1261,121
14,277,District - Imphal West (06),Rural,Youth (15-24),34939,17263,17676,2164,960,452,2133,757,1376,321
14,277,District - Imphal West (06),Urban,All Ages,322879,158106,164773,4819,19921,9523,69644,27090,42554,2288
14,277,District - Imphal West (06),Urban,10-14,29074,14708,14366,406,2008,999,1478,719,759,14
14,277,District - Imphal West (06),Urban,15-19,26396,13145,13251,571,2092,1016,841,313,528,77
14,277,District - Imphal West (06),Urban,20-24,29339,14180,15159,614,2271,1124,1110,365,745,218
14,277,District - Imphal West (06),Urban,Adolescent (10-19),55470,27853,27617,977,4100,2015,2319,1032,1287,91
14,277,District - Imphal West (06),Urban,Youth (15-24),55735,27325,28410,1185,4363,2140,1951,678,1273,295
14,278,District - Imphal East (07),Total,All Ages,456113,226094,230019,15839,27657,13500,131449,52780,78669,9398
14,278,District - Imphal East (07),Total,10-14,46783,23501,23282,1804,2981,1483,4322,2029,2293,78
14,278,District - Imphal East (07),Total,15-19,41628,20577,21051,1593,3031,1431,3265,1254,2011,419
14,278,District - Imphal East (07),Total,20-24,42651,20493,22158,1589,2988,1468,4003,1336,2667,993
14,278,District - Imphal East (07),Total,Adolescent (10-19),88411,44078,44333,3397,6012,2914,7587,3283,4304,497
14,278,District - Imphal East (07),Total,Youth (15-24),84279,41070,43209,3182,6019,2899,7268,2590,4678,1412
14,278,District - Imphal East (07),Rural,All Ages,272906,136789,136117,7815,10601,5356,89025,35852,53173,7843
14,278,District - Imphal East (07),Rural,10-14,29363,14782,14581,900,1260,640,3224,1489,1735,66
14,278,District - Imphal East (07),Rural,15-19,25310,12540,12770,755,1106,552,2498,934,1564,372
14,278,District - Imphal East (07),Rural,20-24,25235,12191,13044,782,1069,525,3093,1035,2058,840
14,278,District - Imphal East (07),Rural,Adolescent (10-19),54673,27322,27351,1655,2366,1192,5722,2423,3299,438
14,278,District - Imphal East (07),Rural,Youth (15-24),50545,24731,25814,1537,2175,1077,5591,1969,3622,1212
14,278,District - Imphal East (07),Urban,All Ages,183207,89305,93902,8024,17056,8144,42424,16928,25496,1555
14,278,District - Imphal East (07),Urban,10-14,17420,8719,8701,904,1721,843,1098,540,558,12
14,278,District - Imphal East (07),Urban,15-19,16318,8037,8281,838,1925,879,767,320,447,47
14,278,District - Imphal East (07),Urban,20-24,17416,8302,9114,807,1919,943,910,301,609,153
14,278,District - Imphal East (07),Urban,Adolescent (10-19),33738,16756,16982,1742,3646,1722,1865,860,1005,59
14,278,District - Imphal East (07),Urban,Youth (15-24),33734,16339,17395,1645,3844,1822,1677,621,1056,200
14,279,District - Ukhrul (08),Total,All Ages,183998,94718,89280,248,173606,87970,54169,24570,29599,1542
14,279,District - Ukhrul (08),Total,10-14,22670,11826,10844,25,21758,11345,2795,1442,1353,17
14,279,District - Ukhrul (08),Total,15-19,20370,10424,9946,34,19638,10000,1250,603,647,58
14,279,District - Ukhrul (08),Total,20-24,18265,9302,8963,22,17144,8586,1487,671,816,135
14,279,District - Ukhrul (08),Total,Adolescent (10-19),43040,22250,20790,59,41396,21345,4045,2045,2000,75
14,279,District - Ukhrul (08),Total,Youth (15-24),38635,19726,18909,56,36782,18586,2737,1274,1463,193
14,279,District - Ukhrul (08),Rural,All Ages,156811,80801,76010,154,149501,75970,48167,21823,26344,1371
14,279,District - Ukhrul (08),Rural,10-14,18980,9882,9098,16,18370,9561,2471,1289,1182,17
14,279,District - Ukhrul (08),Rural,15-19,17020,8739,8281,29,16518,8458,1143,555,588,46
14,279,District - Ukhrul (08),Rural,20-24,15660,7963,7697,15,14865,7439,1369,619,750,115
14,279,District - Ukhrul (08),Rural,Adolescent (10-19),36000,18621,17379,45,34888,18019,3614,1844,1770,63
14,279,District - Ukhrul (08),Rural,Youth (15-24),32680,16702,15978,44,31383,15897,2512,1174,1338,161
14,279,District - Ukhrul (08),Urban,All Ages,27187,13917,13270,94,24105,12000,6002,2747,3255,171
14,279,District - Ukhrul (08),Urban,10-14,3690,1944,1746,9,3388,1784,324,153,171,0
14,279,District - Ukhrul (08),Urban,15-19,3350,1685,1665,5,3120,1542,107,48,59,12
14,279,District - Ukhrul (08),Urban,20-24,2605,1339,1266,7,2279,1147,118,52,66,20
14,279,District - Ukhrul (08),Urban,Adolescent (10-19),7040,3629,3411,14,6508,3326,431,201,230,12
14,279,District - Ukhrul (08),Urban,Youth (15-24),5955,3024,2931,12,5399,2689,225,100,125,32
14,280,District - Chandel (09),Total,All Ages,144182,74579,69603,540,128280,63622,53880,23526,30354,2782
14,280,District - Chandel (09),Total,10-14,15007,7666,7341,52,13769,7004,2732,1307,1425,34
14,280,District - Chandel (09),Total,15-19,15758,7888,7870,49,14601,7303,1994,844,1150,149
14,280,District - Chandel (09),Total,20-24,15374,7727,7647,48,13570,6418,2644,983,1661,340
14,280,District - Chandel (09),Total,Adolescent (10-19),30765,15554,15211,101,28370,14307,4726,2151,2575,183
14,280,District - Chandel (09),Total,Youth (15-24),31132,15615,15517,97,28171,13721,4638,1827,2811,489
14,280,District - Chandel (09),Rural,All Ages,127335,65909,61426,499,118805,59000,47318,20766,26552,2599
14,280,District - Chandel (09),Rural,10-14,12935,6599,6336,49,12548,6390,2429,1175,1254,30
14,280,District - Chandel (09),Rural,15-19,13930,6996,6934,43,13530,6790,1763,766,997,144
14,280,District - Chandel (09),Rural,20-24,13713,6868,6845,43,12682,6011,2372,889,1483,326
14,280,District - Chandel (09),Rural,Adolescent (10-19),26865,13595,13270,92,26078,13180,4192,1941,2251,174
14,280,District - Chandel (09),Rural,Youth (15-24),27643,13864,13779,86,26212,12801,4135,1655,2480,470
14,280,District - Chandel (09),Urban,All Ages,16847,8670,8177,41,9475,4622,6562,2760,3802,183
14,280,District - Chandel (09),Urban,10-14,2072,1067,1005,3,1221,614,303,132,171,4
14,280,District - Chandel (09),Urban,15-19,1828,892,936,6,1071,513,231,78,153,5
14,280,District - Chandel (09),Urban,20-24,1661,859,802,5,888,407,272,94,178,14
14,280,District - Chandel (09),Urban,Adolescent (10-19),3900,1959,1941,9,2292,1127,534,210,324,9
14,280,District - Chandel (09),Urban,Youth (15-24),3489,1751,1738,11,1959,920,503,172,331,19
15,0,State - MIZORAM (15),Total,All Ages,1097206,555339,541867,1218,1036115,516294,249031,116810,132221,26464
15,0,State - MIZORAM (15),Total,10-14,116981,59526,57455,99,112063,56893,6658,2894,3764,211
15,0,State - MIZORAM (15),Total,15-19,110343,55907,54436,106,105282,52981,6195,2395,3800,2145
15,0,State - MIZORAM (15),Total,20-24,111708,55512,56196,144,104992,51237,8465,3040,5425,3905
15,0,State - MIZORAM (15),Total,Adolescent (10-19),227324,115433,111891,205,217345,109874,12853,5289,7564,2356
15,0,State - MIZORAM (15),Total,Youth (15-24),222051,111419,110632,250,210274,104218,14660,5435,9225,6050
15,0,State - MIZORAM (15),Rural,All Ages,525435,269135,256300,298,507467,257987,162101,73735,88366,12448
15,0,State - MIZORAM (15),Rural,10-14,60088,30836,29252,23,58401,29927,5923,2500,3423,114
15,0,State - MIZORAM (15),Rural,15-19,50257,26000,24257,23,48879,25210,5641,2115,3526,1153
15,0,State - MIZORAM (15),Rural,20-24,50969,25314,25655,36,49312,24303,7727,2646,5081,1941
15,0,State - MIZORAM (15),Rural,Adolescent (10-19),110345,56836,53509,46,107280,55137,11564,4615,6949,1267
15,0,State - MIZORAM (15),Rural,Youth (15-24),101226,51314,49912,59,98191,49513,13368,4761,8607,3094
15,0,State - MIZORAM (15),Urban,All Ages,571771,286204,285567,920,528648,258307,86930,43075,43855,14016
15,0,State - MIZORAM (15),Urban,10-14,56893,28690,28203,76,53662,26966,735,394,341,97
15,0,State - MIZORAM (15),Urban,15-19,60086,29907,30179,83,56403,27771,554,280,274,992
15,0,State - MIZORAM (15),Urban,20-24,60739,30198,30541,108,55680,26934,738,394,344,1964
15,0,State - MIZORAM (15),Urban,Adolescent (10-19),116979,58597,58382,159,110065,54737,1289,674,615,1089
15,0,State - MIZORAM (15),Urban,Youth (15-24),120825,60105,60720,191,112083,54705,1292,674,618,2956
15,281,District - Mamit (01),Total,All Ages,86364,44828,41536,51,82080,42075,26173,11851,14322,1963
15,281,District - Mamit (01),Total,10-14,9713,5140,4573,3,9332,4921,732,276,456,24
15,281,District - Mamit (01),Total,15-19,8328,4325,4003,4,8004,4156,900,325,575,196
15,281,District - Mamit (01),Total,20-24,8241,4065,4176,2,7903,3861,1165,386,779,301
15,281,District - Mamit (01),Total,Adolescent (10-19),18041,9465,8576,7,17336,9077,1632,601,1031,220
15,281,District - Mamit (01),Total,Youth (15-24),16569,8390,8179,6,15907,8017,2065,711,1354,497
15,281,District - Mamit (01),Rural,All Ages,71465,37135,34330,38,68096,34999,23291,10403,12888,1146
15,281,District - Mamit (01),Rural,10-14,8162,4274,3888,2,7850,4103,699,254,445,21
15,281,District - Mamit (01),Rural,15-19,6936,3603,3333,4,6687,3475,842,301,541,146
15,281,District - Mamit (01),Rural,20-24,6775,3338,3437,2,6517,3185,1098,353,745,190
15,281,District - Mamit (01),Rural,Adolescent (10-19),15098,7877,7221,6,14537,7578,1541,555,986,167
15,281,District - Mamit (01),Rural,Youth (15-24),13711,6941,6770,6,13204,6660,1940,654,1286,336
15,281,District - Mamit (01),Urban,All Ages,14899,7693,7206,13,13984,7076,2882,1448,1434,817
15,281,District - Mamit (01),Urban,10-14,1551,866,685,1,1482,818,33,22,11,3
15,281,District - Mamit (01),Urban,15-19,1392,722,670,0,1317,681,58,24,34,50
15,281,District - Mamit (01),Urban,20-24,1466,727,739,0,1386,676,67,33,34,111
15,281,District - Mamit (01),Urban,Adolescent (10-19),2943,1588,1355,1,2799,1499,91,46,45,53
15,281,District - Mamit (01),Urban,Youth (15-24),2858,1449,1409,0,2703,1357,125,57,68,161
15,282,District - Kolasib (02),Total,All Ages,83955,42918,41037,84,73609,36917,18060,8771,9289,3341
15,282,District - Kolasib (02),Total,10-14,9029,4559,4470,7,7914,3956,357,180,177,74
15,282,District - Kolasib (02),Total,15-19,8104,4078,4026,4,7205,3602,331,138,193,304
15,282,District - Kolasib (02),Total,20-24,8232,4111,4121,15,7229,3546,464,158,306,476
15,282,District - Kolasib (02),Total,Adolescent (10-19),17133,8637,8496,11,15119,7558,688,318,370,378
15,282,District - Kolasib (02),Total,Youth (15-24),16336,8189,8147,19,14434,7148,795,296,499,780
15,282,District - Kolasib (02),Rural,All Ages,37077,19097,17980,17,32582,16585,9807,4710,5097,1275
15,282,District - Kolasib (02),Rural,10-14,4102,2085,2017,1,3563,1794,258,125,133,22
15,282,District - Kolasib (02),Rural,15-19,3518,1794,1724,1,3124,1576,252,98,154,136
15,282,District - Kolasib (02),Rural,20-24,3498,1723,1775,5,3108,1520,325,103,222,173
15,282,District - Kolasib (02),Rural,Adolescent (10-19),7620,3879,3741,2,6687,3370,510,223,287,158
15,282,District - Kolasib (02),Rural,Youth (15-24),7016,3517,3499,6,6232,3096,577,201,376,309
15,282,District - Kolasib (02),Urban,All Ages,46878,23821,23057,67,41027,20332,8253,4061,4192,2066
15,282,District - Kolasib (02),Urban,10-14,4927,2474,2453,6,4351,2162,99,55,44,52
15,282,District - Kolasib (02),Urban,15-19,4586,2284,2302,3,4081,2026,79,40,39,168
15,282,District - Kolasib (02),Urban,20-24,4734,2388,2346,10,4121,2026,139,55,84,303
15,282,District - Kolasib (02),Urban,Adolescent (10-19),9513,4758,4755,9,8432,4188,178,95,83,220
15,282,District - Kolasib (02),Urban,Youth (15-24),9320,4672,4648,13,8202,4052,218,95,123,471
15,283,District - Aizawl (03),Total,All Ages,400309,199270,201039,627,373542,182517,59714,29723,29991,8176
15,283,District - Aizawl (03),Total,10-14,38075,19167,18908,54,36043,18072,525,276,249,32
15,283,District - Aizawl (03),Total,15-19,41116,20608,20508,68,38668,19178,301,156,145,619
15,283,District - Aizawl (03),Total,20-24,42733,21187,21546,76,39442,19148,378,219,159,1178
15,283,District - Aizawl (03),Total,Adolescent (10-19),79191,39775,39416,122,74711,37250,826,432,394,651
15,283,District - Aizawl (03),Total,Youth (15-24),83849,41795,42054,144,78110,38326,679,375,304,1797
15,283,District - Aizawl (03),Rural,All Ages,85555,43780,41775,46,83343,42249,15780,7866,7914,3781
15,283,District - Aizawl (03),Rural,10-14,8835,4537,4298,0,8666,4436,206,118,88,16
15,283,District - Aizawl (03),Rural,15-19,7683,4035,3648,2,7560,3954,66,28,38,259
15,283,District - Aizawl (03),Rural,20-24,7955,4075,3880,6,7722,3904,77,33,44,538
15,283,District - Aizawl (03),Rural,Adolescent (10-19),16518,8572,7946,2,16226,8390,272,146,126,275
15,283,District - Aizawl (03),Rural,Youth (15-24),15638,8110,7528,8,15282,7858,143,61,82,797
15,283,District - Aizawl (03),Urban,All Ages,314754,155490,159264,581,290199,140268,43934,21857,22077,4395
15,283,District - Aizawl (03),Urban,10-14,29240,14630,14610,54,27377,13636,319,158,161,16
15,283,District - Aizawl (03),Urban,15-19,33433,16573,16860,66,31108,15224,235,128,107,360
15,283,District - Aizawl (03),Urban,20-24,34778,17112,17666,70,31720,15244,301,186,115,640
15,283,District - Aizawl (03),Urban,Adolescent (10-19),62673,31203,31470,120,58485,28860,554,286,268,376
15,283,District - Aizawl (03),Urban,Youth (15-24),68211,33685,34526,136,62828,30468,536,314,222,1000
15,284,District - Champhai (04),Total,All Ages,125745,63388,62357,17,123466,61954,24943,11948,12995,3698
15,284,District - Champhai (04),Total,10-14,13755,6918,6837,0,13556,6821,188,96,92,28
15,284,District - Champhai (04),Total,15-19,12405,6331,6074,0,12222,6220,105,54,51,365
15,284,District - Champhai (04),Total,20-24,11855,5935,5920,2,11604,5778,139,64,75,603
15,284,District - Champhai (04),Total,Adolescent (10-19),26160,13249,12911,0,25778,13041,293,150,143,393
15,284,District - Champhai (04),Total,Youth (15-24),24260,12266,11994,2,23826,11998,244,118,126,968
15,284,District - Champhai (04),Rural,All Ages,77216,39110,38106,10,75747,38217,16194,7730,8464,1747
15,284,District - Champhai (04),Rural,10-14,8698,4332,4366,0,8561,4266,128,66,62,16
15,284,District - Champhai (04),Rural,15-19,7503,3874,3629,0,7376,3793,75,40,35,206
15,284,District - Champhai (04),Rural,20-24,7151,3593,3558,2,7002,3512,101,50,51,323
15,284,District - Champhai (04),Rural,Adolescent (10-19),16201,8206,7995,0,15937,8059,203,106,97,222
15,284,District - Champhai (04),Rural,Youth (15-24),14654,7467,7187,2,14378,7305,176,90,86,529
15,284,District - Champhai (04),Urban,All Ages,48529,24278,24251,7,47719,23737,8749,4218,4531,1951
15,284,District - Champhai (04),Urban,10-14,5057,2586,2471,0,4995,2555,60,30,30,12
15,284,District - Champhai (04),Urban,15-19,4902,2457,2445,0,4846,2427,30,14,16,159
15,284,District - Champhai (04),Urban,20-24,4704,2342,2362,0,4602,2266,38,14,24,280
15,284,District - Champhai (04),Urban,Adolescent (10-19),9959,5043,4916,0,9841,4982,90,44,46,171
15,284,District - Champhai (04),Urban,Youth (15-24),9606,4799,4807,0,9448,4693,68,28,40,439
15,285,District - Serchhip (05),Total,All Ages,64937,32851,32086,32,62889,31381,10461,5253,5208,1006
15,285,District - Serchhip (05),Total,10-14,7072,3486,3586,3,6940,3423,54,30,24,4
15,285,District - Serchhip (05),Total,15-19,6634,3377,3257,3,6508,3300,36,19,17,63
15,285,District - Serchhip (05),Total,20-24,6529,3357,3172,4,6309,3193,38,23,15,145
15,285,District - Serchhip (05),Total,Adolescent (10-19),13706,6863,6843,6,13448,6723,90,49,41,67
15,285,District - Serchhip (05),Total,Youth (15-24),13163,6734,6429,7,12817,6493,74,42,32,208
15,285,District - Serchhip (05),Rural,All Ages,32918,16643,16275,13,32474,16368,5824,2896,2928,293
15,285,District - Serchhip (05),Rural,10-14,3584,1789,1795,0,3539,1767,26,11,15,1
15,285,District - Serchhip (05),Rural,15-19,3304,1714,1590,3,3258,1682,18,8,10,28
15,285,District - Serchhip (05),Rural,20-24,3359,1703,1656,2,3313,1677,25,15,10,55
15,285,District - Serchhip (05),Rural,Adolescent (10-19),6888,3503,3385,3,6797,3449,44,19,25,29
15,285,District - Serchhip (05),Rural,Youth (15-24),6663,3417,3246,5,6571,3359,43,23,20,83
15,285,District - Serchhip (05),Urban,All Ages,32019,16208,15811,19,30415,15013,4637,2357,2280,713
15,285,District - Serchhip (05),Urban,10-14,3488,1697,1791,3,3401,1656,28,19,9,3
15,285,District - Serchhip (05),Urban,15-19,3330,1663,1667,0,3250,1618,18,11,7,35
15,285,District - Serchhip (05),Urban,20-24,3170,1654,1516,2,2996,1516,13,8,5,90
15,285,District - Serchhip (05),Urban,Adolescent (10-19),6818,3360,3458,3,6651,3274,46,30,16,38
15,285,District - Serchhip (05),Urban,Youth (15-24),6500,3317,3183,2,6246,3134,31,19,12,125
15,286,District - Lunglei (06),Total,All Ages,161428,82891,78537,178,153533,77180,40306,18376,21930,6625
15,286,District - Lunglei (06),Total,10-14,18105,9274,8831,14,17638,9027,1066,420,646,43
15,286,District - Lunglei (06),Total,15-19,15738,8028,7710,5,15243,7733,1157,365,792,461
15,286,District - Lunglei (06),Total,20-24,15847,7946,7901,15,15045,7371,1761,580,1181,926
15,286,District - Lunglei (06),Total,Adolescent (10-19),33843,17302,16541,19,32881,16760,2223,785,1438,504
15,286,District - Lunglei (06),Total,Youth (15-24),31585,15974,15611,20,30288,15104,2918,945,1973,1387
15,286,District - Lunglei (06),Rural,All Ages,92676,47577,45099,65,91310,46663,30562,13510,17052,2761
15,286,District - Lunglei (06),Rural,10-14,10879,5630,5249,9,10782,5568,986,380,606,33
15,286,District - Lunglei (06),Rural,15-19,8661,4490,4171,4,8571,4441,1106,343,763,254
15,286,District - Lunglei (06),Rural,20-24,8915,4428,4487,4,8814,4371,1684,539,1145,417
15,286,District - Lunglei (06),Rural,Adolescent (10-19),19540,10120,9420,13,19353,10009,2092,723,1369,287
15,286,District - Lunglei (06),Rural,Youth (15-24),17576,8918,8658,8,17385,8812,2790,882,1908,671
15,286,District - Lunglei (06),Urban,All Ages,68752,35314,33438,113,62223,30517,9744,4866,4878,3864
15,286,District - Lunglei (06),Urban,10-14,7226,3644,3582,5,6856,3459,80,40,40,10
15,286,District - Lunglei (06),Urban,15-19,7077,3538,3539,1,6672,3292,51,22,29,207
15,286,District - Lunglei (06),Urban,20-24,6932,3518,3414,11,6231,3000,77,41,36,509
15,286,District - Lunglei (06),Urban,Adolescent (10-19),14303,7182,7121,6,13528,6751,131,62,69,217
15,286,District - Lunglei (06),Urban,Youth (15-24),14009,7056,6953,12,12903,6292,128,63,65,716
15,287,District - Lawngtlai (07),Total,All Ages,117894,60599,57295,146,112354,57044,55033,24155,30878,1463
15,287,District - Lawngtlai (07),Total,10-14,14358,7511,6847,12,13901,7272,3439,1442,1997,5
15,287,District - Lawngtlai (07),Total,15-19,11840,6059,5781,10,11421,5814,3171,1236,1935,127
15,287,District - Lawngtlai (07),Total,20-24,12457,6051,6406,15,11893,5674,4263,1474,2789,254
15,287,District - Lawngtlai (07),Total,Adolescent (10-19),26198,13570,12628,22,25322,13086,6610,2678,3932,132
15,287,District - Lawngtlai (07),Total,Youth (15-24),24297,12110,12187,25,23314,11488,7434,2710,4724,381
15,287,District - Lawngtlai (07),Rural,All Ages,97064,49940,47124,97,92877,47356,51142,22296,28846,1350
15,287,District - Lawngtlai (07),Rural,10-14,12005,6280,5725,11,11633,6090,3398,1423,1975,5
15,287,District - Lawngtlai (07),Rural,15-19,9602,4940,4662,8,9273,4754,3138,1223,1915,122
15,287,District - Lawngtlai (07),Rural,20-24,10203,4924,5279,12,9795,4663,4222,1458,2764,235
15,287,District - Lawngtlai (07),Rural,Adolescent (10-19),21607,11220,10387,19,20906,10844,6536,2646,3890,127
15,287,District - Lawngtlai (07),Rural,Youth (15-24),19805,9864,9941,20,19068,9417,7360,2681,4679,357
15,287,District - Lawngtlai (07),Urban,All Ages,20830,10659,10171,49,19477,9688,3891,1859,2032,113
15,287,District - Lawngtlai (07),Urban,10-14,2353,1231,1122,1,2268,1182,41,19,22,0
15,287,District - Lawngtlai (07),Urban,15-19,2238,1119,1119,2,2148,1060,33,13,20,5
15,287,District - Lawngtlai (07),Urban,20-24,2254,1127,1127,3,2098,1011,41,16,25,19
15,287,District - Lawngtlai (07),Urban,Adolescent (10-19),4591,2350,2241,3,4416,2242,74,32,42,5
15,287,District - Lawngtlai (07),Urban,Youth (15-24),4492,2246,2246,5,4246,2071,74,29,45,24
15,288,District - Saiha (08),Total,All Ages,56574,28594,27980,83,54642,27226,14341,6733,7608,192
15,288,District - Saiha (08),Total,10-14,6874,3471,3403,6,6739,3401,297,174,123,1
15,288,District - Saiha (08),Total,15-19,6178,3101,3077,12,6011,2978,194,102,92,10
15,288,District - Saiha (08),Total,20-24,5814,2860,2954,15,5567,2666,257,136,121,22
15,288,District - Saiha (08),Total,Adolescent (10-19),13052,6572,6480,18,12750,6379,491,276,215,11
15,288,District - Saiha (08),Total,Youth (15-24),11992,5961,6031,27,11578,5644,451,238,213,32
15,288,District - Saiha (08),Rural,All Ages,31464,15853,15611,12,31038,15550,9501,4324,5177,95
15,288,District - Saiha (08),Rural,10-14,3823,1909,1914,0,3807,1903,222,123,99,0
15,288,District - Saiha (08),Rural,15-19,3050,1550,1500,1,3030,1535,144,74,70,2
15,288,District - Saiha (08),Rural,20-24,3113,1530,1583,3,3041,1471,195,95,100,10
15,288,District - Saiha (08),Rural,Adolescent (10-19),6873,3459,3414,1,6837,3438,366,197,169,2
15,288,District - Saiha (08),Rural,Youth (15-24),6163,3080,3083,4,6071,3006,339,169,170,12
15,288,District - Saiha (08),Urban,All Ages,25110,12741,12369,71,23604,11676,4840,2409,2431,97
15,288,District - Saiha (08),Urban,10-14,3051,1562,1489,6,2932,1498,75,51,24,1
15,288,District - Saiha (08),Urban,15-19,3128,1551,1577,11,2981,1443,50,28,22,8
15,288,District - Saiha (08),Urban,20-24,2701,1330,1371,12,2526,1195,62,41,21,12
15,288,District - Saiha (08),Urban,Adolescent (10-19),6179,3113,3066,17,5913,2941,125,79,46,9
15,288,District - Saiha (08),Urban,Youth (15-24),5829,2881,2948,23,5507,2638,112,69,43,20
16,0,State - TRIPURA (16),Total,All Ages,3673917,1874376,1799541,654918,1166813,588327,869134,373007,496127,201863
16,0,State - TRIPURA (16),Total,10-14,357690,183001,174689,61860,136884,70019,13071,5888,7183,827
16,0,State - TRIPURA (16),Total,15-19,357829,181136,176693,66388,124441,62128,17313,6112,11201,8835
16,0,State - TRIPURA (16),Total,20-24,373177,183779,189398,70858,118908,56170,24346,7901,16445,23880
16,0,State - TRIPURA (16),Total,Adolescent (10-19),715519,364137,351382,128248,261325,132147,30384,12000,18384,9662
16,0,State - TRIPURA (16),Total,Youth (15-24),731006,364915,366091,137246,243349,118298,41659,14013,27646,32715
16,0,State - TRIPURA (16),Rural,All Ages,2712464,1387173,1325291,437993,1117566,563908,719691,305670,414021,191928
16,0,State - TRIPURA (16),Rural,10-14,282994,144904,138090,42968,131530,67424,11676,5139,6537,799
16,0,State - TRIPURA (16),Rural,15-19,274888,139377,135511,45065,118720,59342,15471,5264,10207,8525
16,0,State - TRIPURA (16),Rural,20-24,280876,138466,142410,47511,113848,53795,21800,6834,14966,22977
16,0,State - TRIPURA (16),Rural,Adolescent (10-19),557882,284281,273601,88033,250250,126766,27147,10403,16744,9324
16,0,State - TRIPURA (16),Rural,Youth (15-24),555764,277843,277921,92576,232568,113137,37271,12098,25173,31502
16,0,State - TRIPURA (16),Urban,All Ages,961453,487203,474250,216925,49247,24419,149443,67337,82106,9935
16,0,State - TRIPURA (16),Urban,10-14,74696,38097,36599,18892,5354,2595,1395,749,646,28
16,0,State - TRIPURA (16),Urban,15-19,82941,41759,41182,21323,5721,2786,1842,848,994,310
16,0,State - TRIPURA (16),Urban,20-24,92301,45313,46988,23347,5060,2375,2546,1067,1479,903
16,0,State - TRIPURA (16),Urban,Adolescent (10-19),157637,79856,77781,40215,11075,5381,3237,1597,1640,338
16,0,State - TRIPURA (16),Urban,Youth (15-24),175242,87072,88170,44670,10781,5161,4388,1915,2473,1213
16,289,District - West Tripura (01),Total,All Ages,1725739,879428,846311,338094,431944,217278,364385,156430,207955,88018
16,289,District - West Tripura (01),Total,10-14,155450,79444,76006,31066,45830,23314,4169,2043,2126,316
16,289,District - West Tripura (01),Total,15-19,167086,84694,82392,34530,46679,23260,5711,2312,3399,3575
16,289,District - West Tripura (01),Total,20-24,176431,87398,89033,36855,46101,21955,8041,2995,5046,9772
16,289,District - West Tripura (01),Total,Adolescent (10-19),322536,164138,158398,65596,92509,46574,9880,4355,5525,3891
16,289,District - West Tripura (01),Total,Youth (15-24),343517,172092,171425,71385,92780,45215,13752,5307,8445,13347
16,289,District - West Tripura (01),Rural,All Ages,1048101,536720,511381,186463,402746,203063,259099,109139,149960,82099
16,289,District - West Tripura (01),Rural,10-14,103829,53099,50730,17861,43110,22046,3137,1494,1643,301
16,289,District - West Tripura (01),Rural,15-19,108674,55406,53268,19438,43428,21782,4337,1653,2684,3408
16,289,District - West Tripura (01),Rural,20-24,111283,55426,55857,20406,43073,20547,6207,2232,3975,9286
16,289,District - West Tripura (01),Rural,Adolescent (10-19),212503,108505,103998,37299,86538,43828,7474,3147,4327,3709
16,289,District - West Tripura (01),Rural,Youth (15-24),219957,110832,109125,39844,86501,42329,10544,3885,6659,12694
16,289,District - West Tripura (01),Urban,All Ages,677638,342708,334930,151631,29198,14215,105286,47291,57995,5919
16,289,District - West Tripura (01),Urban,10-14,51621,26345,25276,13205,2720,1268,1032,549,483,15
16,289,District - West Tripura (01),Urban,15-19,58412,29288,29124,15092,3251,1478,1374,659,715,167
16,289,District - West Tripura (01),Urban,20-24,65148,31972,33176,16449,3028,1408,1834,763,1071,486
16,289,District - West Tripura (01),Urban,Adolescent (10-19),110033,55633,54400,28297,5971,2746,2406,1208,1198,182
16,289,District - West Tripura (01),Urban,Youth (15-24),123560,61260,62300,31541,6279,2886,3208,1422,1786,653
16,290,District - South Tripura (02),Total,All Ages,876001,447544,428457,140168,344835,173174,229191,96462,132729,66460
16,290,District - South Tripura (02),Total,10-14,89353,45784,43569,12938,43356,22097,3174,1375,1799,250
16,290,District - South Tripura (02),Total,15-19,84783,42870,41913,14072,36237,17959,4732,1536,3196,2876
16,290,District - South Tripura (02),Total,20-24,87795,43132,44663,15082,33564,15707,6927,2060,4867,8181
16,290,District - South Tripura (02),Total,Adolescent (10-19),174136,88654,85482,27010,79593,40056,7906,2911,4995,3126
16,290,District - South Tripura (02),Total,Youth (15-24),172578,86002,86576,29154,69801,33666,11659,3596,8063,11057
16,290,District - South Tripura (02),Rural,All Ages,752970,384787,368183,111464,338926,170241,210084,87967,122117,64282
16,290,District - South Tripura (02),Rural,10-14,79778,40925,38853,10574,42497,21708,3031,1293,1738,245
16,290,District - South Tripura (02),Rural,15-19,74269,37570,36699,11323,35482,17561,4536,1454,3082,2795
16,290,District - South Tripura (02),Rural,20-24,75867,37287,38580,12090,33025,15464,6627,1930,4697,7959
16,290,District - South Tripura (02),Rural,Adolescent (10-19),154047,78495,75552,21897,77979,39269,7567,2747,4820,3040
16,290,District - South Tripura (02),Rural,Youth (15-24),150136,74857,75279,23413,68507,33025,11163,3384,7779,10754
16,290,District - South Tripura (02),Urban,All Ages,123031,62757,60274,28704,5909,2933,19107,8495,10612,2178
16,290,District - South Tripura (02),Urban,10-14,9575,4859,4716,2364,859,389,143,82,61,5
16,290,District - South Tripura (02),Urban,15-19,10514,5300,5214,2749,755,398,196,82,114,81
16,290,District - South Tripura (02),Urban,20-24,11928,5845,6083,2992,539,243,300,130,170,222
16,290,District - South Tripura (02),Urban,Adolescent (10-19),20089,10159,9930,5113,1614,787,339,164,175,86
16,290,District - South Tripura (02),Urban,Youth (15-24),22442,11145,11297,5741,1294,641,496,212,284,303
16,291,District - Dhalai (03),Total,All Ages,378230,194544,183686,61688,210608,106759,102013,42901,59112,20934
16,291,District - Dhalai (03),Total,10-14,40924,21153,19771,6099,26032,13504,2187,818,1369,101
16,291,District - Dhalai (03),Total,15-19,37351,18864,18487,6384,21772,11022,2593,685,1908,1037
16,291,District - Dhalai (03),Total,20-24,37906,18533,19373,6674,20479,9588,3664,872,2792,2503
16,291,District - Dhalai (03),Total,Adolescent (10-19),78275,40017,38258,12483,47804,24526,4780,1503,3277,1138
16,291,District - Dhalai (03),Total,Youth (15-24),75257,37397,37860,13058,42251,20610,6257,1557,4700,3540
16,291,District - Dhalai (03),Rural,All Ages,337731,173773,163958,50539,205637,104247,95913,40133,55780,20152
16,291,District - Dhalai (03),Rural,10-14,37550,19431,18119,5086,25501,13219,2135,791,1344,99
16,291,District - Dhalai (03),Rural,15-19,33780,17106,16674,5325,21185,10730,2546,668,1878,1004
16,291,District - Dhalai (03),Rural,20-24,33957,16604,17353,5493,19918,9318,3609,854,2755,2422
16,291,District - Dhalai (03),Rural,Adolescent (10-19),71330,36537,34793,10411,46686,23949,4681,1459,3222,1103
16,291,District - Dhalai (03),Rural,Youth (15-24),67737,33710,34027,10818,41103,20048,6155,1522,4633,3426
16,291,District - Dhalai (03),Urban,All Ages,40499,20771,19728,11149,4971,2512,6100,2768,3332,782
16,291,District - Dhalai (03),Urban,10-14,3374,1722,1652,1013,531,285,52,27,25,2
16,291,District - Dhalai (03),Urban,15-19,3571,1758,1813,1059,587,292,47,17,30,33
16,291,District - Dhalai (03),Urban,20-24,3949,1929,2020,1181,561,270,55,18,37,81
16,291,District - Dhalai (03),Urban,Adolescent (10-19),6945,3480,3465,2072,1118,577,99,44,55,35
16,291,District - Dhalai (03),Urban,Youth (15-24),7520,3687,3833,2240,1148,562,102,35,67,114
16,292,District - North Tripura (04),Total,All Ages,693947,352860,341087,114968,179426,91116,173545,77214,96331,26451
16,292,District - North Tripura (04),Total,10-14,71963,36620,35343,11757,21666,11104,3541,1652,1889,160
16,292,District - North Tripura (04),Total,15-19,68609,34708,33901,11402,19753,9887,4277,1579,2698,1347
16,292,District - North Tripura (04),Total,20-24,71045,34716,36329,12247,18764,8920,5714,1974,3740,3424
16,292,District - North Tripura (04),Total,Adolescent (10-19),140572,71328,69244,23159,41419,20991,7818,3231,4587,1507
16,292,District - North Tripura (04),Total,Youth (15-24),139654,69424,70230,23649,38517,18807,9991,3553,6438,4771
16,292,District - North Tripura (04),Rural,All Ages,573662,291893,281769,89527,170257,86357,154595,68431,86164,25395
16,292,District - North Tripura (04),Rural,10-14,61837,31449,30388,9447,20422,10451,3373,1561,1812,154
16,292,District - North Tripura (04),Rural,15-19,58165,29295,28870,8979,18625,9269,4052,1489,2563,1318
16,292,District - North Tripura (04),Rural,20-24,59769,29149,30620,9522,17832,8466,5357,1818,3539,3310
16,292,District - North Tripura (04),Rural,Adolescent (10-19),120002,60744,59258,18426,39047,19720,7425,3050,4375,1472
16,292,District - North Tripura (04),Rural,Youth (15-24),117934,58444,59490,18501,36457,17735,9409,3307,6102,4628
16,292,District - North Tripura (04),Urban,All Ages,120285,60967,59318,25441,9169,4759,18950,8783,10167,1056
16,292,District - North Tripura (04),Urban,10-14,10126,5171,4955,2310,1244,653,168,91,77,6
16,292,District - North Tripura (04),Urban,15-19,10444,5413,5031,2423,1128,618,225,90,135,29
16,292,District - North Tripura (04),Urban,20-24,11276,5567,5709,2725,932,454,357,156,201,114
16,292,District - North Tripura (04),Urban,Adolescent (10-19),20570,10584,9986,4733,2372,1271,393,181,212,35
16,292,District - North Tripura (04),Urban,Youth (15-24),21720,10980,10740,5148,2060,1072,582,246,336,143
17,0,State - MEGHALAYA (17),Total,All Ages,2966889,1491832,1475057,17355,2555861,1269728,1181884,577953,603931,114642
17,0,State - MEGHALAYA (17),Total,10-14,382606,193473,189133,2015,338812,170665,52976,29776,23200,2198
17,0,State - MEGHALAYA (17),Total,15-19,326188,164716,161472,1915,285845,142992,41800,23327,18473,11611
17,0,State - MEGHALAYA (17),Total,20-24,285012,139140,145872,1772,243449,116920,51340,25200,26140,17323
17,0,State - MEGHALAYA (17),Total,Adolescent (10-19),708794,358189,350605,3930,624657,313657,94776,53103,41673,13809
17,0,State - MEGHALAYA (17),Total,Youth (15-24),611200,303856,307344,3687,529294,259912,93140,48527,44613,28934
17,0,State - MEGHALAYA (17),Rural,All Ages,2371439,1194260,1177179,11573,2136891,1070557,1056285,518624,537661,111422
17,0,State - MEGHALAYA (17),Rural,10-14,315360,159784,155576,1419,286946,145078,50555,28532,22023,2161
17,0,State - MEGHALAYA (17),Rural,15-19,254132,129138,124994,1197,231473,117153,39195,22053,17142,11318
17,0,State - MEGHALAYA (17),Rural,20-24,217643,105372,112271,1107,195840,94335,47929,23610,24319,16863
17,0,State - MEGHALAYA (17),Rural,Adolescent (10-19),569492,288922,280570,2616,518419,262231,89750,50585,39165,13479
17,0,State - MEGHALAYA (17),Rural,Youth (15-24),471775,234510,237265,2304,427313,211488,87124,45663,41461,28181
17,0,State - MEGHALAYA (17),Urban,All Ages,595450,297572,297878,5782,418970,199171,125599,59329,66270,3220
17,0,State - MEGHALAYA (17),Urban,10-14,67246,33689,33557,596,51866,25587,2421,1244,1177,37
17,0,State - MEGHALAYA (17),Urban,15-19,72056,35578,36478,718,54372,25839,2605,1274,1331,293
17,0,State - MEGHALAYA (17),Urban,20-24,67369,33768,33601,665,47609,22585,3411,1590,1821,460
17,0,State - MEGHALAYA (17),Urban,Adolescent (10-19),139302,69267,70035,1314,106238,51426,5026,2518,2508,330
17,0,State - MEGHALAYA (17),Urban,Youth (15-24),139425,69346,70079,1383,101981,48424,6016,2864,3152,753
17,293,District - West Garo Hills (01),Total,All Ages,643291,324159,319132,8810,474009,236772,284589,130721,153868,20540
17,293,District - West Garo Hills (01),Total,10-14,81938,41641,40297,1064,61449,30975,14465,7847,6618,349
17,293,District - West Garo Hills (01),Total,15-19,71274,36134,35140,1045,54535,27444,10507,5347,5160,1361
17,293,District - West Garo Hills (01),Total,20-24,59906,28920,30986,891,44113,21196,12992,5400,7592,2399
17,293,District - West Garo Hills (01),Total,Adolescent (10-19),153212,77775,75437,2109,115984,58419,24972,13194,11778,1710
17,293,District - West Garo Hills (01),Total,Youth (15-24),131180,65054,66126,1936,98648,48640,23499,10747,12752,3760
17,293,District - West Garo Hills (01),Rural,All Ages,568433,286923,281510,6249,420285,210724,269985,123903,146082,20417
17,293,District - West Garo Hills (01),Rural,10-14,73075,37416,35659,809,54631,27801,14118,7682,6436,348
17,293,District - West Garo Hills (01),Rural,15-19,61117,31276,29841,712,46733,23746,10178,5175,5003,1350
17,293,District - West Garo Hills (01),Rural,20-24,51536,24817,26719,599,37988,18204,12629,5243,7386,2391
17,293,District - West Garo Hills (01),Rural,Adolescent (10-19),134192,68692,65500,1521,101364,51547,24296,12857,11439,1698
17,293,District - West Garo Hills (01),Rural,Youth (15-24),112653,56093,56560,1311,84721,41950,22807,10418,12389,3741
17,293,District - West Garo Hills (01),Urban,All Ages,74858,37236,37622,2561,53724,26048,14604,6818,7786,123
17,293,District - West Garo Hills (01),Urban,10-14,8863,4225,4638,255,6818,3174,347,165,182,1
17,293,District - West Garo Hills (01),Urban,15-19,10157,4858,5299,333,7802,3698,329,172,157,11
17,293,District - West Garo Hills (01),Urban,20-24,8370,4103,4267,292,6125,2992,363,157,206,8
17,293,District - West Garo Hills (01),Urban,Adolescent (10-19),19020,9083,9937,588,14620,6872,676,337,339,12
17,293,District - West Garo Hills (01),Urban,Youth (15-24),18527,8961,9566,625,13927,6690,692,329,363,19
17,294,District - East Garo Hills (02),Total,All Ages,317917,161223,156694,509,305180,153861,125770,58710,67060,8054
17,294,District - East Garo Hills (02),Total,10-14,41241,21043,20198,62,39800,20307,7423,3930,3493,141
17,294,District - East Garo Hills (02),Total,15-19,35312,17642,17670,58,34060,16934,4426,2195,2231,470
17,294,District - East Garo Hills (02),Total,20-24,29973,14124,15849,67,28698,13363,5561,2197,3364,1072
17,294,District - East Garo Hills (02),Total,Adolescent (10-19),76553,38685,37868,120,73860,37241,11849,6125,5724,611
17,294,District - East Garo Hills (02),Total,Youth (15-24),65285,31766,33519,125,62758,30297,9987,4392,5595,1542
17,294,District - East Garo Hills (02),Rural,All Ages,273725,138763,134962,215,265979,134637,115832,54058,61774,7774
17,294,District - East Garo Hills (02),Rural,10-14,35312,18076,17236,21,34331,17591,7105,3776,3329,139
17,294,District - East Garo Hills (02),Rural,15-19,29469,14900,14569,20,28658,14450,4177,2076,2101,464
17,294,District - East Garo Hills (02),Rural,20-24,25282,11796,13486,33,24563,11410,5262,2060,3202,1048
17,294,District - East Garo Hills (02),Rural,Adolescent (10-19),64781,32976,31805,41,62989,32041,11282,5852,5430,603
17,294,District - East Garo Hills (02),Rural,Youth (15-24),54751,26696,28055,53,53221,25860,9439,4136,5303,1512
17,294,District - East Garo Hills (02),Urban,All Ages,44192,22460,21732,294,39201,19224,9938,4652,5286,280
17,294,District - East Garo Hills (02),Urban,10-14,5929,2967,2962,41,5469,2716,318,154,164,2
17,294,District - East Garo Hills (02),Urban,15-19,5843,2742,3101,38,5402,2484,249,119,130,6
17,294,District - East Garo Hills (02),Urban,20-24,4691,2328,2363,34,4135,1953,299,137,162,24
17,294,District - East Garo Hills (02),Urban,Adolescent (10-19),11772,5709,6063,79,10871,5200,567,273,294,8
17,294,District - East Garo Hills (02),Urban,Youth (15-24),10534,5070,5464,72,9537,4437,548,256,292,30
17,295,District - South Garo Hills (03),Total,All Ages,142334,73170,69164,319,134237,68140,60272,28167,32105,2781
17,295,District - South Garo Hills (03),Total,10-14,18564,9446,9118,39,17782,9021,3095,1633,1462,27
17,295,District - South Garo Hills (03),Total,15-19,15437,7866,7571,36,14692,7442,1954,981,973,129
17,295,District - South Garo Hills (03),Total,20-24,12801,6294,6507,35,11975,5761,2362,1028,1334,314
17,295,District - South Garo Hills (03),Total,Adolescent (10-19),34001,17312,16689,75,32474,16463,5049,2614,2435,156
17,295,District - South Garo Hills (03),Total,Youth (15-24),28238,14160,14078,71,26667,13203,4316,2009,2307,443
17,295,District - South Garo Hills (03),Rural,All Ages,129203,66470,62733,191,123068,62583,56928,26590,30338,2700
17,295,District - South Garo Hills (03),Rural,10-14,16718,8549,8169,18,16126,8215,3020,1593,1427,27
17,295,District - South Garo Hills (03),Rural,15-19,13940,7145,6795,22,13397,6829,1885,948,937,129
17,295,District - South Garo Hills (03),Rural,20-24,11531,5659,5872,20,10902,5241,2276,994,1282,305
17,295,District - South Garo Hills (03),Rural,Adolescent (10-19),30658,15694,14964,40,29523,15044,4905,2541,2364,156
17,295,District - South Garo Hills (03),Rural,Youth (15-24),25471,12804,12667,42,24299,12070,4161,1942,2219,434
17,295,District - South Garo Hills (03),Urban,All Ages,13131,6700,6431,128,11169,5557,3344,1577,1767,81
17,295,District - South Garo Hills (03),Urban,10-14,1846,897,949,21,1656,806,75,40,35,0
17,295,District - South Garo Hills (03),Urban,15-19,1497,721,776,14,1295,613,69,33,36,0
17,295,District - South Garo Hills (03),Urban,20-24,1270,635,635,15,1073,520,86,34,52,9
17,295,District - South Garo Hills (03),Urban,Adolescent (10-19),3343,1618,1725,35,2951,1419,144,73,71,0
17,295,District - South Garo Hills (03),Urban,Youth (15-24),2767,1356,1411,29,2368,1133,155,67,88,9
17,296,District - West Khasi Hills (04),Total,All Ages,383461,193715,189746,168,375097,189134,152783,76408,76375,19987
17,296,District - West Khasi Hills (04),Total,10-14,53030,26881,26149,16,52056,26385,6508,3526,2982,492
17,296,District - West Khasi Hills (04),Total,15-19,41934,21518,20416,24,41241,21155,4265,2486,1779,2245
17,296,District - West Khasi Hills (04),Total,20-24,34772,17140,17632,26,34039,16753,5103,2717,2386,3329
17,296,District - West Khasi Hills (04),Total,Adolescent (10-19),94964,48399,46565,40,93297,47540,10773,6012,4761,2737
17,296,District - West Khasi Hills (04),Total,Youth (15-24),76706,38658,38048,50,75280,37908,9368,5203,4165,5574
17,296,District - West Khasi Hills (04),Rural,All Ages,340356,172380,167976,145,332455,168040,139783,69887,69896,18964
17,296,District - West Khasi Hills (04),Rural,10-14,46925,23774,23151,16,46007,23307,6268,3385,2883,478
17,296,District - West Khasi Hills (04),Rural,15-19,36551,18818,17733,21,35905,18474,4059,2354,1705,2131
17,296,District - West Khasi Hills (04),Rural,20-24,30565,15098,15467,23,29868,14727,4839,2559,2280,3182
17,296,District - West Khasi Hills (04),Rural,Adolescent (10-19),83476,42592,40884,37,81912,41781,10327,5739,4588,2609
17,296,District - West Khasi Hills (04),Rural,Youth (15-24),67116,33916,33200,44,65773,33201,8898,4913,3985,5313
17,296,District - West Khasi Hills (04),Urban,All Ages,43105,21335,21770,23,42642,21094,13000,6521,6479,1023
17,296,District - West Khasi Hills (04),Urban,10-14,6105,3107,2998,0,6049,3078,240,141,99,14
17,296,District - West Khasi Hills (04),Urban,15-19,5383,2700,2683,3,5336,2681,206,132,74,114
17,296,District - West Khasi Hills (04),Urban,20-24,4207,2042,2165,3,4171,2026,264,158,106,147
17,296,District - West Khasi Hills (04),Urban,Adolescent (10-19),11488,5807,5681,3,11385,5759,446,273,173,128
17,296,District - West Khasi Hills (04),Urban,Youth (15-24),9590,4742,4848,6,9507,4707,470,290,180,261
17,297,District - Ribhoi (05),Total,All Ages,258840,132531,126309,590,230081,115907,102981,51554,51427,14216
17,297,District - Ribhoi (05),Total,10-14,35439,18111,17328,68,32419,16536,3903,2303,1600,285
17,297,District - Ribhoi (05),Total,15-19,28285,14410,13875,72,25417,12871,3098,1781,1317,1640
17,297,District - Ribhoi (05),Total,20-24,24142,11840,12302,67,20941,10079,3861,1971,1890,2248
17,297,District - Ribhoi (05),Total,Adolescent (10-19),63724,32521,31203,140,57836,29407,7001,4084,2917,1925
17,297,District - Ribhoi (05),Total,Youth (15-24),52427,26250,26177,139,46358,22950,6959,3752,3207,3888
17,297,District - Ribhoi (05),Rural,All Ages,233587,118705,114882,504,212325,107235,95770,48023,47747,13090
17,297,District - Ribhoi (05),Rural,10-14,32436,16534,15902,59,29863,15208,3754,2220,1534,270
17,297,District - Ribhoi (05),Rural,15-19,25631,13110,12521,59,23236,11818,2934,1697,1237,1509
17,297,District - Ribhoi (05),Rural,20-24,21431,10436,10995,54,19179,9272,3682,1889,1793,2040
17,297,District - Ribhoi (05),Rural,Adolescent (10-19),58067,29644,28423,118,53099,27026,6688,3917,2771,1779
17,297,District - Ribhoi (05),Rural,Youth (15-24),47062,23546,23516,113,42415,21090,6616,3586,3030,3549
17,297,District - Ribhoi (05),Urban,All Ages,25253,13826,11427,86,17756,8672,7211,3531,3680,1126
17,297,District - Ribhoi (05),Urban,10-14,3003,1577,1426,9,2556,1328,149,83,66,15
17,297,District - Ribhoi (05),Urban,15-19,2654,1300,1354,13,2181,1053,164,84,80,131
17,297,District - Ribhoi (05),Urban,20-24,2711,1404,1307,13,1762,807,179,82,97,208
17,297,District - Ribhoi (05),Urban,Adolescent (10-19),5657,2877,2780,22,4737,2381,313,167,146,146
17,297,District - Ribhoi (05),Urban,Youth (15-24),5365,2704,2661,26,3943,1860,343,166,177,339
17,298,District - East Khasi Hills (06),Total,All Ages,825922,410749,415173,5642,661158,320048,247892,123479,124413,30464
17,298,District - East Khasi Hills (06),Total,10-14,98483,49583,48900,625,83561,41771,6537,3822,2715,484
17,298,District - East Khasi Hills (06),Total,15-19,90186,45355,44831,548,74057,36359,6033,3504,2529,3505
17,298,District - East Khasi Hills (06),Total,20-24,86204,42763,43441,563,68250,32653,8067,4390,3677,4943
17,298,District - East Khasi Hills (06),Total,Adolescent (10-19),188669,94938,93731,1173,157618,78130,12570,7326,5244,3989
17,298,District - East Khasi Hills (06),Total,Youth (15-24),176390,88118,88272,1111,142307,69012,14100,7894,6206,8448
17,298,District - East Khasi Hills (06),Rural,All Ages,459441,228409,231032,3054,432621,213721,176433,90164,86269,29906
17,298,District - East Khasi Hills (06),Rural,10-14,60665,30514,30151,364,57658,28996,5368,3223,2145,479
17,298,District - East Khasi Hills (06),Rural,15-19,47589,24012,23577,242,45309,22787,4584,2845,1739,3478
17,298,District - East Khasi Hills (06),Rural,20-24,43231,21040,22191,267,40803,19746,5995,3458,2537,4880
17,298,District - East Khasi Hills (06),Rural,Adolescent (10-19),108254,54526,53728,606,102967,51783,9952,6068,3884,3957
17,298,District - East Khasi Hills (06),Rural,Youth (15-24),90820,45052,45768,509,86112,42533,10579,6303,4276,8358
17,298,District - East Khasi Hills (06),Urban,All Ages,366481,182340,184141,2588,228537,106327,71459,33315,38144,558
17,298,District - East Khasi Hills (06),Urban,10-14,37818,19069,18749,261,25903,12775,1169,599,570,5
17,298,District - East Khasi Hills (06),Urban,15-19,42597,21343,21254,306,28748,13572,1449,659,790,27
17,298,District - East Khasi Hills (06),Urban,20-24,42973,21723,21250,296,27447,12907,2072,932,1140,63
17,298,District - East Khasi Hills (06),Urban,Adolescent (10-19),80415,40412,40003,567,54651,26347,2618,1258,1360,32
17,298,District - East Khasi Hills (06),Urban,Youth (15-24),85570,43066,42504,602,56195,26479,3521,1591,1930,90
17,299,District - Jaintia Hills (07),Total,All Ages,395124,196285,198839,1317,376099,185866,207597,108914,98683,18600
17,299,District - Jaintia Hills (07),Total,10-14,53911,26768,27143,141,51745,25670,11045,6715,4330,420
17,299,District - Jaintia Hills (07),Total,15-19,43760,21791,21969,132,41843,20787,11517,7033,4484,2261
17,299,District - Jaintia Hills (07),Total,20-24,37214,18059,19155,123,35433,17115,13394,7497,5897,3018
17,299,District - Jaintia Hills (07),Total,Adolescent (10-19),97671,48559,49112,273,93588,46457,22562,13748,8814,2681
17,299,District - Jaintia Hills (07),Total,Youth (15-24),80974,39850,41124,255,77276,37902,24911,14530,10381,5279
17,299,District - Jaintia Hills (07),Rural,All Ages,366694,182610,184084,1215,350158,173617,201554,105999,95555,18571
17,299,District - Jaintia Hills (07),Rural,10-14,50229,24921,25308,132,48330,23960,10922,6653,4269,420
17,299,District - Jaintia Hills (07),Rural,15-19,39835,19877,19958,121,38235,19049,11378,6958,4420,2257
17,299,District - Jaintia Hills (07),Rural,20-24,34067,16526,17541,111,32537,15735,13246,7407,5839,3017
17,299,District - Jaintia Hills (07),Rural,Adolescent (10-19),90064,44798,45266,253,86565,43009,22300,13611,8689,2677
17,299,District - Jaintia Hills (07),Rural,Youth (15-24),73902,36403,37499,232,70772,34784,24624,14365,10259,5274
17,299,District - Jaintia Hills (07),Urban,All Ages,28430,13675,14755,102,25941,12249,6043,2915,3128,29
17,299,District - Jaintia Hills (07),Urban,10-14,3682,1847,1835,9,3415,1710,123,62,61,0
17,299,District - Jaintia Hills (07),Urban,15-19,3925,1914,2011,11,3608,1738,139,75,64,4
17,299,District - Jaintia Hills (07),Urban,20-24,3147,1533,1614,12,2896,1380,148,90,58,1
17,299,District - Jaintia Hills (07),Urban,Adolescent (10-19),7607,3761,3846,20,7023,3448,262,137,125,4
17,299,District - Jaintia Hills (07),Urban,Youth (15-24),7072,3447,3625,23,6504,3118,287,165,122,5
18,0,State - ASSAM (18),Total,All Ages,31205576,15939443,15266133,2231321,3884371,1957005,12027599,5370804,6656795,903294
18,0,State - ASSAM (18),Total,10-14,3491727,1789381,1702346,248490,446049,227164,415173,210707,204466,15365
18,0,State - ASSAM (18),Total,15-19,3068581,1595489,1473092,231601,409120,206577,450936,215486,235450,78183
18,0,State - ASSAM (18),Total,20-24,2909405,1415580,1493825,218142,361974,170362,600742,229984,370758,113820
18,0,State - ASSAM (18),Total,Adolescent (10-19),6560308,3384870,3175438,480091,855169,433741,866109,426193,439916,93548
18,0,State - ASSAM (18),Total,Youth (15-24),5977986,3011069,2966917,449743,771094,376939,1051678,445470,606208,192003
18,0,State - ASSAM (18),Rural,All Ages,26807034,13678989,13128045,1825761,3665405,1847326,11121598,4972796,6148802,885561
18,0,State - ASSAM (18),Rural,10-14,3099766,1587764,1512002,209316,423183,215563,395793,201403,194390,15163
18,0,State - ASSAM (18),Rural,15-19,2664091,1388492,1275599,190661,384629,194615,427995,205337,222658,77115
18,0,State - ASSAM (18),Rural,20-24,2477603,1203111,1274492,175384,338230,159124,569392,218280,351112,112082
18,0,State - ASSAM (18),Rural,Adolescent (10-19),5763857,2976256,2787601,399977,807812,410178,823788,406740,417048,92278
18,0,State - ASSAM (18),Rural,Youth (15-24),5141694,2591603,2550091,366045,722859,353739,997387,423617,573770,189197
18,0,State - ASSAM (18),Urban,All Ages,4398542,2260454,2138088,405560,218966,109679,906001,398008,507993,17733
18,0,State - ASSAM (18),Urban,10-14,391961,201617,190344,39174,22866,11601,19380,9304,10076,202
18,0,State - ASSAM (18),Urban,15-19,404490,206997,197493,40940,24491,11962,22941,10149,12792,1068
18,0,State - ASSAM (18),Urban,20-24,431802,212469,219333,42758,23744,11238,31350,11704,19646,1738
18,0,State - ASSAM (18),Urban,Adolescent (10-19),796451,408614,387837,80114,47357,23563,42321,19453,22868,1270
18,0,State - ASSAM (18),Urban,Youth (15-24),836292,419466,416826,83698,48235,23200,54291,21853,32438,2806
18,300,District - Kokrajhar (01),Total,All Ages,887142,452905,434237,29570,278665,139579,397837,177685,220152,29518
18,300,District - Kokrajhar (01),Total,10-14,101991,52377,49614,3178,30985,15744,13424,6694,6730,455
18,300,District - Kokrajhar (01),Total,15-19,91091,47788,43303,3061,30209,15250,15068,7033,8035,2218
18,300,District - Kokrajhar (01),Total,20-24,81497,39679,41818,2982,25919,12146,19952,7484,12468,3467
18,300,District - Kokrajhar (01),Total,Adolescent (10-19),193082,100165,92917,6239,61194,30994,28492,13727,14765,2673
18,300,District - Kokrajhar (01),Total,Youth (15-24),172588,87467,85121,6043,56128,27396,35020,14517,20503,5685
18,300,District - Kokrajhar (01),Rural,All Ages,832201,424446,407755,23747,266717,133788,386311,172788,213523,29387
18,300,District - Kokrajhar (01),Rural,10-14,97213,49944,47269,2657,29813,15157,13234,6612,6622,455
18,300,District - Kokrajhar (01),Rural,15-19,85982,45132,40850,2496,28942,14626,14809,6922,7887,2210
18,300,District - Kokrajhar (01),Rural,20-24,76169,36980,39189,2349,24808,11652,19573,7344,12229,3455
18,300,District - Kokrajhar (01),Rural,Adolescent (10-19),183195,95076,88119,5153,58755,29783,28043,13534,14509,2665
18,300,District - Kokrajhar (01),Rural,Youth (15-24),162151,82112,80039,4845,53750,26278,34382,14266,20116,5665
18,300,District - Kokrajhar (01),Urban,All Ages,54941,28459,26482,5823,11948,5791,11526,4897,6629,131
18,300,District - Kokrajhar (01),Urban,10-14,4778,2433,2345,521,1172,587,190,82,108,0
18,300,District - Kokrajhar (01),Urban,15-19,5109,2656,2453,565,1267,624,259,111,148,8
18,300,District - Kokrajhar (01),Urban,20-24,5328,2699,2629,633,1111,494,379,140,239,12
18,300,District - Kokrajhar (01),Urban,Adolescent (10-19),9887,5089,4798,1086,2439,1211,449,193,256,8
18,300,District - Kokrajhar (01),Urban,Youth (15-24),10437,5355,5082,1198,2378,1118,638,251,387,20
18,301,District - Dhubri (02),Total,All Ages,1949258,997848,951410,70395,6332,3198,1026917,486297,540620,107424
18,301,District - Dhubri (02),Total,10-14,232151,120946,111205,7430,624,325,49208,28208,21000,1914
18,301,District - Dhubri (02),Total,15-19,185117,99147,85970,7004,653,340,48578,25996,22582,9356
18,301,District - Dhubri (02),Total,20-24,180560,88433,92127,7209,552,269,63946,27757,36189,14539
18,301,District - Dhubri (02),Total,Adolescent (10-19),417268,220093,197175,14434,1277,665,97786,54204,43582,11270
18,301,District - Dhubri (02),Total,Youth (15-24),365677,187580,178097,14213,1205,609,112524,53753,58771,23895
18,301,District - Dhubri (02),Rural,All Ages,1745557,893914,851643,39929,5631,2831,971911,462519,509392,106522
18,301,District - Dhubri (02),Rural,10-14,212895,110996,101899,4423,558,290,47886,27482,20404,1903
18,301,District - Dhubri (02),Rural,15-19,165775,89395,76380,3886,580,295,46987,25236,21751,9295
18,301,District - Dhubri (02),Rural,20-24,160262,78470,81792,3958,495,242,61753,26947,34806,14440
18,301,District - Dhubri (02),Rural,Adolescent (10-19),378670,200391,178279,8309,1138,585,94873,52718,42155,11198
18,301,District - Dhubri (02),Rural,Youth (15-24),326037,167865,158172,7844,1075,537,108740,52183,56557,23735
18,301,District - Dhubri (02),Urban,All Ages,203701,103934,99767,30466,701,367,55006,23778,31228,902
18,301,District - Dhubri (02),Urban,10-14,19256,9950,9306,3007,66,35,1322,726,596,11
18,301,District - Dhubri (02),Urban,15-19,19342,9752,9590,3118,73,45,1591,760,831,61
18,301,District - Dhubri (02),Urban,20-24,20298,9963,10335,3251,57,27,2193,810,1383,99
18,301,District - Dhubri (02),Urban,Adolescent (10-19),38598,19702,18896,6125,139,80,2913,1486,1427,72
18,301,District - Dhubri (02),Urban,Youth (15-24),39640,19715,19925,6369,130,72,3784,1570,2214,160
18,302,District - Goalpara (03),Total,All Ages,1008183,513292,494891,45094,231570,116013,444606,208990,235616,37509
18,302,District - Goalpara (03),Total,10-14,118515,61087,57428,4984,25324,12894,16355,9489,6866,616
18,302,District - Goalpara (03),Total,15-19,102641,54846,47795,4795,25677,12932,18317,10219,8098,3330
18,302,District - Goalpara (03),Total,20-24,94834,45526,49308,4583,22526,10783,25351,11134,14217,4700
18,302,District - Goalpara (03),Total,Adolescent (10-19),221156,115933,105223,9779,51001,25826,34672,19708,14964,3946
18,302,District - Goalpara (03),Total,Youth (15-24),197475,100372,97103,9378,48203,23715,43668,21353,22315,8030
18,302,District - Goalpara (03),Rural,All Ages,870121,443244,426877,32886,219871,110337,396733,187159,209574,36011
18,302,District - Goalpara (03),Rural,10-14,103968,53741,50227,3805,24074,12305,14906,8697,6209,583
18,302,District - Goalpara (03),Rural,15-19,89052,47698,41354,3567,24352,12271,16532,9322,7210,3207
18,302,District - Goalpara (03),Rural,20-24,80988,38908,42080,3240,21281,10221,22711,10074,12637,4541
18,302,District - Goalpara (03),Rural,Adolescent (10-19),193020,101439,91581,7372,48426,24576,31438,18019,13419,3790
18,302,District - Goalpara (03),Rural,Youth (15-24),170040,86606,83434,6807,45633,22492,39243,19396,19847,7748
18,302,District - Goalpara (03),Urban,All Ages,138062,70048,68014,12208,11699,5676,47873,21831,26042,1498
18,302,District - Goalpara (03),Urban,10-14,14547,7346,7201,1179,1250,589,1449,792,657,33
18,302,District - Goalpara (03),Urban,15-19,13589,7148,6441,1228,1325,661,1785,897,888,123
18,302,District - Goalpara (03),Urban,20-24,13846,6618,7228,1343,1245,562,2640,1060,1580,159
18,302,District - Goalpara (03),Urban,Adolescent (10-19),28136,14494,13642,2407,2575,1250,3234,1689,1545,156
18,302,District - Goalpara (03),Urban,Youth (15-24),27435,13766,13669,2571,2570,1223,4425,1957,2468,282
18,303,District - Barpeta (04),Total,All Ages,1693622,867004,826618,95320,27344,13530,796564,367966,428598,56932
18,303,District - Barpeta (04),Total,10-14,198779,103144,95635,10503,3075,1575,30932,17007,13925,1015
18,303,District - Barpeta (04),Total,15-19,156404,87787,68617,9888,3088,1529,29608,16896,12712,5690
18,303,District - Barpeta (04),Total,20-24,153925,74412,79513,9479,2705,1261,44492,18153,26339,7703
18,303,District - Barpeta (04),Total,Adolescent (10-19),355183,190931,164252,20391,6163,3104,60540,33903,26637,6705
18,303,District - Barpeta (04),Total,Youth (15-24),310329,162199,148130,19367,5793,2790,74100,35049,39051,13393
18,303,District - Barpeta (04),Rural,All Ages,1546269,791789,754480,73946,25829,12810,763807,354087,409720,56237
18,303,District - Barpeta (04),Rural,10-14,185380,96144,89236,8244,2899,1483,30311,16696,13615,1011
18,303,District - Barpeta (04),Rural,15-19,142454,80457,61997,7605,2865,1419,28816,16521,12295,5642
18,303,District - Barpeta (04),Rural,20-24,139225,67124,72101,7107,2540,1208,43379,17675,25704,7619
18,303,District - Barpeta (04),Rural,Adolescent (10-19),327834,176601,151233,15849,5764,2902,59127,33217,25910,6653
18,303,District - Barpeta (04),Rural,Youth (15-24),281679,147581,134098,14712,5405,2627,72195,34196,37999,13261
18,303,District - Barpeta (04),Urban,All Ages,147353,75215,72138,21374,1515,720,32757,13879,18878,695
18,303,District - Barpeta (04),Urban,10-14,13399,7000,6399,2259,176,92,621,311,310,4
18,303,District - Barpeta (04),Urban,15-19,13950,7330,6620,2283,223,110,792,375,417,48
18,303,District - Barpeta (04),Urban,20-24,14700,7288,7412,2372,165,53,1113,478,635,84
18,303,District - Barpeta (04),Urban,Adolescent (10-19),27349,14330,13019,4542,399,202,1413,686,727,52
18,303,District - Barpeta (04),Urban,Youth (15-24),28650,14618,14032,4655,388,163,1905,853,1052,132
18,304,District - Morigaon (05),Total,All Ages,957423,486651,470772,117841,136777,68382,417521,196953,220568,40019
18,304,District - Morigaon (05),Total,10-14,114433,58521,55912,13678,15960,8200,15868,9244,6624,1147
18,304,District - Morigaon (05),Total,15-19,92456,48555,43901,12057,13536,6804,16255,9179,7076,4952
18,304,District - Morigaon (05),Total,20-24,85234,41056,44178,10994,12222,5658,20745,9148,11597,5759
18,304,District - Morigaon (05),Total,Adolescent (10-19),206889,107076,99813,25735,29496,15004,32123,18423,13700,6099
18,304,District - Morigaon (05),Total,Youth (15-24),177690,89611,88079,23051,25758,12462,37000,18327,18673,10711
18,304,District - Morigaon (05),Rural,All Ages,884125,449123,435002,109307,130548,65266,398595,188520,210075,39333
18,304,District - Morigaon (05),Rural,10-14,107263,54873,52390,12815,15325,7882,15372,8978,6394,1133
18,304,District - Morigaon (05),Rural,15-19,85243,44903,40340,11165,12894,6475,15660,8895,6765,4875
18,304,District - Morigaon (05),Rural,20-24,77805,37504,40301,10094,11537,5334,20037,8869,11168,5673
18,304,District - Morigaon (05),Rural,Adolescent (10-19),192506,99776,92730,23980,28219,14357,31032,17873,13159,6008
18,304,District - Morigaon (05),Rural,Youth (15-24),163048,82407,80641,21259,24431,11809,35697,17764,17933,10548
18,304,District - Morigaon (05),Urban,All Ages,73298,37528,35770,8534,6229,3116,18926,8433,10493,686
18,304,District - Morigaon (05),Urban,10-14,7170,3648,3522,863,635,318,496,266,230,14
18,304,District - Morigaon (05),Urban,15-19,7213,3652,3561,892,642,329,595,284,311,77
18,304,District - Morigaon (05),Urban,20-24,7429,3552,3877,900,685,324,708,279,429,86
18,304,District - Morigaon (05),Urban,Adolescent (10-19),14383,7300,7083,1755,1277,647,1091,550,541,91
18,304,District - Morigaon (05),Urban,Youth (15-24),14642,7204,7438,1792,1327,653,1303,563,740,163
18,305,District - Nagaon (06),Total,All Ages,2823768,1439112,1384656,266350,115153,57759,1113052,517262,595790,107649
18,305,District - Nagaon (06),Total,10-14,337490,171406,166084,29929,13240,6754,34951,19150,15801,2603
18,305,District - Nagaon (06),Total,15-19,273468,142792,130676,28039,11151,5713,39494,21445,18049,12866
18,305,District - Nagaon (06),Total,20-24,255222,124381,130841,26038,10370,4681,53433,22951,30482,15604
18,305,District - Nagaon (06),Total,Adolescent (10-19),610958,314198,296760,57968,24391,12467,74445,40595,33850,15469
18,305,District - Nagaon (06),Total,Youth (15-24),528690,267173,261517,54077,21521,10394,92927,44396,48531,28470
18,305,District - Nagaon (06),Rural,All Ages,2454234,1250985,1203249,228530,109549,54926,1031734,481468,550266,105522
18,305,District - Nagaon (06),Rural,10-14,303547,154148,149399,26447,12678,6443,33389,18318,15071,2567
18,305,District - Nagaon (06),Rural,15-19,239028,125259,113769,24182,10580,5439,37471,20463,17008,12705
18,305,District - Nagaon (06),Rural,20-24,219548,107138,112410,22117,9830,4430,50617,21839,28778,15385
18,305,District - Nagaon (06),Rural,Adolescent (10-19),542575,279407,263168,50629,23258,11882,70860,38781,32079,15272
18,305,District - Nagaon (06),Rural,Youth (15-24),458576,232397,226179,46299,20410,9869,88088,42302,45786,28090
18,305,District - Nagaon (06),Urban,All Ages,369534,188127,181407,37820,5604,2833,81318,35794,45524,2127
18,305,District - Nagaon (06),Urban,10-14,33943,17258,16685,3482,562,311,1562,832,730,36
18,305,District - Nagaon (06),Urban,15-19,34440,17533,16907,3857,571,274,2023,982,1041,161
18,305,District - Nagaon (06),Urban,20-24,35674,17243,18431,3921,540,251,2816,1112,1704,219
18,305,District - Nagaon (06),Urban,Adolescent (10-19),68383,34791,33592,7339,1133,585,3585,1814,1771,197
18,305,District - Nagaon (06),Urban,Youth (15-24),70114,34776,35338,7778,1111,525,4839,2094,2745,380
18,306,District - Sonitpur (07),Total,All Ages,1924110,983904,940206,109130,232207,117685,815538,363379,452159,51007
18,306,District - Sonitpur (07),Total,10-14,212378,107940,104438,11995,26789,13703,31266,14784,16482,799
18,306,District - Sonitpur (07),Total,15-19,186590,94712,91878,11241,23401,11942,35093,15173,19920,3906
18,306,District - Sonitpur (07),Total,20-24,177180,84940,92240,10652,20969,9888,44405,15900,28505,5554
18,306,District - Sonitpur (07),Total,Adolescent (10-19),398968,202652,196316,23236,50190,25645,66359,29957,36402,4705
18,306,District - Sonitpur (07),Total,Youth (15-24),363770,179652,184118,21893,44370,21830,79498,31073,48425,9460
18,306,District - Sonitpur (07),Rural,All Ages,1750265,894985,855280,94692,228345,115789,782526,348834,433692,50570
18,306,District - Sonitpur (07),Rural,10-14,197538,100478,97060,10694,26423,13502,30601,14499,16102,793
18,306,District - Sonitpur (07),Rural,15-19,171135,86835,84300,9807,22971,11730,34337,14892,19445,3885
18,306,District - Sonitpur (07),Rural,20-24,160705,76985,83720,9146,20572,9730,43383,15519,27864,5508
18,306,District - Sonitpur (07),Rural,Adolescent (10-19),368673,187313,181360,20501,49394,25232,64938,29391,35547,4678
18,306,District - Sonitpur (07),Rural,Youth (15-24),331840,163820,168020,18953,43543,21460,77720,30411,47309,9393
18,306,District - Sonitpur (07),Urban,All Ages,173845,88919,84926,14438,3862,1896,33012,14545,18467,437
18,306,District - Sonitpur (07),Urban,10-14,14840,7462,7378,1301,366,201,665,285,380,6
18,306,District - Sonitpur (07),Urban,15-19,15455,7877,7578,1434,430,212,756,281,475,21
18,306,District - Sonitpur (07),Urban,20-24,16475,7955,8520,1506,397,158,1022,381,641,46
18,306,District - Sonitpur (07),Urban,Adolescent (10-19),30295,15339,14956,2735,796,413,1421,566,855,27
18,306,District - Sonitpur (07),Urban,Youth (15-24),31930,15832,16098,2940,827,370,1778,662,1116,67
18,307,District - Lakhimpur (08),Total,All Ages,1042137,529674,512463,81840,249426,126716,358651,154122,204529,16154
18,307,District - Lakhimpur (08),Total,10-14,118490,60864,57626,9682,30372,15698,8224,3731,4493,291
18,307,District - Lakhimpur (08),Total,15-19,102738,52527,50211,8559,25217,12881,10289,4349,5940,1530
18,307,District - Lakhimpur (08),Total,20-24,95594,45629,49965,7782,22439,10675,15136,5334,9802,2218
18,307,District - Lakhimpur (08),Total,Adolescent (10-19),221228,113391,107837,18241,55589,28579,18513,8080,10433,1821
18,307,District - Lakhimpur (08),Total,Youth (15-24),198332,98156,100176,16341,47656,23556,25425,9683,15742,3748
18,307,District - Lakhimpur (08),Rural,All Ages,950804,482582,468222,74891,243145,123499,337628,144776,192852,15817
18,307,District - Lakhimpur (08),Rural,10-14,109730,56288,53442,8945,29686,15317,7809,3536,4273,289
18,307,District - Lakhimpur (08),Rural,15-19,94095,48173,45922,7795,24516,12545,9684,4065,5619,1518
18,307,District - Lakhimpur (08),Rural,20-24,86892,41487,45405,7114,21744,10361,14379,5076,9303,2186
18,307,District - Lakhimpur (08),Rural,Adolescent (10-19),203825,104461,99364,16740,54202,27862,17493,7601,9892,1807
18,307,District - Lakhimpur (08),Rural,Youth (15-24),180987,89660,91327,14909,46260,22906,24063,9141,14922,3704
18,307,District - Lakhimpur (08),Urban,All Ages,91333,47092,44241,6949,6281,3217,21023,9346,11677,337
18,307,District - Lakhimpur (08),Urban,10-14,8760,4576,4184,737,686,381,415,195,220,2
18,307,District - Lakhimpur (08),Urban,15-19,8643,4354,4289,764,701,336,605,284,321,12
18,307,District - Lakhimpur (08),Urban,20-24,8702,4142,4560,668,695,314,757,258,499,32
18,307,District - Lakhimpur (08),Urban,Adolescent (10-19),17403,8930,8473,1501,1387,717,1020,479,541,14
18,307,District - Lakhimpur (08),Urban,Youth (15-24),17345,8496,8849,1432,1396,650,1362,542,820,44
18,308,District - Dhemaji (09),Total,All Ages,686133,351249,334884,44225,325560,165449,263105,113488,149617,4791
18,308,District - Dhemaji (09),Total,10-14,82165,42008,40157,5791,39799,20335,7428,3423,4005,63
18,308,District - Dhemaji (09),Total,15-19,70330,36254,34076,4502,33945,17272,8175,3556,4619,323
18,308,District - Dhemaji (09),Total,20-24,64718,31160,33558,4053,30677,14563,12375,4365,8010,620
18,308,District - Dhemaji (09),Total,Adolescent (10-19),152495,78262,74233,10293,73744,37607,15603,6979,8624,386
18,308,District - Dhemaji (09),Total,Youth (15-24),135048,67414,67634,8555,64622,31835,20550,7921,12629,943
18,308,District - Dhemaji (09),Rural,All Ages,637848,326278,311570,40524,317215,161268,250436,107896,142540,4563
18,308,District - Dhemaji (09),Rural,10-14,76994,39345,37649,5382,38937,19895,7116,3284,3832,60
18,308,District - Dhemaji (09),Rural,15-19,65307,33672,31635,4075,33042,16850,7846,3402,4444,306
18,308,District - Dhemaji (09),Rural,20-24,59871,28765,31106,3617,29784,14130,11917,4192,7725,590
18,308,District - Dhemaji (09),Rural,Adolescent (10-19),142301,73017,69284,9457,71979,36745,14962,6686,8276,366
18,308,District - Dhemaji (09),Rural,Youth (15-24),125178,62437,62741,7692,62826,30980,19763,7594,12169,896
18,308,District - Dhemaji (09),Urban,All Ages,48285,24971,23314,3701,8345,4181,12669,5592,7077,228
18,308,District - Dhemaji (09),Urban,10-14,5171,2663,2508,409,862,440,312,139,173,3
18,308,District - Dhemaji (09),Urban,15-19,5023,2582,2441,427,903,422,329,154,175,17
18,308,District - Dhemaji (09),Urban,20-24,4847,2395,2452,436,893,433,458,173,285,30
18,308,District - Dhemaji (09),Urban,Adolescent (10-19),10194,5245,4949,836,1765,862,641,293,348,20
18,308,District - Dhemaji (09),Urban,Youth (15-24),9870,4977,4893,863,1796,855,787,327,460,47
18,309,District - Tinsukia (10),Total,All Ages,1327929,680231,647698,37688,82066,41769,529607,226782,302825,19483
18,309,District - Tinsukia (10),Total,10-14,144499,74462,70037,4048,9093,4637,20230,8876,11354,242
18,309,District - Tinsukia (10),Total,15-19,133626,68076,65550,3966,7922,4045,24355,9516,14839,1542
18,309,District - Tinsukia (10),Total,20-24,129219,62089,67130,4034,7367,3533,32519,10749,21770,2613
18,309,District - Tinsukia (10),Total,Adolescent (10-19),278125,142538,135587,8014,17015,8682,44585,18392,26193,1784
18,309,District - Tinsukia (10),Total,Youth (15-24),262845,130165,132680,8000,15289,7578,56874,20265,36609,4155
18,309,District - Tinsukia (10),Rural,All Ages,1063186,541395,521791,25286,76272,38796,472577,201524,271053,19039
18,309,District - Tinsukia (10),Rural,10-14,121189,62250,58939,2914,8549,4354,18964,8299,10665,237
18,309,District - Tinsukia (10),Rural,15-19,109597,55599,53998,2712,7342,3759,22933,8893,14040,1523
18,309,District - Tinsukia (10),Rural,20-24,103479,49234,54245,2714,6798,3239,30410,9972,20438,2576
18,309,District - Tinsukia (10),Rural,Adolescent (10-19),230786,117849,112937,5626,15891,8113,41897,17192,24705,1760
18,309,District - Tinsukia (10),Rural,Youth (15-24),213076,104833,108243,5426,14140,6998,53343,18865,34478,4099
18,309,District - Tinsukia (10),Urban,All Ages,264743,138836,125907,12402,5794,2973,57030,25258,31772,444
18,309,District - Tinsukia (10),Urban,10-14,23310,12212,11098,1134,544,283,1266,577,689,5
18,309,District - Tinsukia (10),Urban,15-19,24029,12477,11552,1254,580,286,1422,623,799,19
18,309,District - Tinsukia (10),Urban,20-24,25740,12855,12885,1320,569,294,2109,777,1332,37
18,309,District - Tinsukia (10),Urban,Adolescent (10-19),47339,24689,22650,2388,1124,569,2688,1200,1488,24
18,309,District - Tinsukia (10),Urban,Youth (15-24),49769,25332,24437,2574,1149,580,3531,1400,2131,56
18,310,District - Dibrugarh (11),Total,All Ages,1326335,676434,649901,58876,102871,51835,441804,185073,256731,21792
18,310,District - Dibrugarh (11),Total,10-14,136430,70279,66151,6258,9445,4854,14417,6230,8187,254
18,310,District - Dibrugarh (11),Total,15-19,131642,66811,64831,6186,9611,4902,18097,6755,11342,1348
18,310,District - Dibrugarh (11),Total,20-24,129599,62113,67486,6045,9817,4695,23999,7503,16496,2624
18,310,District - Dibrugarh (11),Total,Adolescent (10-19),268072,137090,130982,12444,19056,9756,32514,12985,19529,1602
18,310,District - Dibrugarh (11),Total,Youth (15-24),261241,128924,132317,12231,19428,9597,42096,14258,27838,3972
18,310,District - Dibrugarh (11),Rural,All Ages,1082605,550299,532306,41396,92593,46689,397032,165177,231855,21148
18,310,District - Dibrugarh (11),Rural,10-14,116574,59952,56622,4679,8663,4435,13536,5846,7690,246
18,310,District - Dibrugarh (11),Rural,15-19,110112,55774,54338,4496,8722,4479,17016,6268,10748,1320
18,310,District - Dibrugarh (11),Rural,20-24,105870,50428,55442,4259,8769,4216,22404,6921,15483,2567
18,310,District - Dibrugarh (11),Rural,Adolescent (10-19),226686,115726,110960,9175,17385,8914,30552,12114,18438,1566
18,310,District - Dibrugarh (11),Rural,Youth (15-24),215982,106202,109780,8755,17491,8695,39420,13189,26231,3887
18,310,District - Dibrugarh (11),Urban,All Ages,243730,126135,117595,17480,10278,5146,44772,19896,24876,644
18,310,District - Dibrugarh (11),Urban,10-14,19856,10327,9529,1579,782,419,881,384,497,8
18,310,District - Dibrugarh (11),Urban,15-19,21530,11037,10493,1690,889,423,1081,487,594,28
18,310,District - Dibrugarh (11),Urban,20-24,23729,11685,12044,1786,1048,479,1595,582,1013,57
18,310,District - Dibrugarh (11),Urban,Adolescent (10-19),41386,21364,20022,3269,1671,842,1962,871,1091,36
18,310,District - Dibrugarh (11),Urban,Youth (15-24),45259,22722,22537,3476,1937,902,2676,1069,1607,85
18,311,District - Sivasagar (12),Total,All Ages,1151050,589216,561834,42347,49039,24989,337545,144449,193096,14008
18,311,District - Sivasagar (12),Total,10-14,116152,59653,56499,4438,5463,2763,9704,4126,5578,188
18,311,District - Sivasagar (12),Total,15-19,110261,56061,54200,4366,5220,2675,11719,4542,7177,837
18,311,District - Sivasagar (12),Total,20-24,108099,52081,56018,4351,4622,2177,14845,4768,10077,1448
18,311,District - Sivasagar (12),Total,Adolescent (10-19),226413,115714,110699,8804,10683,5438,21423,8668,12755,1025
18,311,District - Sivasagar (12),Total,Youth (15-24),218360,108142,110218,8717,9842,4852,26564,9310,17254,2285
18,311,District - Sivasagar (12),Rural,All Ages,1040954,531286,509668,34483,47274,24078,317464,135014,182450,13681
18,311,District - Sivasagar (12),Rural,10-14,106767,54752,52015,3692,5293,2680,9323,3945,5378,186
18,311,District - Sivasagar (12),Rural,15-19,100573,51071,49502,3569,5048,2580,11194,4291,6903,822
18,311,District - Sivasagar (12),Rural,20-24,97704,46896,50808,3471,4468,2102,14208,4490,9718,1426
18,311,District - Sivasagar (12),Rural,Adolescent (10-19),207340,105823,101517,7261,10341,5260,20517,8236,12281,1008
18,311,District - Sivasagar (12),Rural,Youth (15-24),198277,97967,100310,7040,9516,4682,25402,8781,16621,2248
18,311,District - Sivasagar (12),Urban,All Ages,110096,57930,52166,7864,1765,911,20081,9435,10646,327
18,311,District - Sivasagar (12),Urban,10-14,9385,4901,4484,746,170,83,381,181,200,2
18,311,District - Sivasagar (12),Urban,15-19,9688,4990,4698,797,172,95,525,251,274,15
18,311,District - Sivasagar (12),Urban,20-24,10395,5185,5210,880,154,75,637,278,359,22
18,311,District - Sivasagar (12),Urban,Adolescent (10-19),19073,9891,9182,1543,342,178,906,432,474,17
18,311,District - Sivasagar (12),Urban,Youth (15-24),20083,10175,9908,1677,326,170,1162,529,633,37
18,312,District - Jorhat (13),Total,All Ages,1092256,556805,535451,88665,139971,70795,297327,124470,172857,20176
18,312,District - Jorhat (13),Total,10-14,108807,56136,52671,9961,15974,8238,7331,3067,4264,229
18,312,District - Jorhat (13),Total,15-19,105318,53456,51862,9377,14355,7248,9730,3661,6069,1196
18,312,District - Jorhat (13),Total,20-24,102529,49435,53094,8760,12692,6027,12928,4002,8926,2191
18,312,District - Jorhat (13),Total,Adolescent (10-19),214125,109592,104533,19338,30329,15486,17061,6728,10333,1425
18,312,District - Jorhat (13),Total,Youth (15-24),207847,102891,104956,18137,27047,13275,22658,7663,14995,3387
18,312,District - Jorhat (13),Rural,All Ages,871722,442968,428754,72434,134361,67932,256974,106270,150704,18840
18,312,District - Jorhat (13),Rural,10-14,90093,46335,43758,8426,15408,7932,6492,2672,3820,222
18,312,District - Jorhat (13),Rural,15-19,85948,43431,42517,7773,13823,6977,8726,3242,5484,1132
18,312,District - Jorhat (13),Rural,20-24,81467,39178,42289,7049,12130,5747,11461,3496,7965,2056
18,312,District - Jorhat (13),Rural,Adolescent (10-19),176041,89766,86275,16199,29231,14909,15218,5914,9304,1354
18,312,District - Jorhat (13),Rural,Youth (15-24),167415,82609,84806,14822,25953,12724,20187,6738,13449,3188
18,312,District - Jorhat (13),Urban,All Ages,220534,113837,106697,16231,5610,2863,40353,18200,22153,1336
18,312,District - Jorhat (13),Urban,10-14,18714,9801,8913,1535,566,306,839,395,444,7
18,312,District - Jorhat (13),Urban,15-19,19370,10025,9345,1604,532,271,1004,419,585,64
18,312,District - Jorhat (13),Urban,20-24,21062,10257,10805,1711,562,280,1467,506,961,135
18,312,District - Jorhat (13),Urban,Adolescent (10-19),38084,19826,18258,3139,1098,577,1843,814,1029,71
18,312,District - Jorhat (13),Urban,Youth (15-24),40432,20282,20150,3315,1094,551,2471,925,1546,199
18,313,District - Golaghat (14),Total,All Ages,1066888,543161,523727,62298,111765,56420,345124,146686,198438,25086
18,313,District - Golaghat (14),Total,10-14,117308,60011,57297,7070,13140,6645,8813,3711,5102,324
18,313,District - Golaghat (14),Total,15-19,108123,54589,53534,6767,11639,5854,12453,4804,7649,1986
18,313,District - Golaghat (14),Total,20-24,102501,48740,53761,6248,10521,4902,17564,5640,11924,3229
18,313,District - Golaghat (14),Total,Adolescent (10-19),225431,114600,110831,13837,24779,12499,21266,8515,12751,2310
18,313,District - Golaghat (14),Total,Youth (15-24),210624,103329,107295,13015,22160,10756,30017,10444,19573,5215
18,313,District - Golaghat (14),Rural,All Ages,969152,493125,476027,56152,108974,55035,328174,139086,189088,24727
18,313,District - Golaghat (14),Rural,10-14,108452,55441,53011,6486,12751,6457,8529,3605,4924,320
18,313,District - Golaghat (14),Rural,15-19,99251,50101,49150,6134,11306,5687,12106,4664,7442,1971
18,313,District - Golaghat (14),Rural,20-24,93361,44379,48982,5633,10265,4789,17091,5465,11626,3197
18,313,District - Golaghat (14),Rural,Adolescent (10-19),207703,105542,102161,12620,24057,12144,20635,8269,12366,2291
18,313,District - Golaghat (14),Rural,Youth (15-24),192612,94480,98132,11767,21571,10476,29197,10129,19068,5168
18,313,District - Golaghat (14),Urban,All Ages,97736,50036,47700,6146,2791,1385,16950,7600,9350,359
18,313,District - Golaghat (14),Urban,10-14,8856,4570,4286,584,389,188,284,106,178,4
18,313,District - Golaghat (14),Urban,15-19,8872,4488,4384,633,333,167,347,140,207,15
18,313,District - Golaghat (14),Urban,20-24,9140,4361,4779,615,256,113,473,175,298,32
18,313,District - Golaghat (14),Urban,Adolescent (10-19),17728,9058,8670,1217,722,355,631,246,385,19
18,313,District - Golaghat (14),Urban,Youth (15-24),18012,8849,9163,1248,589,280,820,315,505,47
18,314,District - Karbi Anglong (15),Total,All Ages,956313,490167,466146,44961,538738,272460,399099,175914,223185,20595
18,314,District - Karbi Anglong (15),Total,10-14,115294,58717,56577,5539,66867,33936,14592,6686,7906,276
18,314,District - Karbi Anglong (15),Total,15-19,106030,53922,52108,5169,60928,30335,14989,6271,8718,1621
18,314,District - Karbi Anglong (15),Total,20-24,90423,44184,46239,4389,49527,23241,19129,6676,12453,2762
18,314,District - Karbi Anglong (15),Total,Adolescent (10-19),221324,112639,108685,10708,127795,64271,29581,12957,16624,1897
18,314,District - Karbi Anglong (15),Total,Youth (15-24),196453,98106,98347,9558,110455,53576,34118,12947,21171,4383
18,314,District - Karbi Anglong (15),Rural,All Ages,843347,431924,411423,39936,491856,249022,373237,164710,208527,19568
18,314,District - Karbi Anglong (15),Rural,10-14,103214,52527,50687,5005,61340,31128,14056,6433,7623,270
18,314,District - Karbi Anglong (15),Rural,15-19,92845,47409,45436,4614,54560,27334,14368,6019,8349,1543
18,314,District - Karbi Anglong (15),Rural,20-24,77919,38089,39830,3880,43949,20594,18293,6400,11893,2640
18,314,District - Karbi Anglong (15),Rural,Adolescent (10-19),196059,99936,96123,9619,115900,58462,28424,12452,15972,1813
18,314,District - Karbi Anglong (15),Rural,Youth (15-24),170764,85498,85266,8494,98509,47928,32661,12419,20242,4183
18,314,District - Karbi Anglong (15),Urban,All Ages,112966,58243,54723,5025,46882,23438,25862,11204,14658,1027
18,314,District - Karbi Anglong (15),Urban,10-14,12080,6190,5890,534,5527,2808,536,253,283,6
18,314,District - Karbi Anglong (15),Urban,15-19,13185,6513,6672,555,6368,3001,621,252,369,78
18,314,District - Karbi Anglong (15),Urban,20-24,12504,6095,6409,509,5578,2647,836,276,560,122
18,314,District - Karbi Anglong (15),Urban,Adolescent (10-19),25265,12703,12562,1089,11895,5809,1157,505,652,84
18,314,District - Karbi Anglong (15),Urban,Youth (15-24),25689,12608,13081,1064,11946,5648,1457,528,929,200
18,315,District - Dima Hasao (16),Total,All Ages,214102,110802,103300,4337,151843,76520,73229,32243,40986,1833
18,315,District - Dima Hasao (16),Total,10-14,24937,12766,12171,455,18666,9458,2005,958,1047,25
18,315,District - Dima Hasao (16),Total,15-19,22807,11400,11407,427,16965,8324,2004,798,1206,135
18,315,District - Dima Hasao (16),Total,20-24,21102,10318,10784,457,15017,7047,2855,942,1913,217
18,315,District - Dima Hasao (16),Total,Adolescent (10-19),47744,24166,23578,882,35631,17782,4009,1756,2253,160
18,315,District - Dima Hasao (16),Total,Youth (15-24),43909,21718,22191,884,31982,15371,4859,1740,3119,352
18,315,District - Dima Hasao (16),Rural,All Ages,151613,77817,73796,1885,123060,62206,61604,27159,34445,1610
18,315,District - Dima Hasao (16),Rural,10-14,18381,9429,8952,206,15208,7746,1810,860,950,22
18,315,District - Dima Hasao (16),Rural,15-19,16399,8202,8197,177,13598,6707,1823,725,1098,118
18,315,District - Dima Hasao (16),Rural,20-24,14622,7064,7558,214,11878,5600,2587,854,1733,184
18,315,District - Dima Hasao (16),Rural,Adolescent (10-19),34780,17631,17149,383,28806,14453,3633,1585,2048,140
18,315,District - Dima Hasao (16),Rural,Youth (15-24),31021,15266,15755,391,25476,12307,4410,1579,2831,302
18,315,District - Dima Hasao (16),Urban,All Ages,62489,32985,29504,2452,28783,14314,11625,5084,6541,223
18,315,District - Dima Hasao (16),Urban,10-14,6556,3337,3219,249,3458,1712,195,98,97,3
18,315,District - Dima Hasao (16),Urban,15-19,6408,3198,3210,250,3367,1617,181,73,108,17
18,315,District - Dima Hasao (16),Urban,20-24,6480,3254,3226,243,3139,1447,268,88,180,33
18,315,District - Dima Hasao (16),Urban,Adolescent (10-19),12964,6535,6429,499,6825,3329,376,171,205,20
18,315,District - Dima Hasao (16),Urban,Youth (15-24),12888,6452,6436,493,6506,3064,449,161,288,50
18,316,District - Cachar (17),Total,All Ages,1736617,886284,850333,264897,17569,8736,562489,246338,316151,37204
18,316,District - Cachar (17),Total,10-14,188152,96099,92053,29385,1776,899,16673,7537,9136,429
18,316,District - Cachar (17),Total,15-19,176440,90121,86319,27071,1724,856,19096,8208,10888,2968
18,316,District - Cachar (17),Total,20-24,163281,81137,82144,25071,1718,779,22195,8164,14031,4296
18,316,District - Cachar (17),Total,Adolescent (10-19),364592,186220,178372,56456,3500,1755,35769,15745,20024,3397
18,316,District - Cachar (17),Total,Youth (15-24),339721,171258,168463,52142,3442,1635,41291,16372,24919,7264
18,316,District - Cachar (17),Rural,All Ages,1421153,727083,694070,216090,16613,8237,497417,217462,279955,36472
18,316,District - Cachar (17),Rural,10-14,160223,81714,78509,24167,1641,828,15185,6818,8367,422
18,316,District - Cachar (17),Rural,15-19,147659,75666,71993,22287,1619,799,17451,7517,9934,2946
18,316,District - Cachar (17),Rural,20-24,132726,66211,66515,20349,1640,743,19981,7326,12655,4219
18,316,District - Cachar (17),Rural,Adolescent (10-19),307882,157380,150502,46454,3260,1627,32636,14335,18301,3368
18,316,District - Cachar (17),Rural,Youth (15-24),280385,141877,138508,42636,3259,1542,37432,14843,22589,7165
18,316,District - Cachar (17),Urban,All Ages,315464,159201,156263,48807,956,499,65072,28876,36196,732
18,316,District - Cachar (17),Urban,10-14,27929,14385,13544,5218,135,71,1488,719,769,7
18,316,District - Cachar (17),Urban,15-19,28781,14455,14326,4784,105,57,1645,691,954,22
18,316,District - Cachar (17),Urban,20-24,30555,14926,15629,4722,78,36,2214,838,1376,77
18,316,District - Cachar (17),Urban,Adolescent (10-19),56710,28840,27870,10002,240,128,3133,1410,1723,29
18,316,District - Cachar (17),Urban,Youth (15-24),59336,29381,29955,9506,183,93,3859,1529,2330,99
18,317,District - Karimganj (18),Total,All Ages,1228686,625864,602822,157890,1940,994,433389,189922,243467,36618
18,317,District - Karimganj (18),Total,10-14,139930,71147,68783,17285,220,111,12354,5888,6466,536
18,317,District - Karimganj (18),Total,15-19,123965,62775,61190,16446,188,100,13870,6107,7763,3471
18,317,District - Karimganj (18),Total,20-24,112858,56340,56518,15161,194,93,16745,6248,10497,5057
18,317,District - Karimganj (18),Total,Adolescent (10-19),263895,133922,129973,33731,408,211,26224,11995,14229,4007
18,317,District - Karimganj (18),Total,Youth (15-24),236823,119115,117708,31607,382,193,30615,12355,18260,8528
18,317,District - Karimganj (18),Rural,All Ages,1118986,570510,548476,144169,1660,854,414726,181664,233062,36287
18,317,District - Karimganj (18),Rural,10-14,130615,66389,64226,16130,184,95,12052,5724,6328,536
18,317,District - Karimganj (18),Rural,15-19,114112,57863,56249,15111,168,91,13533,5962,7571,3450
18,317,District - Karimganj (18),Rural,20-24,102524,51359,51165,13685,156,74,16353,6107,10246,5022
18,317,District - Karimganj (18),Rural,Adolescent (10-19),244727,124252,120475,31241,352,186,25585,11686,13899,3986
18,317,District - Karimganj (18),Rural,Youth (15-24),216636,109222,107414,28796,324,165,29886,12069,17817,8472
18,317,District - Karimganj (18),Urban,All Ages,109700,55354,54346,13721,280,140,18663,8258,10405,331
18,317,District - Karimganj (18),Urban,10-14,9315,4758,4557,1155,36,16,302,164,138,0
18,317,District - Karimganj (18),Urban,15-19,9853,4912,4941,1335,20,9,337,145,192,21
18,317,District - Karimganj (18),Urban,20-24,10334,4981,5353,1476,38,19,392,141,251,35
18,317,District - Karimganj (18),Urban,Adolescent (10-19),19168,9670,9498,2490,56,25,639,309,330,21
18,317,District - Karimganj (18),Urban,Youth (15-24),20187,9893,10294,2811,58,28,729,286,443,56
18,318,District - Hailakandi (19),Total,All Ages,659296,337890,321406,70659,691,354,251930,111054,140876,17718
18,318,District - Hailakandi (19),Total,10-14,78267,39661,38606,7875,76,36,8958,4135,4823,280
18,318,District - Hailakandi (19),Total,15-19,68236,35153,33083,7204,61,33,9648,4279,5369,1642
18,318,District - Hailakandi (19),Total,20-24,58960,29856,29104,6491,60,29,11244,4135,7109,2330
18,318,District - Hailakandi (19),Total,Adolescent (10-19),146503,74814,71689,15079,137,69,18606,8414,10192,1922
18,318,District - Hailakandi (19),Total,Youth (15-24),127196,65009,62187,13695,121,62,20892,8414,12478,3972
18,318,District - Hailakandi (19),Rural,All Ages,611156,313747,297409,65736,529,271,244194,107658,136536,17611
18,318,District - Hailakandi (19),Rural,10-14,73963,37461,36502,7352,61,26,8790,4068,4722,278
18,318,District - Hailakandi (19),Rural,15-19,63789,32910,30879,6716,50,28,9496,4214,5282,1635
18,318,District - Hailakandi (19),Rural,20-24,54441,27617,26824,6039,48,23,11045,4066,6979,2320
18,318,District - Hailakandi (19),Rural,Adolescent (10-19),137752,70371,67381,14068,111,54,18286,8282,10004,1913
18,318,District - Hailakandi (19),Rural,Youth (15-24),118230,60527,57703,12755,98,51,20541,8280,12261,3955
18,318,District - Hailakandi (19),Urban,All Ages,48140,24143,23997,4923,162,83,7736,3396,4340,107
18,318,District - Hailakandi (19),Urban,10-14,4304,2200,2104,523,15,10,168,67,101,2
18,318,District - Hailakandi (19),Urban,15-19,4447,2243,2204,488,11,5,152,65,87,7
18,318,District - Hailakandi (19),Urban,20-24,4519,2239,2280,452,12,6,199,69,130,10
18,318,District - Hailakandi (19),Urban,Adolescent (10-19),8751,4443,4308,1011,26,15,320,132,188,9
18,318,District - Hailakandi (19),Urban,Youth (15-24),8966,4482,4484,940,23,11,351,134,217,17
18,319,District - Bongaigaon (20),Total,All Ages,738804,375818,362986,82784,18835,9377,304726,138704,166022,24914
18,319,District - Bongaigaon (20),Total,10-14,84618,43575,41043,9320,2097,1058,10206,5636,4570,362
18,319,District - Bongaigaon (20),Total,15-19,70896,38537,32359,8506,2049,1022,10852,6034,4818,2076
18,319,District - Bongaigaon (20),Total,20-24,69865,33420,36445,8137,1802,858,16277,6801,9476,3171
18,319,District - Bongaigaon (20),Total,Adolescent (10-19),155514,82112,73402,17826,4146,2080,21058,11670,9388,2438
18,319,District - Bongaigaon (20),Total,Youth (15-24),140761,71957,68804,16643,3851,1880,27129,12835,14294,5247
18,319,District - Bongaigaon (20),Rural,All Ages,628994,319786,309208,67460,15267,7574,281125,128628,152497,24623
18,319,District - Bongaigaon (20),Rural,10-14,75032,38560,36472,7905,1715,846,9725,5401,4324,359
18,319,District - Bongaigaon (20),Rural,15-19,60834,33449,27385,6978,1648,822,10206,5787,4419,2059
18,319,District - Bongaigaon (20),Rural,20-24,59068,28181,30887,6494,1432,680,15345,6467,8878,3140
18,319,District - Bongaigaon (20),Rural,Adolescent (10-19),135866,72009,63857,14883,3363,1668,19931,11188,8743,2418
18,319,District - Bongaigaon (20),Rural,Youth (15-24),119902,61630,58272,13472,3080,1502,25551,12254,13297,5199
18,319,District - Bongaigaon (20),Urban,All Ages,109810,56032,53778,15324,3568,1803,23601,10076,13525,291
18,319,District - Bongaigaon (20),Urban,10-14,9586,5015,4571,1415,382,212,481,235,246,3
18,319,District - Bongaigaon (20),Urban,15-19,10062,5088,4974,1528,401,200,646,247,399,17
18,319,District - Bongaigaon (20),Urban,20-24,10797,5239,5558,1643,370,178,932,334,598,31
18,319,District - Bongaigaon (20),Urban,Adolescent (10-19),19648,10103,9545,2943,783,412,1127,482,645,20
18,319,District - Bongaigaon (20),Urban,Youth (15-24),20859,10327,10532,3171,771,378,1578,581,997,48
18,320,District - Chirang (21),Total,All Ages,482162,244860,237302,35135,178688,89273,222260,98991,123269,15896
18,320,District - Chirang (21),Total,10-14,57354,29315,28039,4318,21224,10780,7942,4030,3912,217
18,320,District - Chirang (21),Total,15-19,49625,25908,23717,3611,19598,9895,8719,4095,4624,1069
18,320,District - Chirang (21),Total,20-24,43470,20989,22481,3117,16190,7445,11664,4435,7229,1771
18,320,District - Chirang (21),Total,Adolescent (10-19),106979,55223,51756,7929,40822,20675,16661,8125,8536,1286
18,320,District - Chirang (21),Total,Youth (15-24),93095,46897,46198,6728,35788,17340,20383,8530,11853,2840
18,320,District - Chirang (21),Rural,All Ages,446825,226895,219930,31362,176423,88167,212362,94793,117569,15815
18,320,District - Chirang (21),Rural,10-14,53921,27582,26339,3952,21003,10665,7646,3883,3763,217
18,320,District - Chirang (21),Rural,15-19,46370,24222,22148,3240,19348,9771,8470,3986,4484,1067
18,320,District - Chirang (21),Rural,20-24,40081,19289,20792,2733,15930,7330,11278,4281,6997,1766
18,320,District - Chirang (21),Rural,Adolescent (10-19),100291,51804,48487,7192,40351,20436,16116,7869,8247,1284
18,320,District - Chirang (21),Rural,Youth (15-24),86451,43511,42940,5973,35278,17101,19748,8267,11481,2833
18,320,District - Chirang (21),Urban,All Ages,35337,17965,17372,3773,2265,1106,9898,4198,5700,81
18,320,District - Chirang (21),Urban,10-14,3433,1733,1700,366,221,115,296,147,149,0
18,320,District - Chirang (21),Urban,15-19,3255,1686,1569,371,250,124,249,109,140,2
18,320,District - Chirang (21),Urban,20-24,3389,1700,1689,384,260,115,386,154,232,5
18,320,District - Chirang (21),Urban,Adolescent (10-19),6688,3419,3269,737,471,239,545,256,289,2
18,320,District - Chirang (21),Urban,Youth (15-24),6644,3386,3258,755,510,239,635,263,372,7
18,321,District - Kamrup (22),Total,All Ages,1517542,778461,739081,107827,182038,92094,522223,228242,293981,42121
18,321,District - Kamrup (22),Total,10-14,164088,84230,79858,11875,19677,9995,16351,8517,7834,689
18,321,District - Kamrup (22),Total,15-19,148648,78960,69688,11122,19162,10035,16595,8514,8081,3040
18,321,District - Kamrup (22),Total,20-24,144435,71198,73237,10607,17129,8070,22771,8753,14018,4887
18,321,District - Kamrup (22),Total,Adolescent (10-19),312736,163190,149546,22997,38839,20030,32946,17031,15915,3729
18,321,District - Kamrup (22),Total,Youth (15-24),293083,150158,142925,21729,36291,18105,39366,17267,22099,7927
18,321,District - Kamrup (22),Rural,All Ages,1375148,706140,669008,88975,180192,91154,493366,216533,276833,40859
18,321,District - Kamrup (22),Rural,10-14,151110,77622,73488,10087,19498,9901,15936,8318,7618,683
18,321,District - Kamrup (22),Rural,15-19,134547,71770,62777,9212,18972,9938,16091,8293,7798,2959
18,321,District - Kamrup (22),Rural,20-24,129373,63666,65707,8537,16942,7981,22083,8517,13566,4783
18,321,District - Kamrup (22),Rural,Adolescent (10-19),285657,149392,136265,19299,38470,19839,32027,16611,15416,3642
18,321,District - Kamrup (22),Rural,Youth (15-24),263920,135436,128484,17749,35914,17919,38174,16810,21364,7742
18,321,District - Kamrup (22),Urban,All Ages,142394,72321,70073,18852,1846,940,28857,11709,17148,1262
18,321,District - Kamrup (22),Urban,10-14,12978,6608,6370,1788,179,94,415,199,216,6
18,321,District - Kamrup (22),Urban,15-19,14101,7190,6911,1910,190,97,504,221,283,81
18,321,District - Kamrup (22),Urban,20-24,15062,7532,7530,2070,187,89,688,236,452,104
18,321,District - Kamrup (22),Urban,Adolescent (10-19),27079,13798,13281,3698,369,191,919,420,499,87
18,321,District - Kamrup (22),Urban,Youth (15-24),29163,14722,14441,3980,377,186,1192,457,735,185
18,322,District - Kamrup Metropolitan (23),Total,All Ages,1253938,647585,606353,101789,75121,37902,252747,110358,142389,8259
18,322,District - Kamrup Metropolitan (23),Total,10-14,109683,56136,53547,10219,7159,3564,6290,2843,3447,90
18,322,District - Kamrup Metropolitan (23),Total,15-19,112387,57893,54494,10308,7476,3764,6751,2772,3979,539
18,322,District - Kamrup Metropolitan (23),Total,20-24,124612,62083,62529,10631,8082,3963,8883,3184,5699,832
18,322,District - Kamrup Metropolitan (23),Total,Adolescent (10-19),222070,114029,108041,20527,14635,7328,13041,5615,7426,629
18,322,District - Kamrup Metropolitan (23),Total,Youth (15-24),236999,119976,117023,20939,15558,7727,15634,5956,9678,1371
18,322,District - Kamrup Metropolitan (23),Rural,All Ages,216927,111062,105865,33499,29574,14731,71986,30959,41027,5783
18,322,District - Kamrup Metropolitan (23),Rural,10-14,23411,11853,11558,4000,3140,1575,2274,1078,1196,56
18,322,District - Kamrup Metropolitan (23),Rural,15-19,21915,11185,10730,3462,2986,1497,2221,941,1280,424
18,322,District - Kamrup Metropolitan (23),Rural,20-24,21869,10830,11039,3159,2973,1400,3067,1119,1948,626
18,322,District - Kamrup Metropolitan (23),Rural,Adolescent (10-19),45326,23038,22288,7462,6126,3072,4495,2019,2476,480
18,322,District - Kamrup Metropolitan (23),Rural,Youth (15-24),43784,22015,21769,6621,5959,2897,5288,2060,3228,1050
18,322,District - Kamrup Metropolitan (23),Urban,All Ages,1037011,536523,500488,68290,45547,23171,180761,79399,101362,2476
18,322,District - Kamrup Metropolitan (23),Urban,10-14,86272,44283,41989,6219,4019,1989,4016,1765,2251,34
18,322,District - Kamrup Metropolitan (23),Urban,15-19,90472,46708,43764,6846,4490,2267,4530,1831,2699,115
18,322,District - Kamrup Metropolitan (23),Urban,20-24,102743,51253,51490,7472,5109,2563,5816,2065,3751,206
18,322,District - Kamrup Metropolitan (23),Urban,Adolescent (10-19),176744,90991,85753,13065,8509,4256,8546,3596,4950,149
18,322,District - Kamrup Metropolitan (23),Urban,Youth (15-24),193215,97961,95254,14318,9599,4830,10346,3896,6450,321
18,323,District - Nalbari (24),Total,All Ages,771639,396006,375633,60216,23364,11692,239868,102822,137046,19603
18,323,District - Nalbari (24),Total,10-14,81286,41415,39871,6273,2601,1317,7146,3553,3593,171
18,323,District - Nalbari (24),Total,15-19,74719,38941,35778,6251,2571,1296,6769,3395,3374,1062
18,323,District - Nalbari (24),Total,20-24,73124,36417,36707,6204,2217,1066,8833,3198,5635,1915
18,323,District - Nalbari (24),Total,Adolescent (10-19),156005,80356,75649,12524,5172,2613,13915,6948,6967,1233
18,323,District - Nalbari (24),Total,Youth (15-24),147843,75358,72485,12455,4788,2362,15602,6593,9009,2977
18,323,District - Nalbari (24),Rural,All Ages,688909,353677,335232,54232,23003,11511,224698,96537,128161,18931
18,323,District - Nalbari (24),Rural,10-14,73936,37654,36282,5682,2574,1299,6940,3449,3491,170
18,323,District - Nalbari (24),Rural,15-19,67022,35041,31981,5622,2524,1271,6533,3283,3250,1038
18,323,District - Nalbari (24),Rural,20-24,65072,32446,32626,5533,2181,1052,8523,3077,5446,1875
18,323,District - Nalbari (24),Rural,Adolescent (10-19),140958,72695,68263,11304,5098,2570,13473,6732,6741,1208
18,323,District - Nalbari (24),Rural,Youth (15-24),132094,67487,64607,11155,4705,2323,15056,6360,8696,2913
18,323,District - Nalbari (24),Urban,All Ages,82730,42329,40401,5984,361,181,15170,6285,8885,672
18,323,District - Nalbari (24),Urban,10-14,7350,3761,3589,591,27,18,206,104,102,1
18,323,District - Nalbari (24),Urban,15-19,7697,3900,3797,629,47,25,236,112,124,24
18,323,District - Nalbari (24),Urban,20-24,8052,3971,4081,671,36,14,310,121,189,40
18,323,District - Nalbari (24),Urban,Adolescent (10-19),15047,7661,7386,1220,74,43,442,216,226,25
18,323,District - Nalbari (24),Urban,Youth (15-24),15749,7871,7878,1300,83,39,546,233,313,64
18,324,District - Baksa (25),Total,All Ages,950075,481330,468745,73083,331007,165634,377238,158716,218522,44447
18,324,District - Baksa (25),Total,10-14,105760,53778,51982,8209,36432,18452,10496,4984,5512,423
18,324,District - Baksa (25),Total,15-19,97629,50442,47187,7549,34733,17513,11779,5118,6661,2542
18,324,District - Baksa (25),Total,20-24,87953,42900,45053,6966,30233,14163,15986,5681,10305,4515
18,324,District - Baksa (25),Total,Adolescent (10-19),203389,104220,99169,15758,71165,35965,22275,10102,12173,2965
18,324,District - Baksa (25),Total,Youth (15-24),185582,93342,92240,14515,64966,31676,27765,10799,16966,7057
18,324,District - Baksa (25),Rural,All Ages,937833,475027,462806,71382,329894,165084,372973,156847,216126,44290
18,324,District - Baksa (25),Rural,10-14,104431,53108,51323,8020,36302,18394,10348,4907,5441,421
18,324,District - Baksa (25),Rural,15-19,96361,49761,46600,7376,34613,17453,11631,5036,6595,2534
18,324,District - Baksa (25),Rural,20-24,86798,42328,44470,6770,30141,14122,15788,5593,10195,4506
18,324,District - Baksa (25),Rural,Adolescent (10-19),200792,102869,97923,15396,70915,35847,21979,9943,12036,2955
18,324,District - Baksa (25),Rural,Youth (15-24),183159,92089,91070,14146,64754,31575,27419,10629,16790,7040
18,324,District - Baksa (25),Urban,All Ages,12242,6303,5939,1701,1113,550,4265,1869,2396,157
18,324,District - Baksa (25),Urban,10-14,1329,670,659,189,130,58,148,77,71,2
18,324,District - Baksa (25),Urban,15-19,1268,681,587,173,120,60,148,82,66,8
18,324,District - Baksa (25),Urban,20-24,1155,572,583,196,92,41,198,88,110,9
18,324,District - Baksa (25),Urban,Adolescent (10-19),2597,1351,1246,362,250,118,296,159,137,10
18,324,District - Baksa (25),Urban,Youth (15-24),2423,1253,1170,369,212,101,346,170,176,17
18,325,District - Darrang (26),Total,All Ages,928500,475273,453227,40260,8419,4300,441461,206607,234854,46418
18,325,District - Darrang (26),Total,10-14,109659,56408,53251,4476,937,470,21131,11994,9137,1127
18,325,District - Darrang (26),Total,15-19,84706,45938,38768,4178,934,491,18665,10480,8185,4322
18,325,District - Darrang (26),Total,20-24,80066,38805,41261,3923,820,422,24338,10218,14120,5719
18,325,District - Darrang (26),Total,Adolescent (10-19),194365,102346,92019,8654,1871,961,39796,22474,17322,5449
18,325,District - Darrang (26),Total,Youth (15-24),164772,84743,80029,8101,1754,913,43003,20698,22305,10041
18,325,District - Darrang (26),Rural,All Ages,873006,446460,426546,28746,8025,4090,428931,201149,227782,46293
18,325,District - Darrang (26),Rural,10-14,104406,53721,50685,3244,904,453,20862,11862,9000,1125
18,325,District - Darrang (26),Rural,15-19,79633,43280,36353,3077,888,464,18322,10332,7990,4318
18,325,District - Darrang (26),Rural,20-24,74927,36155,38772,2747,782,400,23897,10049,13848,5712
18,325,District - Darrang (26),Rural,Adolescent (10-19),184039,97001,87038,6321,1792,917,39184,22194,16990,5443
18,325,District - Darrang (26),Rural,Youth (15-24),154560,79435,75125,5824,1670,864,42219,20381,21838,10030
18,325,District - Darrang (26),Urban,All Ages,55494,28813,26681,11514,394,210,12530,5458,7072,125
18,325,District - Darrang (26),Urban,10-14,5253,2687,2566,1232,33,17,269,132,137,2
18,325,District - Darrang (26),Urban,15-19,5073,2658,2415,1101,46,27,343,148,195,4
18,325,District - Darrang (26),Urban,20-24,5139,2650,2489,1176,38,22,441,169,272,7
18,325,District - Darrang (26),Urban,Adolescent (10-19),10326,5345,4981,2333,79,44,612,280,332,6
18,325,District - Darrang (26),Urban,Youth (15-24),10212,5308,4904,2277,84,49,784,317,467,11
18,326,District - Udalguri (27),Total,All Ages,831668,421617,410051,37844,267372,133550,361742,157291,204451,36120
18,326,District - Udalguri (27),Total,10-14,93111,47300,45811,4316,29034,14723,12878,6206,6672,600
18,326,District - Udalguri (27),Total,15-19,82688,42098,40590,3951,27107,13526,13968,6291,7677,2616
18,326,District - Udalguri (27),Total,20-24,78545,38259,40286,3778,25587,11928,18132,6661,11471,4079
18,326,District - Udalguri (27),Total,Adolescent (10-19),175799,89398,86401,8267,56141,28249,26846,12497,14349,3216
18,326,District - Udalguri (27),Total,Youth (15-24),161233,80357,80876,7729,52694,25454,32100,12952,19148,6695
18,326,District - Udalguri (27),Rural,All Ages,794094,402442,391652,34086,262985,131381,353077,153579,199498,36022
18,326,District - Udalguri (27),Rural,10-14,89520,45457,44063,3957,28556,14475,12701,6133,6568,599
18,326,District - Udalguri (27),Rural,15-19,79053,40234,38819,3527,26672,13308,13733,6166,7567,2613
18,326,District - Udalguri (27),Rural,20-24,74837,36400,38437,3376,25157,11724,17829,6545,11284,4070
18,326,District - Udalguri (27),Rural,Adolescent (10-19),168573,85691,82882,7484,55228,27783,26434,12299,14135,3212
18,326,District - Udalguri (27),Rural,Youth (15-24),153890,76634,77256,6903,51829,25032,31562,12711,18851,6683
18,326,District - Udalguri (27),Urban,All Ages,37574,19175,18399,3758,4387,2169,8665,3712,4953,98
18,326,District - Udalguri (27),Urban,10-14,3591,1843,1748,359,478,248,177,73,104,1
18,326,District - Udalguri (27),Urban,15-19,3635,1864,1771,424,435,218,235,125,110,3
18,326,District - Udalguri (27),Urban,20-24,3708,1859,1849,402,430,204,303,116,187,9
18,326,District - Udalguri (27),Urban,Adolescent (10-19),7226,3707,3519,783,913,466,412,198,214,4
18,326,District - Udalguri (27),Urban,Youth (15-24),7343,3723,3620,826,865,422,538,241,297,12
19,0,State - WEST BENGAL (19),Total,All Ages,91276115,46809027,44467088,21463270,5296953,2649974,29737834,12990217,16747617,5869498
19,0,State - WEST BENGAL (19),Total,10-14,9156523,4677506,4479017,2232479,584485,298029,664105,345247,318858,49735
19,0,State - WEST BENGAL (19),Total,15-19,9058031,4702325,4355706,2201600,557709,287680,920412,433597,486815,387898
19,0,State - WEST BENGAL (19),Total,20-24,8758322,4422630,4335692,2143811,524872,255794,1351813,553798,798015,732515
19,0,State - WEST BENGAL (19),Total,Adolescent (10-19),18214554,9379831,8834723,4434079,1142194,585709,1584517,778844,805673,437633
19,0,State - WEST BENGAL (19),Total,Youth (15-24),17816353,9124955,8691398,4345411,1082581,543474,2272225,987395,1284830,1120413
19,0,State - WEST BENGAL (19),Rural,All Ages,62183113,31844945,30338168,17095107,4855115,2428057,22969334,9996748,12972586,5640355
19,0,State - WEST BENGAL (19),Rural,10-14,6677094,3401028,3276066,1822788,539779,275145,510218,264490,245728,47993
19,0,State - WEST BENGAL (19),Rural,15-19,6442695,3359604,3083091,1765428,510725,263879,713805,333875,379930,375192
19,0,State - WEST BENGAL (19),Rural,20-24,6042721,3062672,2980049,1694312,478402,233321,1069198,432966,636232,707607
19,0,State - WEST BENGAL (19),Rural,Adolescent (10-19),13119789,6760632,6359157,3588216,1050504,539024,1224023,598365,625658,423185
19,0,State - WEST BENGAL (19),Rural,Youth (15-24),12485416,6422276,6063140,3459740,989127,497200,1783003,766841,1016162,1082799
19,0,State - WEST BENGAL (19),Urban,All Ages,29093002,14964082,14128920,4368163,441838,221917,6768500,2993469,3775031,229143
19,0,State - WEST BENGAL (19),Urban,10-14,2479429,1276478,1202951,409691,44706,22884,153887,80757,73130,1742
19,0,State - WEST BENGAL (19),Urban,15-19,2615336,1342721,1272615,436172,46984,23801,206607,99722,106885,12706
19,0,State - WEST BENGAL (19),Urban,20-24,2715601,1359958,1355643,449499,46470,22473,282615,120832,161783,24908
19,0,State - WEST BENGAL (19),Urban,Adolescent (10-19),5094765,2619199,2475566,845863,91690,46685,360494,180479,180015,14448
19,0,State - WEST BENGAL (19),Urban,Youth (15-24),5330937,2702679,2628258,885671,93454,46274,489222,220554,268668,37614
19,327,District - Darjiling (01),Total,All Ages,1846823,937259,909564,317275,397389,197251,531238,219586,311652,32087
19,327,District - Darjiling (01),Total,10-14,188142,95990,92152,34784,40850,20720,8573,4094,4479,274
19,327,District - Darjiling (01),Total,15-19,188383,96495,91888,35072,42358,21309,12749,5345,7404,1694
19,327,District - Darjiling (01),Total,20-24,184729,90723,94006,32394,41313,19619,20716,7158,13558,3396
19,327,District - Darjiling (01),Total,Adolescent (10-19),376525,192485,184040,69856,83208,42029,21322,9439,11883,1968
19,327,District - Darjiling (01),Total,Youth (15-24),373112,187218,185894,67466,83671,40928,33465,12503,20962,5090
19,327,District - Darjiling (01),Rural,All Ages,1118860,566965,551895,224822,319069,158918,382036,156183,225853,29958
19,327,District - Darjiling (01),Rural,10-14,118050,59905,58145,25083,33723,17060,6016,2877,3139,265
19,327,District - Darjiling (01),Rural,15-19,120321,61456,58865,25257,34742,17409,9369,3843,5526,1619
19,327,District - Darjiling (01),Rural,20-24,115814,57038,58776,23045,33551,16000,15847,5312,10535,3223
19,327,District - Darjiling (01),Rural,Adolescent (10-19),238371,121361,117010,50340,68465,34469,15385,6720,8665,1884
19,327,District - Darjiling (01),Rural,Youth (15-24),236135,118494,117641,48302,68293,33409,25216,9155,16061,4842
19,327,District - Darjiling (01),Urban,All Ages,727963,370294,357669,92453,78320,38333,149202,63403,85799,2129
19,327,District - Darjiling (01),Urban,10-14,70092,36085,34007,9701,7127,3660,2557,1217,1340,9
19,327,District - Darjiling (01),Urban,15-19,68062,35039,33023,9815,7616,3900,3380,1502,1878,75
19,327,District - Darjiling (01),Urban,20-24,68915,33685,35230,9349,7762,3619,4869,1846,3023,173
19,327,District - Darjiling (01),Urban,Adolescent (10-19),138154,71124,67030,19516,14743,7560,5937,2719,3218,84
19,327,District - Darjiling (01),Urban,Youth (15-24),136977,68724,68253,19164,15378,7519,8249,3348,4901,248
19,328,District - Jalpaiguri (02),Total,All Ages,3872846,1983064,1889782,1458278,731704,365868,1374066,586442,787624,212657
19,328,District - Jalpaiguri (02),Total,10-14,406444,206398,200046,157342,83655,42273,21161,10664,10497,1089
19,328,District - Jalpaiguri (02),Total,15-19,418483,213181,205302,161574,84869,42409,33759,15077,18682,10497
19,328,District - Jalpaiguri (02),Total,20-24,406785,204429,202356,155284,79346,37571,60549,21800,38749,24487
19,328,District - Jalpaiguri (02),Total,Adolescent (10-19),824927,419579,405348,318916,168524,84682,54920,25741,29179,11586
19,328,District - Jalpaiguri (02),Total,Youth (15-24),825268,417610,407658,316858,164215,79980,94308,36877,57431,34984
19,328,District - Jalpaiguri (02),Rural,All Ages,2812495,1437286,1375209,1159391,690312,345035,1096191,464930,631261,201001
19,328,District - Jalpaiguri (02),Rural,10-14,308351,156282,152069,125221,79077,39884,16367,8092,8275,1032
19,328,District - Jalpaiguri (02),Rural,15-19,318503,161810,156693,129807,80368,40161,27185,11977,15208,9950
19,328,District - Jalpaiguri (02),Rural,20-24,302332,152584,149748,124227,74917,35469,49777,17592,32185,23280
19,328,District - Jalpaiguri (02),Rural,Adolescent (10-19),626854,318092,308762,255028,159445,80045,43552,20069,23483,10982
19,328,District - Jalpaiguri (02),Rural,Youth (15-24),620835,314394,306441,254034,155285,75630,76962,29569,47393,33230
19,328,District - Jalpaiguri (02),Urban,All Ages,1060351,545778,514573,298887,41392,20833,277875,121512,156363,11656
19,328,District - Jalpaiguri (02),Urban,10-14,98093,50116,47977,32121,4578,2389,4794,2572,2222,57
19,328,District - Jalpaiguri (02),Urban,15-19,99980,51371,48609,31767,4501,2248,6574,3100,3474,547
19,328,District - Jalpaiguri (02),Urban,20-24,104453,51845,52608,31057,4429,2102,10772,4208,6564,1207
19,328,District - Jalpaiguri (02),Urban,Adolescent (10-19),198073,101487,96586,63888,9079,4637,11368,5672,5696,604
19,328,District - Jalpaiguri (02),Urban,Youth (15-24),204433,103216,101217,62824,8930,4350,17346,7308,10038,1754
19,329,District - Koch Bihar (03),Total,All Ages,2819086,1451542,1367544,1414336,18125,9388,968582,422809,545773,272435
19,329,District - Koch Bihar (03),Total,10-14,299043,152091,146952,148720,2063,1056,12595,6722,5873,1982
19,329,District - Koch Bihar (03),Total,15-19,295924,155156,140768,151025,1969,1039,18333,9153,9180,17202
19,329,District - Koch Bihar (03),Total,20-24,280811,145285,135526,141609,1858,960,32415,13601,18814,32374
19,329,District - Koch Bihar (03),Total,Adolescent (10-19),594967,307247,287720,299745,4032,2095,30928,15875,15053,19184
19,329,District - Koch Bihar (03),Total,Youth (15-24),576735,300441,276294,292634,3827,1999,50748,22754,27994,49576
19,329,District - Koch Bihar (03),Rural,All Ages,2529652,1304916,1224736,1350657,16872,8735,912429,398524,513905,269929
19,329,District - Koch Bihar (03),Rural,10-14,275827,140265,135562,142866,1952,998,11878,6360,5518,1969
19,329,District - Koch Bihar (03),Rural,15-19,271242,142670,128572,144769,1848,973,17358,8711,8647,17083
19,329,District - Koch Bihar (03),Rural,20-24,253607,132034,121573,135005,1707,890,30759,12930,17829,32116
19,329,District - Koch Bihar (03),Rural,Adolescent (10-19),547069,282935,264134,287635,3800,1971,29236,15071,14165,19052
19,329,District - Koch Bihar (03),Rural,Youth (15-24),524849,274704,250145,279774,3555,1863,48117,21641,26476,49199
19,329,District - Koch Bihar (03),Urban,All Ages,289434,146626,142808,63679,1253,653,56153,24285,31868,2506
19,329,District - Koch Bihar (03),Urban,10-14,23216,11826,11390,5854,111,58,717,362,355,13
19,329,District - Koch Bihar (03),Urban,15-19,24682,12486,12196,6256,121,66,975,442,533,119
19,329,District - Koch Bihar (03),Urban,20-24,27204,13251,13953,6604,151,70,1656,671,985,258
19,329,District - Koch Bihar (03),Urban,Adolescent (10-19),47898,24312,23586,12110,232,124,1692,804,888,132
19,329,District - Koch Bihar (03),Urban,Youth (15-24),51886,25737,26149,12860,272,136,2631,1113,1518,377
19,330,District - Uttar Dinajpur (04),Total,All Ages,3007134,1551066,1456068,807950,162816,81831,1517467,697571,819896,294195
19,330,District - Uttar Dinajpur (04),Total,10-14,396320,202042,194278,99848,20184,10371,71804,36199,35605,4115
19,330,District - Uttar Dinajpur (04),Total,15-19,313924,165132,148792,84196,14825,7799,74369,35389,38980,23017
19,330,District - Uttar Dinajpur (04),Total,20-24,260807,135557,125250,72266,13556,6527,88445,36820,51625,35496
19,330,District - Uttar Dinajpur (04),Total,Adolescent (10-19),710244,367174,343070,184044,35009,18170,146173,71588,74585,27132
19,330,District - Uttar Dinajpur (04),Total,Youth (15-24),574731,300689,274042,156462,28381,14326,162814,72209,90605,58513
19,330,District - Uttar Dinajpur (04),Rural,All Ages,2644906,1362469,1282437,741154,158377,79631,1411617,648828,762789,290440
19,330,District - Uttar Dinajpur (04),Rural,10-14,355686,180295,175391,91877,19593,10074,66689,33609,33080,4044
19,330,District - Uttar Dinajpur (04),Rural,15-19,281105,147386,133719,77557,14414,7601,70426,33566,36860,22724
19,330,District - Uttar Dinajpur (04),Rural,20-24,227650,118761,108889,65758,13152,6330,83779,34942,48837,35059
19,330,District - Uttar Dinajpur (04),Rural,Adolescent (10-19),636791,327681,309110,169434,34007,17675,137115,67175,69940,26768
19,330,District - Uttar Dinajpur (04),Rural,Youth (15-24),508755,266147,242608,143315,27566,13931,154205,68508,85697,57783
19,330,District - Uttar Dinajpur (04),Urban,All Ages,362228,188597,173631,66796,4439,2200,105850,48743,57107,3755
19,330,District - Uttar Dinajpur (04),Urban,10-14,40634,21747,18887,7971,591,297,5115,2590,2525,71
19,330,District - Uttar Dinajpur (04),Urban,15-19,32819,17746,15073,6639,411,198,3943,1823,2120,293
19,330,District - Uttar Dinajpur (04),Urban,20-24,33157,16796,16361,6508,404,197,4666,1878,2788,437
19,330,District - Uttar Dinajpur (04),Urban,Adolescent (10-19),73453,39493,33960,14610,1002,495,9058,4413,4645,364
19,330,District - Uttar Dinajpur (04),Urban,Youth (15-24),65976,34542,31434,13147,815,395,8609,3701,4908,730
19,331,District - Dakshin Dinajpur (05),Total,All Ages,1676276,857199,819077,482754,275366,138025,592591,260725,331866,174690
19,331,District - Dakshin Dinajpur (05),Total,10-14,184947,94151,90796,55131,33107,16964,9938,5137,4801,1978
19,331,District - Dakshin Dinajpur (05),Total,15-19,173247,91640,81607,50702,27757,14638,14718,7137,7581,11852
19,331,District - Dakshin Dinajpur (05),Total,20-24,154886,78486,76400,44595,24269,11994,24599,9992,14607,20579
19,331,District - Dakshin Dinajpur (05),Total,Adolescent (10-19),358194,185791,172403,105833,60864,31602,24656,12274,12382,13830
19,331,District - Dakshin Dinajpur (05),Total,Youth (15-24),328133,170126,158007,95297,52026,26632,39317,17129,22188,32431
19,331,District - Dakshin Dinajpur (05),Rural,All Ages,1439981,737771,702210,440182,267913,134311,549320,242174,307146,172665
19,331,District - Dakshin Dinajpur (05),Rural,10-14,164410,83879,80531,50584,31699,16263,9403,4888,4515,1966
19,331,District - Dakshin Dinajpur (05),Rural,15-19,152425,80909,71516,46026,26888,14189,14008,6820,7188,11741
19,331,District - Dakshin Dinajpur (05),Rural,20-24,134431,68429,66002,40445,23652,11702,23460,9543,13917,20372
19,331,District - Dakshin Dinajpur (05),Rural,Adolescent (10-19),316835,164788,152047,96610,58587,30452,23411,11708,11703,13707
19,331,District - Dakshin Dinajpur (05),Rural,Youth (15-24),286856,149338,137518,86471,50540,25891,37468,16363,21105,32113
19,331,District - Dakshin Dinajpur (05),Urban,All Ages,236295,119428,116867,42572,7453,3714,43271,18551,24720,2025
19,331,District - Dakshin Dinajpur (05),Urban,10-14,20537,10272,10265,4547,1408,701,535,249,286,12
19,331,District - Dakshin Dinajpur (05),Urban,15-19,20822,10731,10091,4676,869,449,710,317,393,111
19,331,District - Dakshin Dinajpur (05),Urban,20-24,20455,10057,10398,4150,617,292,1139,449,690,207
19,331,District - Dakshin Dinajpur (05),Urban,Adolescent (10-19),41359,21003,20356,9223,2277,1150,1245,566,679,123
19,331,District - Dakshin Dinajpur (05),Urban,Youth (15-24),41277,20788,20489,8826,1486,741,1849,766,1083,318
19,332,District - Maldah (06),Total,All Ages,3988845,2051541,1937304,835430,313984,157528,1902413,899522,1002891,322452
19,332,District - Maldah (06),Total,10-14,504830,257234,247596,101281,38266,19631,71910,41099,30811,3598
19,332,District - Maldah (06),Total,15-19,423386,222799,200587,88018,30877,16312,81507,42187,39320,24663
19,332,District - Maldah (06),Total,20-24,373432,190476,182956,77749,28353,13699,110225,48987,61238,42336
19,332,District - Maldah (06),Total,Adolescent (10-19),928216,480033,448183,189299,69143,35943,153417,83286,70131,28261
19,332,District - Maldah (06),Total,Youth (15-24),796818,413275,383543,165767,59230,30011,191732,91174,100558,66999
19,332,District - Maldah (06),Rural,All Ages,3447185,1768336,1678849,767492,307625,154156,1715508,806927,908581,314469
19,332,District - Maldah (06),Rural,10-14,450334,229325,221009,94179,37600,19299,67190,38455,28735,3541
19,332,District - Maldah (06),Rural,15-19,369380,195038,174342,80686,30197,15940,75480,39044,36436,24127
19,332,District - Maldah (06),Rural,20-24,319756,162530,157226,70858,27786,13418,101703,44956,56747,41307
19,332,District - Maldah (06),Rural,Adolescent (10-19),819714,424363,395351,174865,67797,35239,142670,77499,65171,27668
19,332,District - Maldah (06),Rural,Youth (15-24),689136,357568,331568,151544,57983,29358,177183,84000,93183,65434
19,332,District - Maldah (06),Urban,All Ages,541660,283205,258455,67938,6359,3372,186905,92595,94310,7983
19,332,District - Maldah (06),Urban,10-14,54496,27909,26587,7102,666,332,4720,2644,2076,57
19,332,District - Maldah (06),Urban,15-19,54006,27761,26245,7332,680,372,6027,3143,2884,536
19,332,District - Maldah (06),Urban,20-24,53676,27946,25730,6891,567,281,8522,4031,4491,1029
19,332,District - Maldah (06),Urban,Adolescent (10-19),108502,55670,52832,14434,1346,704,10747,5787,4960,593
19,332,District - Maldah (06),Urban,Youth (15-24),107682,55707,51975,14223,1247,653,14549,7174,7375,1565
19,333,District - Murshidabad (07),Total,All Ages,7103807,3627564,3476243,897534,91035,46163,3047973,1450377,1597596,627126
19,333,District - Murshidabad (07),Total,10-14,843488,428602,414886,99820,11361,5826,73660,42619,31041,6358
19,333,District - Murshidabad (07),Total,15-19,786792,408705,378087,94710,9997,5272,110279,57925,52354,50236
19,333,District - Murshidabad (07),Total,20-24,707320,358789,348531,89509,9209,4481,170876,81350,89526,88413
19,333,District - Murshidabad (07),Total,Adolescent (10-19),1630280,837307,792973,194530,21358,11098,183939,100544,83395,56594
19,333,District - Murshidabad (07),Total,Youth (15-24),1494112,767494,726618,184219,19206,9753,281155,139275,141880,138649
19,333,District - Murshidabad (07),Rural,All Ages,5703115,2917822,2785293,727721,86004,43527,2509613,1204137,1305476,604954
19,333,District - Murshidabad (07),Rural,10-14,682727,347296,335431,81564,10785,5525,56229,32850,23379,6079
19,333,District - Murshidabad (07),Rural,15-19,630936,330478,300458,76012,9430,4962,85620,46276,39344,48364
19,333,District - Murshidabad (07),Rural,20-24,567285,288562,278723,72052,8698,4220,137852,67556,70296,85141
19,333,District - Murshidabad (07),Rural,Adolescent (10-19),1313663,677774,635889,157576,20215,10487,141849,79126,62723,54443
19,333,District - Murshidabad (07),Rural,Youth (15-24),1198221,619040,579181,148064,18128,9182,223472,113832,109640,133505
19,333,District - Murshidabad (07),Urban,All Ages,1400692,709742,690950,169813,5031,2636,538360,246240,292120,22172
19,333,District - Murshidabad (07),Urban,10-14,160761,81306,79455,18256,576,301,17431,9769,7662,279
19,333,District - Murshidabad (07),Urban,15-19,155856,78227,77629,18698,567,310,24659,11649,13010,1872
19,333,District - Murshidabad (07),Urban,20-24,140035,70227,69808,17457,511,261,33024,13794,19230,3272
19,333,District - Murshidabad (07),Urban,Adolescent (10-19),316617,159533,157084,36954,1143,611,42090,21418,20672,2151
19,333,District - Murshidabad (07),Urban,Youth (15-24),295891,148454,147437,36155,1078,571,57683,25443,32240,5144
19,334,District - Birbhum (08),Total,All Ages,3502404,1790920,1711484,1033140,242484,119787,1343957,589439,754518,350669
19,334,District - Birbhum (08),Total,10-14,372912,191145,181767,112714,28250,14448,33238,16824,16414,3779
19,334,District - Birbhum (08),Total,15-19,353567,189216,164351,100827,23642,12081,49174,22759,26415,26204
19,334,District - Birbhum (08),Total,20-24,330649,166434,164215,99991,22810,10795,72811,28088,44723,46559
19,334,District - Birbhum (08),Total,Adolescent (10-19),726479,380361,346118,213541,51892,26529,82412,39583,42829,29983
19,334,District - Birbhum (08),Total,Youth (15-24),684216,355650,328566,200818,46452,22876,121985,50847,71138,72763
19,334,District - Birbhum (08),Rural,All Ages,3052956,1561976,1490980,934054,232666,115022,1220590,536315,684275,343757
19,334,District - Birbhum (08),Rural,10-14,332016,170111,161905,102801,27198,13917,30011,15259,14752,3715
19,334,District - Birbhum (08),Rural,15-19,310481,167079,143402,90538,22584,11532,44477,20710,23767,25594
19,334,District - Birbhum (08),Rural,20-24,287747,145010,142737,89621,21880,10380,66528,25630,40898,45578
19,334,District - Birbhum (08),Rural,Adolescent (10-19),642497,337190,305307,193339,49782,25449,74488,35969,38519,29309
19,334,District - Birbhum (08),Rural,Youth (15-24),598228,312089,286139,180159,44464,21912,111005,46340,64665,71172
19,334,District - Birbhum (08),Urban,All Ages,449448,228944,220504,99086,9818,4765,123367,53124,70243,6912
19,334,District - Birbhum (08),Urban,10-14,40896,21034,19862,9913,1052,531,3227,1565,1662,64
19,334,District - Birbhum (08),Urban,15-19,43086,22137,20949,10289,1058,549,4697,2049,2648,610
19,334,District - Birbhum (08),Urban,20-24,42902,21424,21478,10370,930,415,6283,2458,3825,981
19,334,District - Birbhum (08),Urban,Adolescent (10-19),83982,43171,40811,20202,2110,1080,7924,3614,4310,674
19,334,District - Birbhum (08),Urban,Youth (15-24),85988,43561,42427,20659,1988,964,10980,4507,6473,1591
19,335,District - Barddhaman (09),Total,All Ages,7717563,3966889,3750674,2115719,489447,243581,2470355,1048849,1421506,604286
19,335,District - Barddhaman (09),Total,10-14,724818,371927,352891,217469,53938,27479,47577,23147,24430,5037
19,335,District - Barddhaman (09),Total,15-19,760051,396683,363368,218624,54214,27364,80007,34876,45131,44587
19,335,District - Barddhaman (09),Total,20-24,747485,378406,369079,215157,50939,24898,119940,44837,75103,76726
19,335,District - Barddhaman (09),Total,Adolescent (10-19),1484869,768610,716259,436093,108152,54843,127584,58023,69561,49624
19,335,District - Barddhaman (09),Total,Youth (15-24),1507536,775089,732447,433781,105153,52262,199947,79713,120234,121313
19,335,District - Barddhaman (09),Rural,All Ages,4639264,2373787,2265477,1524133,379262,188349,1640987,702231,938756,579345
19,335,District - Barddhaman (09),Rural,10-14,450430,230766,219664,157902,42091,21494,27450,13473,13977,4842
19,335,District - Barddhaman (09),Rural,15-19,460631,241786,218845,153568,41528,21002,49943,21949,27994,43016
19,335,District - Barddhaman (09),Rural,20-24,441100,223275,217825,150777,38874,18878,78941,29763,49178,73798
19,335,District - Barddhaman (09),Rural,Adolescent (10-19),911061,472552,438509,311470,83619,42496,77393,35422,41971,47858
19,335,District - Barddhaman (09),Rural,Youth (15-24),901731,465061,436670,304345,80402,39880,128884,51712,77172,116814
19,335,District - Barddhaman (09),Urban,All Ages,3078299,1593102,1485197,591586,110185,55232,829368,346618,482750,24941
19,335,District - Barddhaman (09),Urban,10-14,274388,141161,133227,59567,11847,5985,20127,9674,10453,195
19,335,District - Barddhaman (09),Urban,15-19,299420,154897,144523,65056,12686,6362,30064,12927,17137,1571
19,335,District - Barddhaman (09),Urban,20-24,306385,155131,151254,64380,12065,6020,40999,15074,25925,2928
19,335,District - Barddhaman (09),Urban,Adolescent (10-19),573808,296058,277750,124623,24533,12347,50191,22601,27590,1766
19,335,District - Barddhaman (09),Urban,Youth (15-24),605805,310028,295777,129436,24751,12382,71063,28001,43062,4499
19,336,District - Nadia (10),Total,All Ages,5167600,2653768,2513832,1546917,140700,71142,1687045,774902,912143,461580
19,336,District - Nadia (10),Total,10-14,492315,251588,240727,150045,15396,7743,20264,11113,9151,2396
19,336,District - Nadia (10),Total,15-19,505495,264003,241492,159249,15265,8013,35892,18578,17314,26743
19,336,District - Nadia (10),Total,20-24,505782,257352,248430,159795,14650,7296,67763,31925,35838,58162
19,336,District - Nadia (10),Total,Adolescent (10-19),997810,515591,482219,309294,30661,15756,56156,29691,26465,29139
19,336,District - Nadia (10),Total,Youth (15-24),1011277,521355,489922,319044,29915,15309,103655,50503,53152,84905
19,336,District - Nadia (10),Rural,All Ages,3728727,1921112,1807615,1141341,120300,60954,1374641,639676,734965,436720
19,336,District - Nadia (10),Rural,10-14,379881,193999,185882,113063,13402,6749,16820,9266,7554,2304
19,336,District - Nadia (10),Rural,15-19,381588,201097,180491,118709,13109,6989,30259,15824,14435,25606
19,336,District - Nadia (10),Rural,20-24,371206,190440,180766,117481,12284,6169,58173,27837,30336,55464
19,336,District - Nadia (10),Rural,Adolescent (10-19),761469,395096,366373,231772,26511,13738,47079,25090,21989,27910
19,336,District - Nadia (10),Rural,Youth (15-24),752794,391537,361257,236190,25393,13158,88432,43661,44771,81070
19,336,District - Nadia (10),Urban,All Ages,1438873,732656,706217,405576,20400,10188,312404,135226,177178,24860
19,336,District - Nadia (10),Urban,10-14,112434,57589,54845,36982,1994,994,3444,1847,1597,92
19,336,District - Nadia (10),Urban,15-19,123907,62906,61001,40540,2156,1024,5633,2754,2879,1137
19,336,District - Nadia (10),Urban,20-24,134576,66912,67664,42314,2366,1127,9590,4088,5502,2698
19,336,District - Nadia (10),Urban,Adolescent (10-19),236341,120495,115846,77522,4150,2018,9077,4601,4476,1229
19,336,District - Nadia (10),Urban,Youth (15-24),258483,129818,128665,82854,4522,2151,15223,6842,8381,3835
19,337,District - North Twenty Four Parganas (11),Total,All Ages,10009781,5119389,4890392,2169084,264597,134179,2401088,1063343,1337745,434463
19,337,District - North Twenty Four Parganas (11),Total,10-14,876441,448930,427511,197621,27587,13969,46102,24856,21246,3652
19,337,District - North Twenty Four Parganas (11),Total,15-19,928370,472771,455599,208917,27731,14179,61380,30876,30504,27038
19,337,District - North Twenty Four Parganas (11),Total,20-24,961606,480072,481534,220826,27425,13649,89252,40268,48984,55210
19,337,District - North Twenty Four Parganas (11),Total,Adolescent (10-19),1804811,921701,883110,406538,55318,28148,107482,55732,51750,30690
19,337,District - North Twenty Four Parganas (11),Total,Youth (15-24),1889976,952843,937133,429743,55156,27828,150632,71144,79488,82248
19,337,District - North Twenty Four Parganas (11),Rural,All Ages,4277619,2196554,2081065,1252699,196920,99676,1348253,603528,744725,408718
19,337,District - North Twenty Four Parganas (11),Rural,10-14,433364,220760,212604,119221,21582,10872,25662,14486,11176,3447
19,337,District - North Twenty Four Parganas (11),Rural,15-19,460466,233929,226537,124470,21089,10787,36373,18920,17453,25796
19,337,District - North Twenty Four Parganas (11),Rural,20-24,456237,231189,225048,129500,20267,10197,55264,26055,29209,52715
19,337,District - North Twenty Four Parganas (11),Rural,Adolescent (10-19),893830,454689,439141,243691,42671,21659,62035,33406,28629,29243
19,337,District - North Twenty Four Parganas (11),Rural,Youth (15-24),916703,465118,451585,253970,41356,20984,91637,44975,46662,78511
19,337,District - North Twenty Four Parganas (11),Urban,All Ages,5732162,2922835,2809327,916385,67677,34503,1052835,459815,593020,25745
19,337,District - North Twenty Four Parganas (11),Urban,10-14,443077,228170,214907,78400,6005,3097,20440,10370,10070,205
19,337,District - North Twenty Four Parganas (11),Urban,15-19,467904,238842,229062,84447,6642,3392,25007,11956,13051,1242
19,337,District - North Twenty Four Parganas (11),Urban,20-24,505369,248883,256486,91326,7158,3452,33988,14213,19775,2495
19,337,District - North Twenty Four Parganas (11),Urban,Adolescent (10-19),910981,467012,443969,162847,12647,6489,45447,22326,23121,1447
19,337,District - North Twenty Four Parganas (11),Urban,Youth (15-24),973273,487725,485548,175773,13800,6844,58995,26169,32826,3737
19,338,District - Hugli (12),Total,All Ages,5519145,2814653,2704492,1344021,229243,113249,1440757,602876,837881,370014
19,338,District - Hugli (12),Total,10-14,480627,244663,235964,133440,24270,12225,18400,9438,8962,2683
19,338,District - Hugli (12),Total,15-19,507641,259008,248633,138293,25773,13091,31051,14056,16995,23116
19,338,District - Hugli (12),Total,20-24,505273,250851,254422,135772,24266,11793,49284,19267,30017,41895
19,338,District - Hugli (12),Total,Adolescent (10-19),988268,503671,484597,271733,50043,25316,49451,23494,25957,25799
19,338,District - Hugli (12),Total,Youth (15-24),1012914,509859,503055,274065,50039,24884,80335,33323,47012,65011
19,338,District - Hugli (12),Rural,All Ages,3390646,1722945,1667701,1053739,211620,104347,1001102,413178,587924,353405
19,338,District - Hugli (12),Rural,10-14,313493,158418,155075,108091,22544,11337,11231,5795,5436,2597
19,338,District - Hugli (12),Rural,15-19,329488,167911,161577,110232,23923,12127,20707,9152,11555,22311
19,338,District - Hugli (12),Rural,20-24,317620,157813,159807,105868,22404,10924,34316,12953,21363,40459
19,338,District - Hugli (12),Rural,Adolescent (10-19),642981,326329,316652,218323,46467,23464,31938,14947,16991,24908
19,338,District - Hugli (12),Rural,Youth (15-24),647108,325724,321384,216100,46327,23051,55023,22105,32918,62770
19,338,District - Hugli (12),Urban,All Ages,2128499,1091708,1036791,290282,17623,8902,439655,189698,249957,16609
19,338,District - Hugli (12),Urban,10-14,167134,86245,80889,25349,1726,888,7169,3643,3526,86
19,338,District - Hugli (12),Urban,15-19,178153,91097,87056,28061,1850,964,10344,4904,5440,805
19,338,District - Hugli (12),Urban,20-24,187653,93038,94615,29904,1862,869,14968,6314,8654,1436
19,338,District - Hugli (12),Urban,Adolescent (10-19),345287,177342,167945,53410,3576,1852,17513,8547,8966,891
19,338,District - Hugli (12),Urban,Youth (15-24),365806,184135,181671,57965,3712,1833,25312,11218,14094,2241
19,339,District - Bankura (13),Total,All Ages,3596674,1838095,1758579,1174447,368690,183467,1363682,538758,824924,303270
19,339,District - Bankura (13),Total,10-14,357373,183159,174214,128634,37751,19458,27489,11380,16109,2214
19,339,District - Bankura (13),Total,15-19,340595,184570,156025,116040,37038,20134,46189,17729,28460,19744
19,339,District - Bankura (13),Total,20-24,325766,166383,159383,110997,34900,17489,70608,23041,47567,38113
19,339,District - Bankura (13),Total,Adolescent (10-19),697968,367729,330239,244674,74789,39592,73678,29109,44569,21958
19,339,District - Bankura (13),Total,Youth (15-24),666361,350953,315408,227037,71938,37623,116797,40770,76027,57857
19,339,District - Bankura (13),Rural,All Ages,3296901,1685777,1611124,1105653,365380,181734,1294249,511402,782847,300780
19,339,District - Bankura (13),Rural,10-14,332467,170257,162210,121567,37313,19178,25979,10647,15332,2202
19,339,District - Bankura (13),Rural,15-19,314160,171008,143152,108771,36659,19938,43939,16846,27093,19581
19,339,District - Bankura (13),Rural,20-24,298448,152712,145736,103876,34577,17337,67503,21926,45577,37792
19,339,District - Bankura (13),Rural,Adolescent (10-19),646627,341265,305362,230338,73972,39116,69918,27493,42425,21783
19,339,District - Bankura (13),Rural,Youth (15-24),612608,323720,288888,212647,71236,37275,111442,38772,72670,57373
19,339,District - Bankura (13),Urban,All Ages,299773,152318,147455,68794,3310,1733,69433,27356,42077,2490
19,339,District - Bankura (13),Urban,10-14,24906,12902,12004,7067,438,280,1510,733,777,12
19,339,District - Bankura (13),Urban,15-19,26435,13562,12873,7269,379,196,2250,883,1367,163
19,339,District - Bankura (13),Urban,20-24,27318,13671,13647,7121,323,152,3105,1115,1990,321
19,339,District - Bankura (13),Urban,Adolescent (10-19),51341,26464,24877,14336,817,476,3760,1616,2144,175
19,339,District - Bankura (13),Urban,Youth (15-24),53753,27233,26520,14390,702,348,5355,1998,3357,484
19,340,District - Puruliya (14),Total,All Ages,2930115,1496996,1433119,567767,540652,271803,1305210,494938,810272,128475
19,340,District - Puruliya (14),Total,10-14,314565,160266,154299,64924,58926,30005,33473,12805,20668,1031
19,340,District - Puruliya (14),Total,15-19,278243,150466,127777,56842,53646,28815,49244,16318,32926,6819
19,340,District - Puruliya (14),Total,20-24,253676,129160,124516,50945,48988,24593,68324,19095,49229,13871
19,340,District - Puruliya (14),Total,Adolescent (10-19),592808,310732,282076,121766,112572,58820,82717,29123,53594,7850
19,340,District - Puruliya (14),Total,Youth (15-24),531919,279626,252293,107787,102634,53408,117568,35413,82155,20690
19,340,District - Puruliya (14),Rural,All Ages,2556801,1304208,1252593,490517,531822,267382,1181941,445588,736353,126699
19,340,District - Puruliya (14),Rural,10-14,277625,141383,136242,56097,57969,29535,29467,11108,18359,1019
19,340,District - Puruliya (14),Rural,15-19,241158,131076,110082,48046,52708,28331,43874,14243,29631,6700
19,340,District - Puruliya (14),Rural,20-24,218969,111516,107453,43429,48115,24165,61773,16957,44816,13681
19,340,District - Puruliya (14),Rural,Adolescent (10-19),518783,272459,246324,104143,110677,57866,73341,25351,47990,7719
19,340,District - Puruliya (14),Rural,Youth (15-24),460127,242592,217535,91475,100823,52496,105647,31200,74447,20381
19,340,District - Puruliya (14),Urban,All Ages,373314,192788,180526,77250,8830,4421,123269,49350,73919,1776
19,340,District - Puruliya (14),Urban,10-14,36940,18883,18057,8827,957,470,4006,1697,2309,12
19,340,District - Puruliya (14),Urban,15-19,37085,19390,17695,8796,938,484,5370,2075,3295,119
19,340,District - Puruliya (14),Urban,20-24,34707,17644,17063,7516,873,428,6551,2138,4413,190
19,340,District - Puruliya (14),Urban,Adolescent (10-19),74025,38273,35752,17623,1895,954,9376,3772,5604,131
19,340,District - Puruliya (14),Urban,Youth (15-24),71792,37034,34758,16312,1811,912,11921,4213,7708,309
19,341,District - Haora (15),Total,All Ages,4850029,2500819,2349210,718951,15094,7761,1244823,557995,686828,116736
19,341,District - Haora (15),Total,10-14,442820,226893,215927,68938,1396,747,23688,13335,10353,710
19,341,District - Haora (15),Total,15-19,473223,241434,231789,75261,1613,798,36263,19102,17161,5297
19,341,District - Haora (15),Total,20-24,469745,235349,234396,75735,1627,801,49288,23121,26167,10745
19,341,District - Haora (15),Total,Adolescent (10-19),916043,468327,447716,144199,3009,1545,59951,32437,27514,6007
19,341,District - Haora (15),Total,Youth (15-24),942968,476783,466185,150996,3240,1599,85551,42223,43328,16042
19,341,District - Haora (15),Rural,All Ages,1775885,909519,866366,407815,4025,2075,519619,227167,292452,95515
19,341,District - Haora (15),Rural,10-14,170131,86370,83761,40737,418,226,8669,4866,3803,591
19,341,District - Haora (15),Rural,15-19,183231,93055,90176,44059,447,234,14734,7585,7149,4540
19,341,District - Haora (15),Rural,20-24,176035,88234,87801,42942,448,200,20950,9531,11419,9024
19,341,District - Haora (15),Rural,Adolescent (10-19),353362,179425,173937,84796,865,460,23403,12451,10952,5131
19,341,District - Haora (15),Rural,Youth (15-24),359266,181289,177977,87001,895,434,35684,17116,18568,13564
19,341,District - Haora (15),Urban,All Ages,3074144,1591300,1482844,311136,11069,5686,725204,330828,394376,21221
19,341,District - Haora (15),Urban,10-14,272689,140523,132166,28201,978,521,15019,8469,6550,119
19,341,District - Haora (15),Urban,15-19,289992,148379,141613,31202,1166,564,21529,11517,10012,757
19,341,District - Haora (15),Urban,20-24,293710,147115,146595,32793,1179,601,28338,13590,14748,1721
19,341,District - Haora (15),Urban,Adolescent (10-19),562681,288902,273779,59403,2144,1085,36548,19986,16562,876
19,341,District - Haora (15),Urban,Youth (15-24),583702,295494,288208,63995,2345,1165,49867,25107,24760,2478
19,342,District - Kolkata (16),Total,All Ages,4496694,2356766,2139928,241932,10684,5729,908557,429851,478706,8903
19,342,District - Kolkata (16),Total,10-14,336850,176065,160785,20513,836,448,23365,12568,10797,151
19,342,District - Kolkata (16),Total,15-19,370514,193986,176528,22769,993,518,30473,16434,14039,479
19,342,District - Kolkata (16),Total,20-24,400295,206756,193539,24544,1105,557,41056,20924,20132,870
19,342,District - Kolkata (16),Total,Adolescent (10-19),707364,370051,337313,43282,1829,966,53838,29002,24836,630
19,342,District - Kolkata (16),Total,Youth (15-24),770809,400742,370067,47313,2098,1075,71529,37358,34171,1349
19,342,District - Kolkata (16),Rural,All Ages,0,0,0,0,0,0,0,0,0,0
19,342,District - Kolkata (16),Rural,10-14,0,0,0,0,0,0,0,0,0,0
19,342,District - Kolkata (16),Rural,15-19,0,0,0,0,0,0,0,0,0,0
19,342,District - Kolkata (16),Rural,20-24,0,0,0,0,0,0,0,0,0,0
19,342,District - Kolkata (16),Rural,Adolescent (10-19),0,0,0,0,0,0,0,0,0,0
19,342,District - Kolkata (16),Rural,Youth (15-24),0,0,0,0,0,0,0,0,0,0
19,342,District - Kolkata (16),Urban,All Ages,4496694,2356766,2139928,241932,10684,5729,908557,429851,478706,8903
19,342,District - Kolkata (16),Urban,10-14,336850,176065,160785,20513,836,448,23365,12568,10797,151
19,342,District - Kolkata (16),Urban,15-19,370514,193986,176528,22769,993,518,30473,16434,14039,479
19,342,District - Kolkata (16),Urban,20-24,400295,206756,193539,24544,1105,557,41056,20924,20132,870
19,342,District - Kolkata (16),Urban,Adolescent (10-19),707364,370051,337313,43282,1829,966,53838,29002,24836,630
19,342,District - Kolkata (16),Urban,Youth (15-24),770809,400742,370067,47313,2098,1075,71529,37358,34171,1349
19,343,District - South Twenty Four Parganas (17),Total,All Ages,8161961,4173778,3988183,2464032,96976,49195,2630304,1130501,1499803,388993
19,343,District - South Twenty Four Parganas (17),Total,10-14,843807,430349,413458,239670,10879,5603,73859,40441,33418,3346
19,343,District - South Twenty Four Parganas (17),Total,15-19,837800,424440,413360,244249,10230,5101,86564,42646,43918,22197
19,343,District - South Twenty Four Parganas (17),Total,20-24,822249,409187,413062,250538,9147,4572,114456,48288,66168,49132
19,343,District - South Twenty Four Parganas (17),Total,Adolescent (10-19),1681607,854789,826818,483919,21109,10704,160423,83087,77336,25543
19,343,District - South Twenty Four Parganas (17),Total,Youth (15-24),1660049,833627,826422,494787,19377,9673,201020,90934,110086,71329
19,343,District - South Twenty Four Parganas (17),Rural,All Ages,6074188,3109219,2964969,2062297,89889,45554,2087310,892367,1194943,365884
19,343,District - South Twenty Four Parganas (17),Rural,10-14,657350,334540,322810,206240,10264,5285,59461,32352,27109,3164
19,343,District - South Twenty Four Parganas (17),Rural,15-19,642234,325804,316430,208544,9587,4797,68964,33676,35288,21142
19,343,District - South Twenty Four Parganas (17),Rural,20-24,618682,310109,308573,210558,8387,4201,91432,38167,53265,46762
19,343,District - South Twenty Four Parganas (17),Rural,Adolescent (10-19),1299584,660344,639240,414784,19851,10082,128425,66028,62397,24306
19,343,District - South Twenty Four Parganas (17),Rural,Youth (15-24),1260916,635913,625003,419102,17974,8998,160396,71843,88553,67904
19,343,District - South Twenty Four Parganas (17),Urban,All Ages,2087773,1064559,1023214,401735,7087,3641,542994,238134,304860,23109
19,343,District - South Twenty Four Parganas (17),Urban,10-14,186457,95809,90648,33430,615,318,14398,8089,6309,182
19,343,District - South Twenty Four Parganas (17),Urban,15-19,195566,98636,96930,35705,643,304,17600,8970,8630,1055
19,343,District - South Twenty Four Parganas (17),Urban,20-24,203567,99078,104489,39980,760,371,23024,10121,12903,2370
19,343,District - South Twenty Four Parganas (17),Urban,Adolescent (10-19),382023,194445,187578,69135,1258,622,31998,17059,14939,1237
19,343,District - South Twenty Four Parganas (17),Urban,Youth (15-24),399133,197714,201419,75685,1403,675,40624,19091,21533,3425
19,344,District - Paschim Medinipur (18),Total,All Ages,5913457,3007885,2905572,1128269,880015,439831,1835045,740972,1094073,489199
19,344,District - Paschim Medinipur (18),Total,10-14,585212,297486,287726,120404,92859,47541,33138,15521,17617,3993
19,344,District - Paschim Medinipur (18),Total,15-19,579423,301240,278183,115433,91775,47235,49906,19543,30363,31708
19,344,District - Paschim Medinipur (18),Total,20-24,558646,278273,280373,109493,88038,42965,73087,24241,48846,60556
19,344,District - Paschim Medinipur (18),Total,Adolescent (10-19),1164635,598726,565909,235837,184634,94776,83044,35064,47980,35701
19,344,District - Paschim Medinipur (18),Total,Youth (15-24),1138069,579513,558556,224926,179813,90200,122993,43784,79209,92264
19,344,District - Paschim Medinipur (18),Rural,All Ages,5190771,2641721,2549050,1034177,853031,426541,1674954,674713,1000241,478649
19,344,District - Paschim Medinipur (18),Rural,10-14,525083,267185,257898,111352,90026,46113,29562,13722,15840,3932
19,344,District - Paschim Medinipur (18),Rural,15-19,514887,268489,246398,105983,88549,45611,44860,17367,27493,31082
19,344,District - Paschim Medinipur (18),Rural,20-24,489640,244400,245240,99802,85098,41561,66327,21712,44615,59428
19,344,District - Paschim Medinipur (18),Rural,Adolescent (10-19),1039970,535674,504296,217335,178575,91724,74422,31089,43333,35014
19,344,District - Paschim Medinipur (18),Rural,Youth (15-24),1004527,512889,491638,205785,173647,87172,111187,39079,72108,90510
19,344,District - Paschim Medinipur (18),Urban,All Ages,722686,366164,356522,94092,26984,13290,160091,66259,93832,10550
19,344,District - Paschim Medinipur (18),Urban,10-14,60129,30301,29828,9052,2833,1428,3576,1799,1777,61
19,344,District - Paschim Medinipur (18),Urban,15-19,64536,32751,31785,9450,3226,1624,5046,2176,2870,626
19,344,District - Paschim Medinipur (18),Urban,20-24,69006,33873,35133,9691,2940,1404,6760,2529,4231,1128
19,344,District - Paschim Medinipur (18),Urban,Adolescent (10-19),124665,63052,61613,18502,6059,3052,8622,3975,4647,687
19,344,District - Paschim Medinipur (18),Urban,Youth (15-24),133542,66624,66918,19141,6166,3028,11806,4705,7101,1754
19,345,District - Purba Medinipur (19),Total,All Ages,5095875,2629834,2466041,745434,27952,14196,1172681,480761,691920,277268
19,345,District - Purba Medinipur (19),Total,10-14,505569,258527,247042,81181,2911,1522,13871,7285,6586,1349
19,345,District - Purba Medinipur (19),Total,15-19,522970,271400,251570,79799,3137,1573,18555,8467,10088,14805
19,345,District - Purba Medinipur (19),Total,20-24,508380,260662,247718,76612,3073,1535,28119,10995,17124,33595
19,345,District - Purba Medinipur (19),Total,Adolescent (10-19),1028539,529927,498612,160980,6048,3095,32426,15752,16674,16154
19,345,District - Purba Medinipur (19),Total,Youth (15-24),1031350,532062,499288,156411,6210,3108,46674,19462,27212,48400
19,345,District - Purba Medinipur (19),Rural,All Ages,4503161,2322562,2180599,677263,24028,12110,1048974,428880,620094,267467
19,345,District - Purba Medinipur (19),Rural,10-14,449869,229992,219877,74343,2543,1336,12134,6385,5749,1284
19,345,District - Purba Medinipur (19),Rural,15-19,460459,238623,221836,72394,2655,1296,16229,7366,8863,14216
19,345,District - Purba Medinipur (19),Rural,20-24,446162,228036,218126,69068,2605,1280,24814,9604,15210,32408
19,345,District - Purba Medinipur (19),Rural,Adolescent (10-19),910328,468615,441713,146737,5198,2632,28363,13751,14612,15500
19,345,District - Purba Medinipur (19),Rural,Youth (15-24),906621,466659,439962,141462,5260,2576,41043,16970,24073,46624
19,345,District - Purba Medinipur (19),Urban,All Ages,592714,307272,285442,68171,3924,2086,123707,51881,71826,9801
19,345,District - Purba Medinipur (19),Urban,10-14,55700,28535,27165,6838,368,186,1737,900,837,65
19,345,District - Purba Medinipur (19),Urban,15-19,62511,32777,29734,7405,482,277,2326,1101,1225,589
19,345,District - Purba Medinipur (19),Urban,20-24,62218,32626,29592,7544,468,255,3305,1391,1914,1187
19,345,District - Purba Medinipur (19),Urban,Adolescent (10-19),118211,61312,56899,14243,850,463,4063,2001,2062,654
19,345,District - Purba Medinipur (19),Urban,Youth (15-24),124729,65403,59326,14949,950,532,5631,2492,3139,1776
20,0,State - JHARKHAND (20),Total,All Ages,32988134,16930315,16057819,3985644,8645042,4315407,14660065,6047796,8612269,1238774
20,0,State - JHARKHAND (20),Total,10-14,4104396,2112627,1991769,528887,1098861,558683,409551,179067,230484,19269
20,0,State - JHARKHAND (20),Total,15-19,3205268,1714887,1490381,382254,837613,428877,492864,182723,310141,88674
20,0,State - JHARKHAND (20),Total,20-24,2827622,1431263,1396359,335143,719170,345438,736350,219675,516675,156363
20,0,State - JHARKHAND (20),Total,Adolescent (10-19),7309664,3827514,3482150,911141,1936474,987560,902415,361790,540625,107943
20,0,State - JHARKHAND (20),Total,Youth (15-24),6032890,3146150,2886740,717397,1556783,774315,1229214,402398,826816,245037
20,0,State - JHARKHAND (20),Rural,All Ages,25055073,12776486,12278587,3152863,7868150,3928323,12411995,5093755,7318240,1197462
20,0,State - JHARKHAND (20),Rural,10-14,3237192,1662046,1575146,426934,1008679,513610,354996,152845,202151,18811
20,0,State - JHARKHAND (20),Rural,15-19,2359367,1268321,1091046,286615,747383,383570,426767,153417,273350,86416
20,0,State - JHARKHAND (20),Rural,20-24,2052259,1031084,1021175,252478,638239,306263,647922,188171,459751,151991
20,0,State - JHARKHAND (20),Rural,Adolescent (10-19),5596559,2930367,2666192,713549,1756062,897180,781763,306262,475501,105227
20,0,State - JHARKHAND (20),Rural,Youth (15-24),4411626,2299405,2112221,539093,1385622,689833,1074689,341588,733101,238407
20,0,State - JHARKHAND (20),Urban,All Ages,7933061,4153829,3779232,832781,776892,387084,2248070,954041,1294029,41312
20,0,State - JHARKHAND (20),Urban,10-14,867204,450581,416623,101953,90182,45073,54555,26222,28333,458
20,0,State - JHARKHAND (20),Urban,15-19,845901,446566,399335,95639,90230,45307,66097,29306,36791,2258
20,0,State - JHARKHAND (20),Urban,20-24,775363,400179,375184,82665,80931,39175,88428,31504,56924,4372
20,0,State - JHARKHAND (20),Urban,Adolescent (10-19),1713105,897147,815958,197592,180412,90380,120652,55528,65124,2716
20,0,State - JHARKHAND (20),Urban,Youth (15-24),1621264,846745,774519,178304,171161,84482,154525,60810,93715,6630
20,346,District - Garhwa (01),Total,All Ages,1322784,683575,639209,319946,205874,104499,669308,278414,390894,57365
20,346,District - Garhwa (01),Total,10-14,191645,98470,93175,47558,31249,15914,18383,7451,10932,719
20,346,District - Garhwa (01),Total,15-19,121854,67480,54374,28664,18831,10059,19426,6608,12818,2800
20,346,District - Garhwa (01),Total,20-24,101489,53035,48454,23993,14192,7061,33116,8967,24149,6520
20,346,District - Garhwa (01),Total,Adolescent (10-19),313499,165950,147549,76222,50080,25973,37809,14059,23750,3519
20,346,District - Garhwa (01),Total,Youth (15-24),223343,120515,102828,52657,33023,17120,52542,15575,36967,9320
20,346,District - Garhwa (01),Rural,All Ages,1253114,646947,606167,308843,203918,103494,645586,268495,377091,56594
20,346,District - Garhwa (01),Rural,10-14,182844,93893,88951,46031,30995,15793,17840,7203,10637,715
20,346,District - Garhwa (01),Rural,15-19,114569,63537,51032,27532,18591,9945,18858,6366,12492,2761
20,346,District - Garhwa (01),Rural,20-24,95228,49688,45540,23013,13999,6946,32233,8680,23553,6438
20,346,District - Garhwa (01),Rural,Adolescent (10-19),297413,157430,139983,73563,49586,25738,36698,13569,23129,3476
20,346,District - Garhwa (01),Rural,Youth (15-24),209797,113225,96572,50545,32590,16891,51091,15046,36045,9199
20,346,District - Garhwa (01),Urban,All Ages,69670,36628,33042,11103,1956,1005,23722,9919,13803,771
20,346,District - Garhwa (01),Urban,10-14,8801,4577,4224,1527,254,121,543,248,295,4
20,346,District - Garhwa (01),Urban,15-19,7285,3943,3342,1132,240,114,568,242,326,39
20,346,District - Garhwa (01),Urban,20-24,6261,3347,2914,980,193,115,883,287,596,82
20,346,District - Garhwa (01),Urban,Adolescent (10-19),16086,8520,7566,2659,494,235,1111,490,621,43
20,346,District - Garhwa (01),Urban,Youth (15-24),13546,7290,6256,2112,433,229,1451,529,922,121
20,347,District - Chatra (02),Total,All Ages,1042886,533935,508951,340553,45563,23141,532825,230033,302792,63773
20,347,District - Chatra (02),Total,10-14,145520,75023,70497,48222,6877,3567,16837,7293,9544,817
20,347,District - Chatra (02),Total,15-19,99010,52981,46029,29183,4632,2289,18294,6897,11397,4358
20,347,District - Chatra (02),Total,20-24,84903,42912,41991,26263,3678,1805,28029,8683,19346,8423
20,347,District - Chatra (02),Total,Adolescent (10-19),244530,128004,116526,77405,11509,5856,35131,14190,20941,5175
20,347,District - Chatra (02),Total,Youth (15-24),183913,95893,88020,55446,8310,4094,46323,15580,30743,12781
20,347,District - Chatra (02),Rural,All Ages,979932,500211,479721,332431,44298,22448,513335,221466,291869,63316
20,347,District - Chatra (02),Rural,10-14,137278,70773,66505,47042,6683,3471,16295,7011,9284,815
20,347,District - Chatra (02),Rural,15-19,91593,48925,42668,28290,4494,2211,17768,6632,11136,4334
20,347,District - Chatra (02),Rural,20-24,78790,39485,39305,25583,3568,1742,27376,8412,18964,8374
20,347,District - Chatra (02),Rural,Adolescent (10-19),228871,119698,109173,75332,11177,5682,34063,13643,20420,5149
20,347,District - Chatra (02),Rural,Youth (15-24),170383,88410,81973,53873,8062,3953,45144,15044,30100,12708
20,347,District - Chatra (02),Urban,All Ages,62954,33724,29230,8122,1265,693,19490,8567,10923,457
20,347,District - Chatra (02),Urban,10-14,8242,4250,3992,1180,194,96,542,282,260,2
20,347,District - Chatra (02),Urban,15-19,7417,4056,3361,893,138,78,526,265,261,24
20,347,District - Chatra (02),Urban,20-24,6113,3427,2686,680,110,63,653,271,382,49
20,347,District - Chatra (02),Urban,Adolescent (10-19),15659,8306,7353,2073,332,174,1068,547,521,26
20,347,District - Chatra (02),Urban,Youth (15-24),13530,7483,6047,1573,248,141,1179,536,643,73
20,348,District - Kodarma (03),Total,All Ages,716259,367222,349037,109003,6903,3594,326010,128442,197568,24197
20,348,District - Kodarma (03),Total,10-14,91525,47540,43985,13889,789,452,6459,2604,3855,277
20,348,District - Kodarma (03),Total,15-19,67781,37668,30113,9620,587,331,7447,2618,4829,1604
20,348,District - Kodarma (03),Total,20-24,59560,30338,29222,8888,577,248,13515,3159,10356,3170
20,348,District - Kodarma (03),Total,Adolescent (10-19),159306,85208,74098,23509,1376,783,13906,5222,8684,1881
20,348,District - Kodarma (03),Total,Youth (15-24),127341,68006,59335,18508,1164,579,20962,5777,15185,4774
20,348,District - Kodarma (03),Rural,All Ages,575013,293595,281418,93885,6152,3210,278866,109084,169782,23157
20,348,District - Kodarma (03),Rural,10-14,74485,38706,35779,12007,706,402,5531,2216,3315,272
20,348,District - Kodarma (03),Rural,15-19,53488,29960,23528,8184,515,296,6409,2186,4223,1557
20,348,District - Kodarma (03),Rural,20-24,46832,23757,23075,7620,510,222,11877,2635,9242,3083
20,348,District - Kodarma (03),Rural,Adolescent (10-19),127973,68666,59307,20191,1221,698,11940,4402,7538,1829
20,348,District - Kodarma (03),Rural,Youth (15-24),100320,53717,46603,15804,1025,518,18286,4821,13465,4640
20,348,District - Kodarma (03),Urban,All Ages,141246,73627,67619,15118,751,384,47144,19358,27786,1040
20,348,District - Kodarma (03),Urban,10-14,17040,8834,8206,1882,83,50,928,388,540,5
20,348,District - Kodarma (03),Urban,15-19,14293,7708,6585,1436,72,35,1038,432,606,47
20,348,District - Kodarma (03),Urban,20-24,12728,6581,6147,1268,67,26,1638,524,1114,87
20,348,District - Kodarma (03),Urban,Adolescent (10-19),31333,16542,14791,3318,155,85,1966,820,1146,52
20,348,District - Kodarma (03),Urban,Youth (15-24),27021,14289,12732,2704,139,61,2676,956,1720,134
20,349,District - Giridih (04),Total,All Ages,2445474,1258098,1187376,325493,238188,120646,1191999,474362,717637,78621
20,349,District - Giridih (04),Total,10-14,317220,164375,152845,42480,32016,16180,29486,11907,17579,1026
20,349,District - Giridih (04),Total,15-19,224476,124952,99524,28269,20885,10931,36918,11588,25330,5342
20,349,District - Giridih (04),Total,20-24,206884,104095,102789,27000,19102,9103,63786,15470,48316,10691
20,349,District - Giridih (04),Total,Adolescent (10-19),541696,289327,252369,70749,52901,27111,66404,23495,42909,6368
20,349,District - Giridih (04),Total,Youth (15-24),431360,229047,202313,55269,39987,20034,100704,27058,73646,16033
20,349,District - Giridih (04),Rural,All Ages,2237450,1149608,1087842,301327,235170,119085,1123937,444508,679429,77107
20,349,District - Giridih (04),Rural,10-14,292830,151810,141020,39532,31638,16013,27635,10987,16648,1009
20,349,District - Giridih (04),Rural,15-19,202570,113285,89285,25890,20521,10703,34652,10494,24158,5247
20,349,District - Giridih (04),Rural,20-24,186691,93668,93023,24637,18816,8948,60709,14305,46404,10475
20,349,District - Giridih (04),Rural,Adolescent (10-19),495400,265095,230305,65422,52159,26716,62287,21481,40806,6256
20,349,District - Giridih (04),Rural,Youth (15-24),389261,206953,182308,50527,39337,19651,95361,24799,70562,15722
20,349,District - Giridih (04),Urban,All Ages,208024,108490,99534,24166,3018,1561,68062,29854,38208,1514
20,349,District - Giridih (04),Urban,10-14,24390,12565,11825,2948,378,167,1851,920,931,17
20,349,District - Giridih (04),Urban,15-19,21906,11667,10239,2379,364,228,2266,1094,1172,95
20,349,District - Giridih (04),Urban,20-24,20193,10427,9766,2363,286,155,3077,1165,1912,216
20,349,District - Giridih (04),Urban,Adolescent (10-19),46296,24232,22064,5327,742,395,4117,2014,2103,112
20,349,District - Giridih (04),Urban,Youth (15-24),42099,22094,20005,4742,650,383,5343,2259,3084,311
20,350,District - Deoghar (05),Total,All Ages,1492073,775022,717051,190036,180962,91012,698535,285185,413350,69187
20,350,District - Deoghar (05),Total,10-14,183760,96572,87188,23022,21913,11367,17883,7136,10747,795
20,350,District - Deoghar (05),Total,15-19,132938,75006,57932,16461,15070,7934,24489,8185,16304,4899
20,350,District - Deoghar (05),Total,20-24,126952,64111,62841,15957,15132,7120,39842,10565,29277,9624
20,350,District - Deoghar (05),Total,Adolescent (10-19),316698,171578,145120,39483,36983,19301,42372,15321,27051,5694
20,350,District - Deoghar (05),Total,Youth (15-24),259890,139117,120773,32418,30202,15054,64331,18750,45581,14523
20,350,District - Deoghar (05),Rural,All Ages,1233712,638136,595576,159077,176140,88616,628820,255264,373556,67412
20,350,District - Deoghar (05),Rural,10-14,154387,80882,73505,19207,21287,11055,16390,6432,9958,788
20,350,District - Deoghar (05),Rural,15-19,106766,60504,46262,13255,14632,7719,22573,7411,15162,4813
20,350,District - Deoghar (05),Rural,20-24,102861,51506,51355,13117,14676,6902,37092,9681,27411,9435
20,350,District - Deoghar (05),Rural,Adolescent (10-19),261153,141386,119767,32462,35919,18774,38963,13843,25120,5601
20,350,District - Deoghar (05),Rural,Youth (15-24),209627,112010,97617,26372,29308,14621,59665,17092,42573,14248
20,350,District - Deoghar (05),Urban,All Ages,258361,136886,121475,30959,4822,2396,69715,29921,39794,1775
20,350,District - Deoghar (05),Urban,10-14,29373,15690,13683,3815,626,312,1493,704,789,7
20,350,District - Deoghar (05),Urban,15-19,26172,14502,11670,3206,438,215,1916,774,1142,86
20,350,District - Deoghar (05),Urban,20-24,24091,12605,11486,2840,456,218,2750,884,1866,189
20,350,District - Deoghar (05),Urban,Adolescent (10-19),55545,30192,25353,7021,1064,527,3409,1478,1931,93
20,350,District - Deoghar (05),Urban,Youth (15-24),50263,27107,23156,6046,894,433,4666,1658,3008,275
20,351,District - Godda (06),Total,All Ages,1313551,677927,635624,115567,279208,138510,709032,301715,407317,87229
20,351,District - Godda (06),Total,10-14,163166,85944,77222,15074,33358,17450,27772,12250,15522,1132
20,351,District - Godda (06),Total,15-19,112610,63410,49200,9214,24231,12313,29897,12111,17786,6061
20,351,District - Godda (06),Total,20-24,100556,50738,49818,8407,22740,10463,41354,13344,28010,10438
20,351,District - Godda (06),Total,Adolescent (10-19),275776,149354,126422,24288,57589,29763,57669,24361,33308,7193
20,351,District - Godda (06),Total,Youth (15-24),213166,114148,99018,17621,46971,22776,71251,25455,45796,16499
20,351,District - Godda (06),Rural,All Ages,1249132,643907,605225,111055,276785,137352,689786,293197,396589,86422
20,351,District - Godda (06),Rural,10-14,155667,82027,73640,14474,33109,17326,27236,11996,15240,1127
20,351,District - Godda (06),Rural,15-19,106239,60028,46211,8781,23907,12172,29384,11867,17517,6009
20,351,District - Godda (06),Rural,20-24,94843,47803,47040,8028,22424,10330,40560,13067,27493,10350
20,351,District - Godda (06),Rural,Adolescent (10-19),261906,142055,119851,23255,57016,29498,56620,23863,32757,7136
20,351,District - Godda (06),Rural,Youth (15-24),201082,107831,93251,16809,46331,22502,69944,24934,45010,16359
20,351,District - Godda (06),Urban,All Ages,64419,34020,30399,4512,2423,1158,19246,8518,10728,807
20,351,District - Godda (06),Urban,10-14,7499,3917,3582,600,249,124,536,254,282,5
20,351,District - Godda (06),Urban,15-19,6371,3382,2989,433,324,141,513,244,269,52
20,351,District - Godda (06),Urban,20-24,5713,2935,2778,379,316,133,794,277,517,88
20,351,District - Godda (06),Urban,Adolescent (10-19),13870,7299,6571,1033,573,265,1049,498,551,57
20,351,District - Godda (06),Urban,Youth (15-24),12084,6317,5767,812,640,274,1307,521,786,140
20,352,District - Sahibganj (07),Total,All Ages,1150567,589391,561176,72341,308343,153435,667304,302088,365216,110168
20,352,District - Sahibganj (07),Total,10-14,146536,76351,70185,9115,36366,18978,25909,12287,13622,2075
20,352,District - Sahibganj (07),Total,15-19,101638,55253,46385,6418,25953,12995,32011,14024,17987,9670
20,352,District - Sahibganj (07),Total,20-24,91835,45506,46329,6132,23636,10815,43778,16370,27408,14551
20,352,District - Sahibganj (07),Total,Adolescent (10-19),248174,131604,116570,15533,62319,31973,57920,26311,31609,11745
20,352,District - Sahibganj (07),Total,Youth (15-24),193473,100759,92714,12550,49589,23810,75789,30394,45395,24221
20,352,District - Sahibganj (07),Rural,All Ages,990901,505892,485009,57490,301930,150205,606242,274783,331459,106130
20,352,District - Sahibganj (07),Rural,10-14,127554,66531,61023,7251,35535,18544,23863,11296,12567,2009
20,352,District - Sahibganj (07),Rural,15-19,85279,46455,38824,4790,25303,12671,29604,12905,16699,9308
20,352,District - Sahibganj (07),Rural,20-24,77431,37932,39499,4730,23063,10511,40537,15080,25457,14044
20,352,District - Sahibganj (07),Rural,Adolescent (10-19),212833,112986,99847,12041,60838,31215,53467,24201,29266,11317
20,352,District - Sahibganj (07),Rural,Youth (15-24),162710,84387,78323,9520,48366,23182,70141,27985,42156,23352
20,352,District - Sahibganj (07),Urban,All Ages,159666,83499,76167,14851,6413,3230,61062,27305,33757,4038
20,352,District - Sahibganj (07),Urban,10-14,18982,9820,9162,1864,831,434,2046,991,1055,66
20,352,District - Sahibganj (07),Urban,15-19,16359,8798,7561,1628,650,324,2407,1119,1288,362
20,352,District - Sahibganj (07),Urban,20-24,14404,7574,6830,1402,573,304,3241,1290,1951,507
20,352,District - Sahibganj (07),Urban,Adolescent (10-19),35341,18618,16723,3492,1481,758,4453,2110,2343,428
20,352,District - Sahibganj (07),Urban,Youth (15-24),30763,16372,14391,3030,1223,628,5648,2409,3239,869
20,353,District - Pakur (08),Total,All Ages,900422,452661,447761,28469,379054,186967,547541,245672,301869,57797
20,353,District - Pakur (08),Total,10-14,113985,58896,55089,3478,44292,22866,24979,12543,12436,939
20,353,District - Pakur (08),Total,15-19,76857,39970,36887,2346,29391,14425,27266,11572,15694,5101
20,353,District - Pakur (08),Total,20-24,74920,35173,39747,2423,30988,13637,38392,14036,24356,8366
20,353,District - Pakur (08),Total,Adolescent (10-19),190842,98866,91976,5824,73683,37291,52245,24115,28130,6040
20,353,District - Pakur (08),Total,Youth (15-24),151777,75143,76634,4769,60379,28062,65658,25608,40050,13467
20,353,District - Pakur (08),Rural,All Ages,832910,418251,414659,25177,376390,185652,517357,231719,285638,56901
20,353,District - Pakur (08),Rural,10-14,105525,54611,50914,3016,43959,22713,23359,11716,11643,935
20,353,District - Pakur (08),Rural,15-19,69875,36422,33453,2010,29109,14293,25535,10777,14758,5012
20,353,District - Pakur (08),Rural,20-24,68683,32039,36644,2109,30750,13514,36423,13215,23208,8186
20,353,District - Pakur (08),Rural,Adolescent (10-19),175400,91033,84367,5026,73068,37006,48894,22493,26401,5947
20,353,District - Pakur (08),Rural,Youth (15-24),138558,68461,70097,4119,59859,27807,61958,23992,37966,13198
20,353,District - Pakur (08),Urban,All Ages,67512,34410,33102,3292,2664,1315,30184,13953,16231,896
20,353,District - Pakur (08),Urban,10-14,8460,4285,4175,462,333,153,1620,827,793,4
20,353,District - Pakur (08),Urban,15-19,6982,3548,3434,336,282,132,1731,795,936,89
20,353,District - Pakur (08),Urban,20-24,6237,3134,3103,314,238,123,1969,821,1148,180
20,353,District - Pakur (08),Urban,Adolescent (10-19),15442,7833,7609,798,615,285,3351,1622,1729,93
20,353,District - Pakur (08),Urban,Youth (15-24),13219,6682,6537,650,520,255,3700,1616,2084,269
20,354,District - Dhanbad (09),Total,All Ages,2684487,1405956,1278531,437309,233119,117256,962283,391006,571277,25466
20,354,District - Dhanbad (09),Total,10-14,318597,164610,153987,55764,29533,15008,26592,11938,14654,379
20,354,District - Dhanbad (09),Total,15-19,290914,156464,134450,49677,23547,12355,35170,14023,21147,1490
20,354,District - Dhanbad (09),Total,20-24,250370,132310,118060,41252,20593,10084,45407,14613,30794,3038
20,354,District - Dhanbad (09),Total,Adolescent (10-19),609511,321074,288437,105441,53080,27363,61762,25961,35801,1869
20,354,District - Dhanbad (09),Total,Youth (15-24),541284,288774,252510,90929,44140,22439,80577,28636,51941,4528
20,354,District - Dhanbad (09),Rural,All Ages,1124093,581956,542137,163090,198079,99381,474838,184812,290026,20720
20,354,District - Dhanbad (09),Rural,10-14,140502,71579,68923,21082,25270,12817,11495,4689,6806,336
20,354,District - Dhanbad (09),Rural,15-19,113103,61436,51667,16772,19427,10161,16577,5691,10886,1246
20,354,District - Dhanbad (09),Rural,20-24,99284,51750,47534,14598,17115,8208,24036,6659,17377,2601
20,354,District - Dhanbad (09),Rural,Adolescent (10-19),253605,133015,120590,37854,44697,22978,28072,10380,17692,1582
20,354,District - Dhanbad (09),Rural,Youth (15-24),212387,113186,99201,31370,36542,18369,40613,12350,28263,3847
20,354,District - Dhanbad (09),Urban,All Ages,1560394,824000,736394,274219,35040,17875,487445,206194,281251,4746
20,354,District - Dhanbad (09),Urban,10-14,178095,93031,85064,34682,4263,2191,15097,7249,7848,43
20,354,District - Dhanbad (09),Urban,15-19,177811,95028,82783,32905,4120,2194,18593,8332,10261,244
20,354,District - Dhanbad (09),Urban,20-24,151086,80560,70526,26654,3478,1876,21371,7954,13417,437
20,354,District - Dhanbad (09),Urban,Adolescent (10-19),355906,188059,167847,67587,8383,4385,33690,15581,18109,287
20,354,District - Dhanbad (09),Urban,Youth (15-24),328897,175588,153309,59559,7598,4070,39964,16286,23678,681
20,355,District - Bokaro (10),Total,All Ages,2062330,1072807,989523,299227,255626,129233,788810,313719,475091,23861
20,355,District - Bokaro (10),Total,10-14,250234,127703,122531,38415,33347,16728,16250,6620,9630,212
20,355,District - Bokaro (10),Total,15-19,214879,115306,99573,31787,27027,14197,24153,8358,15795,1307
20,355,District - Bokaro (10),Total,20-24,188396,98069,90327,27560,22700,11448,36634,10540,26094,2818
20,355,District - Bokaro (10),Total,Adolescent (10-19),465113,243009,222104,70202,60374,30925,40403,14978,25425,1519
20,355,District - Bokaro (10),Total,Youth (15-24),403275,213375,189900,59347,49727,25645,60787,18898,41889,4125
20,355,District - Bokaro (10),Rural,All Ages,1078686,554954,523732,175690,182223,92118,501508,197591,303917,21523
20,355,District - Bokaro (10),Rural,10-14,140200,70772,69428,23418,24607,12330,10166,3870,6296,204
20,355,District - Bokaro (10),Rural,15-19,106999,58092,48907,17322,18248,9606,16386,5261,11125,1232
20,355,District - Bokaro (10),Rural,20-24,90537,47046,43491,14896,15047,7628,25629,6985,18644,2582
20,355,District - Bokaro (10),Rural,Adolescent (10-19),247199,128864,118335,40740,42855,21936,26552,9131,17421,1436
20,355,District - Bokaro (10),Rural,Youth (15-24),197536,105138,92398,32218,33295,17234,42015,12246,29769,3814
20,355,District - Bokaro (10),Urban,All Ages,983644,517853,465791,123537,73403,37115,287302,116128,171174,2338
20,355,District - Bokaro (10),Urban,10-14,110034,56931,53103,14997,8740,4398,6084,2750,3334,8
20,355,District - Bokaro (10),Urban,15-19,107880,57214,50666,14465,8779,4591,7767,3097,4670,75
20,355,District - Bokaro (10),Urban,20-24,97859,51023,46836,12664,7653,3820,11005,3555,7450,236
20,355,District - Bokaro (10),Urban,Adolescent (10-19),217914,114145,103769,29462,17519,8989,13851,5847,8004,83
20,355,District - Bokaro (10),Urban,Youth (15-24),205739,108237,97502,27129,16432,8411,18772,6652,12120,311
20,356,District - Lohardaga (11),Total,All Ages,461790,232629,229161,15330,262734,130814,202083,83061,119022,21281
20,356,District - Lohardaga (11),Total,10-14,65562,33223,32339,2249,38785,19638,4219,1920,2299,350
20,356,District - Lohardaga (11),Total,15-19,49562,25585,23977,1743,28095,14506,5829,2093,3736,1836
20,356,District - Lohardaga (11),Total,20-24,36799,18306,18493,1214,19851,9670,8287,2301,5986,2850
20,356,District - Lohardaga (11),Total,Adolescent (10-19),115124,58808,56316,3992,66880,34144,10048,4013,6035,2186
20,356,District - Lohardaga (11),Total,Youth (15-24),86361,43891,42470,2957,47946,24176,14116,4394,9722,4686
20,356,District - Lohardaga (11),Rural,All Ages,404379,203255,201124,13035,248472,123926,186975,76402,110573,21015
20,356,District - Lohardaga (11),Rural,10-14,58631,29670,28961,1951,36726,18602,3911,1747,2164,344
20,356,District - Lohardaga (11),Rural,15-19,43017,22313,20704,1450,26186,13602,5459,1915,3544,1825
20,356,District - Lohardaga (11),Rural,20-24,31065,15466,15599,981,18467,9040,7811,2111,5700,2831
20,356,District - Lohardaga (11),Rural,Adolescent (10-19),101648,51983,49665,3401,62912,32204,9370,3662,5708,2169
20,356,District - Lohardaga (11),Rural,Youth (15-24),74082,37779,36303,2431,44653,22642,13270,4026,9244,4656
20,356,District - Lohardaga (11),Urban,All Ages,57411,29374,28037,2295,14262,6888,15108,6659,8449,266
20,356,District - Lohardaga (11),Urban,10-14,6931,3553,3378,298,2059,1036,308,173,135,6
20,356,District - Lohardaga (11),Urban,15-19,6545,3272,3273,293,1909,904,370,178,192,11
20,356,District - Lohardaga (11),Urban,20-24,5734,2840,2894,233,1384,630,476,190,286,19
20,356,District - Lohardaga (11),Urban,Adolescent (10-19),13476,6825,6651,591,3968,1940,678,351,327,17
20,356,District - Lohardaga (11),Urban,Youth (15-24),12279,6112,6167,526,3293,1534,846,368,478,30
20,357,District - Purbi Singhbhum (12),Total,All Ages,2293919,1176902,1117017,111414,653923,325989,786220,320376,465844,39661
20,357,District - Purbi Singhbhum (12),Total,10-14,226440,117772,108668,11405,71340,36867,14039,6293,7746,339
20,357,District - Purbi Singhbhum (12),Total,15-19,213765,113552,100213,11159,63097,33474,20388,7976,12412,2413
20,357,District - Purbi Singhbhum (12),Total,20-24,215693,107205,108488,11456,61593,29629,34099,10452,23647,4451
20,357,District - Purbi Singhbhum (12),Total,Adolescent (10-19),440205,231324,208881,22564,134437,70341,34427,14269,20158,2752
20,357,District - Purbi Singhbhum (12),Total,Youth (15-24),429458,220757,208701,22615,124690,63103,54487,18428,36059,6864
20,357,District - Purbi Singhbhum (12),Rural,All Ages,1019328,514498,504830,44771,515214,256760,471331,186606,284725,37093
20,357,District - Purbi Singhbhum (12),Rural,10-14,107519,55474,52045,4712,57157,29601,7978,3321,4657,328
20,357,District - Purbi Singhbhum (12),Rural,15-19,92021,49429,42592,4107,48648,26026,13041,4613,8428,2327
20,357,District - Purbi Singhbhum (12),Rural,20-24,89377,44147,45230,3913,46401,22583,22343,6415,15928,4222
20,357,District - Purbi Singhbhum (12),Rural,Adolescent (10-19),199540,104903,94637,8819,105805,55627,21019,7934,13085,2655
20,357,District - Purbi Singhbhum (12),Rural,Youth (15-24),181398,93576,87822,8020,95049,48609,35384,11028,24356,6549
20,357,District - Purbi Singhbhum (12),Urban,All Ages,1274591,662404,612187,66643,138709,69229,314889,133770,181119,2568
20,357,District - Purbi Singhbhum (12),Urban,10-14,118921,62298,56623,6693,14183,7266,6061,2972,3089,11
20,357,District - Purbi Singhbhum (12),Urban,15-19,121744,64123,57621,7052,14449,7448,7347,3363,3984,86
20,357,District - Purbi Singhbhum (12),Urban,20-24,126316,63058,63258,7543,15192,7046,11756,4037,7719,229
20,357,District - Purbi Singhbhum (12),Urban,Adolescent (10-19),240665,126421,114244,13745,28632,14714,13408,6335,7073,97
20,357,District - Purbi Singhbhum (12),Urban,Youth (15-24),248060,127181,120879,14595,29641,14494,19103,7400,11703,315
20,358,District - Palamu (13),Total,All Ages,1939869,1006302,933567,536382,181208,92577,915306,384596,530710,95734
20,358,District - Palamu (13),Total,10-14,269126,138656,130470,77751,27001,13733,26135,11050,15085,1301
20,358,District - Palamu (13),Total,15-19,188105,102422,85683,49444,17574,9363,29270,10559,18711,4943
20,358,District - Palamu (13),Total,20-24,155614,81804,73810,41601,13193,6623,46678,13837,32841,10878
20,358,District - Palamu (13),Total,Adolescent (10-19),457231,241078,216153,127195,44575,23096,55405,21609,33796,6244
20,358,District - Palamu (13),Total,Youth (15-24),343719,184226,159493,91045,30767,15986,75948,24396,51552,15821
20,358,District - Palamu (13),Rural,All Ages,1713866,887551,826315,503315,177852,90870,846052,354982,491070,92375
20,358,District - Palamu (13),Rural,10-14,241649,124442,117207,73215,26599,13515,24530,10253,14277,1209
20,358,District - Palamu (13),Rural,15-19,163670,89393,74277,45846,17169,9151,27347,9675,17672,4828
20,358,District - Palamu (13),Rural,20-24,134803,70634,64169,38794,12851,6450,43925,12807,31118,10556
20,358,District - Palamu (13),Rural,Adolescent (10-19),405319,213835,191484,119061,43768,22666,51877,19928,31949,6037
20,358,District - Palamu (13),Rural,Youth (15-24),298473,160027,138446,84640,30020,15601,71272,22482,48790,15384
20,358,District - Palamu (13),Urban,All Ages,226003,118751,107252,33067,3356,1707,69254,29614,39640,3359
20,358,District - Palamu (13),Urban,10-14,27477,14214,13263,4536,402,218,1605,797,808,92
20,358,District - Palamu (13),Urban,15-19,24435,13029,11406,3598,405,212,1923,884,1039,115
20,358,District - Palamu (13),Urban,20-24,20811,11170,9641,2807,342,173,2753,1030,1723,322
20,358,District - Palamu (13),Urban,Adolescent (10-19),51912,27243,24669,8134,807,430,3528,1681,1847,207
20,358,District - Palamu (13),Urban,Youth (15-24),45246,24199,21047,6405,747,385,4676,1914,2762,437
20,359,District - Latehar (14),Total,All Ages,726978,369666,357312,154910,331096,166427,376296,159960,216336,33198
20,359,District - Latehar (14),Total,10-14,104224,53025,51199,22720,48773,24522,13824,5728,8096,722
20,359,District - Latehar (14),Total,15-19,71853,36918,34935,14394,33224,16749,15268,5154,10114,2688
20,359,District - Latehar (14),Total,20-24,57565,28671,28894,11929,25090,12084,20818,6214,14604,4238
20,359,District - Latehar (14),Total,Adolescent (10-19),176077,89943,86134,37114,81997,41271,29092,10882,18210,3410
20,359,District - Latehar (14),Total,Youth (15-24),129418,65589,63829,26323,58314,28833,36086,11368,24718,6926
20,359,District - Latehar (14),Rural,All Ages,675120,342566,332554,146213,324023,162958,358962,152405,206557,32294
20,359,District - Latehar (14),Rural,10-14,97774,49711,48063,21561,47764,24039,13291,5490,7801,702
20,359,District - Latehar (14),Rural,15-19,66279,34112,32167,13437,32392,16370,14629,4880,9749,2616
20,359,District - Latehar (14),Rural,20-24,52790,26192,26598,11200,24493,11787,20014,5887,14127,4121
20,359,District - Latehar (14),Rural,Adolescent (10-19),164053,83823,80230,34998,80156,40409,27920,10370,17550,3318
20,359,District - Latehar (14),Rural,Youth (15-24),119069,60304,58765,24637,56885,28157,34643,10767,23876,6737
20,359,District - Latehar (14),Urban,All Ages,51858,27100,24758,8697,7073,3469,17334,7555,9779,904
20,359,District - Latehar (14),Urban,10-14,6450,3314,3136,1159,1009,483,533,238,295,20
20,359,District - Latehar (14),Urban,15-19,5574,2806,2768,957,832,379,639,274,365,72
20,359,District - Latehar (14),Urban,20-24,4775,2479,2296,729,597,297,804,327,477,117
20,359,District - Latehar (14),Urban,Adolescent (10-19),12024,6120,5904,2116,1841,862,1172,512,660,92
20,359,District - Latehar (14),Urban,Youth (15-24),10349,5285,5064,1686,1429,676,1443,601,842,189
20,360,District - Hazaribagh (15),Total,All Ages,1734495,890881,843614,303515,121768,60796,721246,294768,426478,43404
20,360,District - Hazaribagh (15),Total,10-14,228765,116383,112382,41517,16861,8322,12738,5543,7195,443
20,360,District - Hazaribagh (15),Total,15-19,179151,95787,83364,30359,12855,6299,15659,5890,9769,2698
20,360,District - Hazaribagh (15),Total,20-24,150498,78018,72480,25580,11085,5473,27746,7339,20407,5677
20,360,District - Hazaribagh (15),Total,Adolescent (10-19),407916,212170,195746,71876,29716,14621,28397,11433,16964,3141
20,360,District - Hazaribagh (15),Total,Youth (15-24),329649,173805,155844,55939,23940,11772,43405,13229,30176,8375
20,360,District - Hazaribagh (15),Rural,All Ages,1459188,746934,712254,272868,107553,53800,651179,264598,386581,42287
20,360,District - Hazaribagh (15),Rural,10-14,196631,99659,96972,37642,14854,7304,11489,4937,6552,441
20,360,District - Hazaribagh (15),Rural,15-19,148135,79794,68341,26719,10917,5379,14183,5143,9040,2653
20,360,District - Hazaribagh (15),Rural,20-24,123377,63927,59450,22502,9633,4761,25837,6610,19227,5576
20,360,District - Hazaribagh (15),Rural,Adolescent (10-19),344766,179453,165313,64361,25771,12683,25672,10080,15592,3094
20,360,District - Hazaribagh (15),Rural,Youth (15-24),271512,143721,127791,49221,20550,10140,40020,11753,28267,8229
20,360,District - Hazaribagh (15),Urban,All Ages,275307,143947,131360,30647,14215,6996,70067,30170,39897,1117
20,360,District - Hazaribagh (15),Urban,10-14,32134,16724,15410,3875,2007,1018,1249,606,643,2
20,360,District - Hazaribagh (15),Urban,15-19,31016,15993,15023,3640,1938,920,1476,747,729,45
20,360,District - Hazaribagh (15),Urban,20-24,27121,14091,13030,3078,1452,712,1909,729,1180,101
20,360,District - Hazaribagh (15),Urban,Adolescent (10-19),63150,32717,30433,7515,3945,1938,2725,1353,1372,47
20,360,District - Hazaribagh (15),Urban,Youth (15-24),58137,30084,28053,6718,3390,1632,3385,1476,1909,146
20,361,District - Ramgarh (16),Total,All Ages,949443,494230,455213,106356,201166,101901,352946,144199,208747,21342
20,361,District - Ramgarh (16),Total,10-14,119543,61100,58443,13777,27242,13566,5627,2680,2947,170
20,361,District - Ramgarh (16),Total,15-19,107781,56705,51076,12284,23503,12143,8070,3139,4931,1322
20,361,District - Ramgarh (16),Total,20-24,89788,48026,41762,10425,18117,9608,13154,3951,9203,2575
20,361,District - Ramgarh (16),Total,Adolescent (10-19),227324,117805,109519,26061,50745,25709,13697,5819,7878,1492
20,361,District - Ramgarh (16),Total,Youth (15-24),197569,104731,92838,22709,41620,21751,21224,7090,14134,3897
20,361,District - Ramgarh (16),Rural,All Ages,530488,272167,258321,50227,144484,73082,229282,92255,137027,19267
20,361,District - Ramgarh (16),Rural,10-14,69636,35153,34483,6677,19701,9775,3382,1574,1808,153
20,361,District - Ramgarh (16),Rural,15-19,58376,30351,28025,5389,16416,8475,5065,1795,3270,1223
20,361,District - Ramgarh (16),Rural,20-24,46913,24733,22180,4571,12526,6620,8848,2416,6432,2365
20,361,District - Ramgarh (16),Rural,Adolescent (10-19),128012,65504,62508,12066,36117,18250,8447,3369,5078,1376
20,361,District - Ramgarh (16),Rural,Youth (15-24),105289,55084,50205,9960,28942,15095,13913,4211,9702,3588
20,361,District - Ramgarh (16),Urban,All Ages,418955,222063,196892,56129,56682,28819,123664,51944,71720,2075
20,361,District - Ramgarh (16),Urban,10-14,49907,25947,23960,7100,7541,3791,2245,1106,1139,17
20,361,District - Ramgarh (16),Urban,15-19,49405,26354,23051,6895,7087,3668,3005,1344,1661,99
20,361,District - Ramgarh (16),Urban,20-24,42875,23293,19582,5854,5591,2988,4306,1535,2771,210
20,361,District - Ramgarh (16),Urban,Adolescent (10-19),99312,52301,47011,13995,14628,7459,5250,2450,2800,116
20,361,District - Ramgarh (16),Urban,Youth (15-24),92280,49647,42633,12749,12678,6656,7311,2879,4432,309
20,362,District - Dumka (17),Total,All Ages,1321442,668514,652928,79614,571077,282125,649033,262239,386794,72157
20,362,District - Dumka (17),Total,10-14,152644,78755,73889,9317,64818,33125,18166,8090,10076,1400
20,362,District - Dumka (17),Total,15-19,114084,61404,52680,6731,48878,24582,22582,8363,14219,5372
20,362,District - Dumka (17),Total,20-24,109730,52921,56809,6669,47750,21930,36898,10672,26226,9400
20,362,District - Dumka (17),Total,Adolescent (10-19),266728,140159,126569,16048,113696,57707,40748,16453,24295,6772
20,362,District - Dumka (17),Total,Youth (15-24),223814,114325,109489,13400,96628,46512,59480,19035,40445,14772
20,362,District - Dumka (17),Rural,All Ages,1231264,620928,610336,71695,565629,279275,624604,251667,372937,71379
20,362,District - Dumka (17),Rural,10-14,143085,73763,69322,8447,64346,32897,17531,7795,9736,1386
20,362,District - Dumka (17),Rural,15-19,104951,56515,48436,5932,48258,24291,21880,8041,13839,5325
20,362,District - Dumka (17),Rural,20-24,101433,48582,52851,5876,47265,21729,35927,10358,25569,9321
20,362,District - Dumka (17),Rural,Adolescent (10-19),248036,130278,117758,14379,112604,57188,39411,15836,23575,6711
20,362,District - Dumka (17),Rural,Youth (15-24),206384,105097,101287,11808,95523,46020,57807,18399,39408,14646
20,362,District - Dumka (17),Urban,All Ages,90178,47586,42592,7919,5448,2850,24429,10572,13857,778
20,362,District - Dumka (17),Urban,10-14,9559,4992,4567,870,472,228,635,295,340,14
20,362,District - Dumka (17),Urban,15-19,9133,4889,4244,799,620,291,702,322,380,47
20,362,District - Dumka (17),Urban,20-24,8297,4339,3958,793,485,201,971,314,657,79
20,362,District - Dumka (17),Urban,Adolescent (10-19),18692,9881,8811,1669,1092,519,1337,617,720,61
20,362,District - Dumka (17),Urban,Youth (15-24),17430,9228,8202,1592,1105,492,1673,636,1037,126
20,363,District - Jamtara (18),Total,All Ages,791042,404830,386212,72885,240489,120035,364730,146570,218160,26814
20,363,District - Jamtara (18),Total,10-14,92292,47658,44634,8709,27567,14149,11222,4792,6430,538
20,363,District - Jamtara (18),Total,15-19,69316,37346,31970,6683,20370,10465,13442,4897,8545,1956
20,363,District - Jamtara (18),Total,20-24,66737,32992,33745,6487,19721,9046,20031,5784,14247,3466
20,363,District - Jamtara (18),Total,Adolescent (10-19),161608,85004,76604,15392,47937,24614,24664,9689,14975,2494
20,363,District - Jamtara (18),Total,Youth (15-24),136053,70338,65715,13170,40091,19511,33473,10681,22792,5422
20,363,District - Jamtara (18),Rural,All Ages,715296,365043,350253,63026,236962,118262,343512,137758,205754,26493
20,363,District - Jamtara (18),Rural,10-14,84246,43460,40786,7517,27170,13941,10824,4587,6237,537
20,363,District - Jamtara (18),Rural,15-19,61626,33301,28325,5551,19971,10259,12843,4652,8191,1939
20,363,District - Jamtara (18),Rural,20-24,59512,29222,30290,5483,19391,8884,19228,5522,13706,3426
20,363,District - Jamtara (18),Rural,Adolescent (10-19),145872,76761,69111,13068,47141,24200,23667,9239,14428,2476
20,363,District - Jamtara (18),Rural,Youth (15-24),121138,62523,58615,11034,39362,19143,32071,10174,21897,5365
20,363,District - Jamtara (18),Urban,All Ages,75746,39787,35959,9859,3527,1773,21218,8812,12406,321
20,363,District - Jamtara (18),Urban,10-14,8046,4198,3848,1192,397,208,398,205,193,1
20,363,District - Jamtara (18),Urban,15-19,7690,4045,3645,1132,399,206,599,245,354,17
20,363,District - Jamtara (18),Urban,20-24,7225,3770,3455,1004,330,162,803,262,541,40
20,363,District - Jamtara (18),Urban,Adolescent (10-19),15736,8243,7493,2324,796,414,997,450,547,18
20,363,District - Jamtara (18),Urban,Youth (15-24),14915,7815,7100,2136,729,368,1402,507,895,57
20,364,District - Ranchi (19),Total,All Ages,2914253,1494937,1419316,152943,1042016,520582,1002820,409693,593127,103770
20,364,District - Ranchi (19),Total,10-14,340174,173691,166483,18656,131651,65828,19760,9098,10662,1718
20,364,District - Ranchi (19),Total,15-19,306556,159706,146850,16396,114454,58639,24956,9366,15590,6813
20,364,District - Ranchi (19),Total,20-24,261237,131590,129647,13561,91043,44608,35447,10475,24972,11135
20,364,District - Ranchi (19),Total,Adolescent (10-19),646730,333397,313333,35052,246105,124467,44716,18464,26252,8531
20,364,District - Ranchi (19),Total,Youth (15-24),567793,291296,276497,29957,205497,103247,60403,19841,40562,17948
20,364,District - Ranchi (19),Rural,All Ages,1656918,840528,816390,84270,789838,395718,703446,280176,423270,95876
20,364,District - Ranchi (19),Rural,10-14,212481,107825,104656,10835,104903,52647,13340,5974,7366,1630
20,364,District - Ranchi (19),Rural,15-19,174038,90992,83046,8259,84879,44009,17741,6146,11595,6421
20,364,District - Ranchi (19),Rural,20-24,136322,69294,67028,6517,63978,31719,25842,7069,18773,10376
20,364,District - Ranchi (19),Rural,Adolescent (10-19),386519,198817,187702,19094,189782,96656,31081,12120,18961,8051
20,364,District - Ranchi (19),Rural,Youth (15-24),310360,160286,150074,14776,148857,75728,43583,13215,30368,16797
20,364,District - Ranchi (19),Urban,All Ages,1257335,654409,602926,68673,252178,124864,299374,129517,169857,7894
20,364,District - Ranchi (19),Urban,10-14,127693,65866,61827,7821,26748,13181,6420,3124,3296,88
20,364,District - Ranchi (19),Urban,15-19,132518,68714,63804,8137,29575,14630,7215,3220,3995,392
20,364,District - Ranchi (19),Urban,20-24,124915,62296,62619,7044,27065,12889,9605,3406,6199,759
20,364,District - Ranchi (19),Urban,Adolescent (10-19),260211,134580,125631,15958,56323,27811,13635,6344,7291,480
20,364,District - Ranchi (19),Urban,Youth (15-24),257433,131010,126423,15181,56640,27519,16820,6626,10194,1151
20,365,District - Khunti (20),Total,All Ages,531885,266335,265550,24037,389626,193710,247310,101594,145716,16422
20,365,District - Khunti (20),Total,10-14,66134,33486,32648,3175,49106,24852,8031,3379,4652,404
20,365,District - Khunti (20),Total,15-19,52570,26720,25850,2375,38434,19420,8297,2851,5446,1198
20,365,District - Khunti (20),Total,20-24,43958,21418,22540,1928,31595,15187,11123,3197,7926,1922
20,365,District - Khunti (20),Total,Adolescent (10-19),118704,60206,58498,5550,87540,44272,16328,6230,10098,1602
20,365,District - Khunti (20),Total,Youth (15-24),96528,48138,48390,4303,70029,34607,19420,6048,13372,3120
20,365,District - Khunti (20),Rural,All Ages,486903,243494,243409,21223,371469,184910,235170,96494,138676,16050
20,365,District - Khunti (20),Rural,10-14,60797,30834,29963,2813,46750,23747,7664,3209,4455,397
20,365,District - Khunti (20),Rural,15-19,47500,24165,23335,2045,36278,18357,8005,2741,5264,1178
20,365,District - Khunti (20),Rural,20-24,39383,19097,20286,1639,29778,14295,10766,3058,7708,1880
20,365,District - Khunti (20),Rural,Adolescent (10-19),108297,54999,53298,4858,83028,42104,15669,5950,9719,1575
20,365,District - Khunti (20),Rural,Youth (15-24),86883,43262,43621,3684,66056,32652,18771,5799,12972,3058
20,365,District - Khunti (20),Urban,All Ages,44982,22841,22141,2814,18157,8800,12140,5100,7040,372
20,365,District - Khunti (20),Urban,10-14,5337,2652,2685,362,2356,1105,367,170,197,7
20,365,District - Khunti (20),Urban,15-19,5070,2555,2515,330,2156,1063,292,110,182,20
20,365,District - Khunti (20),Urban,20-24,4575,2321,2254,289,1817,892,357,139,218,42
20,365,District - Khunti (20),Urban,Adolescent (10-19),10407,5207,5200,692,4512,2168,659,280,379,27
20,365,District - Khunti (20),Urban,Youth (15-24),9645,4876,4769,619,3973,1955,649,249,400,62
20,366,District - Gumla (21),Total,All Ages,1025213,514390,510823,32459,706754,352514,465493,192595,272898,33161
20,366,District - Gumla (21),Total,10-14,137557,69389,68168,4074,96953,48807,12807,5730,7077,822
20,366,District - Gumla (21),Total,15-19,101111,51511,49600,3182,69299,35133,13181,4620,8561,2743
20,366,District - Gumla (21),Total,20-24,80087,39624,40463,2545,53554,26377,18082,5293,12789,4261
20,366,District - Gumla (21),Total,Adolescent (10-19),238668,120900,117768,7256,166252,83940,25988,10350,15638,3565
20,366,District - Gumla (21),Total,Youth (15-24),181198,91135,90063,5727,122853,61510,31263,9913,21350,7004
20,366,District - Gumla (21),Rural,All Ages,960132,481135,478997,29506,682789,340901,450127,185968,264159,32736
20,366,District - Gumla (21),Rural,10-14,128859,65001,63858,3692,93238,47032,12538,5596,6942,817
20,366,District - Gumla (21),Rural,15-19,93235,47572,45663,2795,66081,33617,12839,4450,8389,2725
20,366,District - Gumla (21),Rural,20-24,73644,36318,37326,2249,51360,25306,17689,5143,12546,4231
20,366,District - Gumla (21),Rural,Adolescent (10-19),222094,112573,109521,6487,159319,80649,25377,10046,15331,3542
20,366,District - Gumla (21),Rural,Youth (15-24),166879,83890,82989,5044,117441,58923,30528,9593,20935,6956
20,366,District - Gumla (21),Urban,All Ages,65081,33255,31826,2953,23965,11613,15366,6627,8739,425
20,366,District - Gumla (21),Urban,10-14,8698,4388,4310,382,3715,1775,269,134,135,5
20,366,District - Gumla (21),Urban,15-19,7876,3939,3937,387,3218,1516,342,170,172,18
20,366,District - Gumla (21),Urban,20-24,6443,3306,3137,296,2194,1071,393,150,243,30
20,366,District - Gumla (21),Urban,Adolescent (10-19),16574,8327,8247,769,6933,3291,611,304,307,23
20,366,District - Gumla (21),Urban,Youth (15-24),14319,7245,7074,683,5412,2587,735,320,415,48
20,367,District - Simdega (22),Total,All Ages,599578,300309,299269,44674,424407,211546,256095,108318,147777,29589
20,367,District - Simdega (22),Total,10-14,72722,36726,35996,5485,51467,25880,7662,3541,4121,397
20,367,District - Simdega (22),Total,15-19,57581,29169,28412,4120,40831,20548,7291,2993,4298,2138
20,367,District - Simdega (22),Total,20-24,48374,24053,24321,3400,33984,16793,9783,3507,6276,3585
20,367,District - Simdega (22),Total,Adolescent (10-19),130303,65895,64408,9605,92298,46428,14953,6534,8419,2535
20,367,District - Simdega (22),Total,Youth (15-24),105955,53222,52733,7520,74815,37341,17074,6500,10574,5723
20,367,District - Simdega (22),Rural,All Ages,556634,278425,278209,42751,404487,201913,245218,103511,141707,28685
20,367,District - Simdega (22),Rural,10-14,67090,33742,33348,5211,48734,24471,7437,3425,4012,386
20,367,District - Simdega (22),Rural,15-19,52419,26657,25762,3887,38288,19395,6958,2827,4131,2057
20,367,District - Simdega (22),Rural,20-24,44090,21846,22244,3233,32070,15874,9373,3320,6053,3461
20,367,District - Simdega (22),Rural,Adolescent (10-19),119509,60399,59110,9098,87022,43866,14395,6252,8143,2443
20,367,District - Simdega (22),Rural,Youth (15-24),96509,48503,48006,7120,70358,35269,16331,6147,10184,5518
20,367,District - Simdega (22),Urban,All Ages,42944,21884,21060,1923,19920,9633,10877,4807,6070,904
20,367,District - Simdega (22),Urban,10-14,5632,2984,2648,274,2733,1409,225,116,109,11
20,367,District - Simdega (22),Urban,15-19,5162,2512,2650,233,2543,1153,333,166,167,81
20,367,District - Simdega (22),Urban,20-24,4284,2207,2077,167,1914,919,410,187,223,124
20,367,District - Simdega (22),Urban,Adolescent (10-19),10794,5496,5298,507,5276,2562,558,282,276,92
20,367,District - Simdega (22),Urban,Youth (15-24),9446,4719,4727,400,4457,2072,743,353,390,205
20,368,District - Pashchimi Singhbhum (23),Total,All Ages,1502338,749385,752953,56986,1011296,500949,774777,310112,464665,72410
20,368,District - Pashchimi Singhbhum (23),Total,10-14,188117,96190,91927,6752,132384,67663,34728,14945,19783,1815
20,368,District - Pashchimi Singhbhum (23),Total,15-19,149027,75550,73477,6104,99631,50390,38178,13683,24495,7405
20,368,District - Pashchimi Singhbhum (23),Total,20-24,131468,62879,68589,5435,85995,40428,48425,14533,33892,10355
20,368,District - Pashchimi Singhbhum (23),Total,Adolescent (10-19),337144,171740,165404,12856,232015,118053,72906,28628,44278,9220
20,368,District - Pashchimi Singhbhum (23),Total,Youth (15-24),280495,138429,142066,11539,185626,90818,86603,28216,58387,17760
20,368,District - Pashchimi Singhbhum (23),Rural,All Ages,1284304,637657,646647,38215,953106,472040,713900,285712,428188,71305
20,368,District - Pashchimi Singhbhum (23),Rural,10-14,164918,84351,80567,4671,125062,64031,33151,14222,18929,1800
20,368,District - Pashchimi Singhbhum (23),Rural,15-19,126618,64166,62452,4086,92987,47061,36201,12861,23340,7313
20,368,District - Pashchimi Singhbhum (23),Rural,20-24,109107,51841,57266,3415,79852,37490,45560,13594,31966,10226
20,368,District - Pashchimi Singhbhum (23),Rural,Adolescent (10-19),291536,148517,143019,8757,218049,111092,69352,27083,42269,9113
20,368,District - Pashchimi Singhbhum (23),Rural,Youth (15-24),235725,116007,119718,7501,172839,84551,81761,26455,55306,17539
20,368,District - Pashchimi Singhbhum (23),Urban,All Ages,218034,111728,106306,18771,58190,28909,60877,24400,36477,1105
20,368,District - Pashchimi Singhbhum (23),Urban,10-14,23199,11839,11360,2081,7322,3632,1577,723,854,15
20,368,District - Pashchimi Singhbhum (23),Urban,15-19,22409,11384,11025,2018,6644,3329,1977,822,1155,92
20,368,District - Pashchimi Singhbhum (23),Urban,20-24,22361,11038,11323,2020,6143,2938,2865,939,1926,129
20,368,District - Pashchimi Singhbhum (23),Urban,Adolescent (10-19),45608,23223,22385,4099,13966,6961,3554,1545,2009,107
20,368,District - Pashchimi Singhbhum (23),Urban,Youth (15-24),44770,22422,22348,4038,12787,6267,4842,1761,3081,221
20,369,District - Saraikela-Kharsawan (24),Total,All Ages,1065056,544411,520645,56195,374642,187149,452063,179079,272984,32167
20,369,District - Saraikela-Kharsawan (24),Total,10-14,118908,61089,57819,6283,45173,23221,10043,4249,5794,479
20,369,District - Saraikela-Kharsawan (24),Total,15-19,101849,54022,47827,5641,37214,19337,15382,5155,10227,2517
20,369,District - Saraikela-Kharsawan (24),Total,20-24,94209,47469,46740,5038,33261,16198,21926,6373,15553,3931
20,369,District - Saraikela-Kharsawan (24),Total,Adolescent (10-19),220757,115111,105646,11924,82387,42558,25425,9404,16021,2996
20,369,District - Saraikela-Kharsawan (24),Total,Youth (15-24),196058,101491,94567,10679,70475,35535,37308,11528,25780,6448
20,369,District - Saraikela-Kharsawan (24),Rural,All Ages,806310,408848,397462,43683,345187,172347,371962,144302,227660,31325
20,369,District - Saraikela-Kharsawan (24),Rural,10-14,92604,47377,45227,4930,41886,21544,8120,3299,4821,471
20,369,District - Saraikela-Kharsawan (24),Rural,15-19,77001,40917,36084,4286,34166,17801,12830,4088,8742,2467
20,369,District - Saraikela-Kharsawan (24),Rural,20-24,69263,35111,34152,3774,30206,14774,18287,5142,13145,3831
20,369,District - Saraikela-Kharsawan (24),Rural,Adolescent (10-19),169605,88294,81311,9216,76052,39345,20950,7387,13563,2938
20,369,District - Saraikela-Kharsawan (24),Rural,Youth (15-24),146264,76028,70236,8060,64372,32575,31117,9230,21887,6298
20,369,District - Saraikela-Kharsawan (24),Urban,All Ages,258746,135563,123183,12512,29455,14802,80101,34777,45324,842
20,369,District - Saraikela-Kharsawan (24),Urban,10-14,26304,13712,12592,1353,3287,1677,1923,950,973,8
20,369,District - Saraikela-Kharsawan (24),Urban,15-19,24848,13105,11743,1355,3048,1536,2552,1067,1485,50
20,369,District - Saraikela-Kharsawan (24),Urban,20-24,24946,12358,12588,1264,3055,1424,3639,1231,2408,100
20,369,District - Saraikela-Kharsawan (24),Urban,Adolescent (10-19),51152,26817,24335,2708,6335,3213,4475,2017,2458,58
20,369,District - Saraikela-Kharsawan (24),Urban,Youth (15-24),49794,25463,24331,2619,6103,2960,6191,2298,3893,150
21,0,State - ODISHA (21),Total,All Ages,41974218,21212136,20762082,7188463,9590756,4727732,15231623,6122455,9109168,2420540
21,0,State - ODISHA (21),Total,10-14,4348625,2203535,2145090,788487,1130712,565799,356534,154032,202502,24225
21,0,State - ODISHA (21),Total,15-19,3925398,1972684,1952714,703713,882390,433569,462209,160803,301406,155967
21,0,State - ODISHA (21),Total,20-24,3783527,1870939,1912588,656238,805914,381859,614789,187851,426938,268387
21,0,State - ODISHA (21),Total,Adolescent (10-19),8274023,4176219,4097804,1492200,2013102,999368,818743,314835,503908,180192
21,0,State - ODISHA (21),Total,Youth (15-24),7708925,3843623,3865302,1359951,1688304,815428,1076998,348654,728344,424354
21,0,State - ODISHA (21),Rural,All Ages,34970562,17586203,17384359,6218642,8994967,4428522,13592647,5431651,8160996,2355909
21,0,State - ODISHA (21),Rural,10-14,3705396,1872543,1832853,686503,1057985,529847,322874,138149,184725,23759
21,0,State - ODISHA (21),Rural,15-19,3240171,1616989,1623182,601295,816869,400253,418956,142808,276148,152055
21,0,State - ODISHA (21),Rural,20-24,3078847,1513663,1565184,556348,745451,352018,556137,167228,388909,261427
21,0,State - ODISHA (21),Rural,Adolescent (10-19),6945567,3489532,3456035,1287798,1874854,930100,741830,280957,460873,175814
21,0,State - ODISHA (21),Rural,Youth (15-24),6319018,3130652,3188366,1157643,1562320,752271,975093,310036,665057,413482
21,0,State - ODISHA (21),Urban,All Ages,7003656,3625933,3377723,969821,595789,299210,1638976,690804,948172,64631
21,0,State - ODISHA (21),Urban,10-14,643229,330992,312237,101984,72727,35952,33660,15883,17777,466
21,0,State - ODISHA (21),Urban,15-19,685227,355695,329532,102418,65521,33316,43253,17995,25258,3912
21,0,State - ODISHA (21),Urban,20-24,704680,357276,347404,99890,60463,29841,58652,20623,38029,6960
21,0,State - ODISHA (21),Urban,Adolescent (10-19),1328456,686687,641769,204402,138248,69268,76913,33878,43035,4378
21,0,State - ODISHA (21),Urban,Youth (15-24),1389907,712971,676936,202308,125984,63157,101905,38618,63287,10872
21,370,District - Bargarh (01),Total,All Ages,1481255,749161,732094,298780,281135,140542,497472,191944,305528,152438
21,370,District - Bargarh (01),Total,10-14,142008,71608,70400,30493,30818,15049,5986,2831,3155,1532
21,370,District - Bargarh (01),Total,15-19,150319,74804,75515,30922,30059,14867,8517,3006,5511,12026
21,370,District - Bargarh (01),Total,20-24,138061,69354,68707,27856,24727,12716,13315,3807,9508,17257
21,370,District - Bargarh (01),Total,Adolescent (10-19),292327,146412,145915,61415,60877,29916,14503,5837,8666,13558
21,370,District - Bargarh (01),Total,Youth (15-24),288380,144158,144222,58778,54786,27583,21832,6813,15019,29283
21,370,District - Bargarh (01),Rural,All Ages,1331145,672603,658542,269396,270996,135586,461973,177616,284357,150632
21,370,District - Bargarh (01),Rural,10-14,128275,64645,63630,27358,29704,14602,5518,2607,2911,1517
21,370,District - Bargarh (01),Rural,15-19,135862,67487,68375,27755,28973,14327,7897,2757,5140,11893
21,370,District - Bargarh (01),Rural,20-24,123138,62053,61085,24829,23727,12240,12376,3512,8864,17055
21,370,District - Bargarh (01),Rural,Adolescent (10-19),264137,132132,132005,55113,58677,28929,13415,5364,8051,13410
21,370,District - Bargarh (01),Rural,Youth (15-24),259000,129540,129460,52584,52700,26567,20273,6269,14004,28948
21,370,District - Bargarh (01),Urban,All Ages,150110,76558,73552,29384,10139,4956,35499,14328,21171,1806
21,370,District - Bargarh (01),Urban,10-14,13733,6963,6770,3135,1114,447,468,224,244,15
21,370,District - Bargarh (01),Urban,15-19,14457,7317,7140,3167,1086,540,620,249,371,133
21,370,District - Bargarh (01),Urban,20-24,14923,7301,7622,3027,1000,476,939,295,644,202
21,370,District - Bargarh (01),Urban,Adolescent (10-19),28190,14280,13910,6302,2200,987,1088,473,615,148
21,370,District - Bargarh (01),Urban,Youth (15-24),29380,14618,14762,6194,2086,1016,1559,544,1015,335
21,371,District - Jharsuguda (02),Total,All Ages,579505,296690,282815,104620,176758,88273,173626,68598,105028,21048
21,371,District - Jharsuguda (02),Total,10-14,55856,28119,27737,10313,18902,9222,2082,956,1126,177
21,371,District - Jharsuguda (02),Total,15-19,58206,29354,28852,10870,19659,9587,3221,1286,1935,1472
21,371,District - Jharsuguda (02),Total,20-24,59195,30234,28961,10846,18364,9223,5334,1759,3575,2283
21,371,District - Jharsuguda (02),Total,Adolescent (10-19),114062,57473,56589,21183,38561,18809,5303,2242,3061,1649
21,371,District - Jharsuguda (02),Total,Youth (15-24),117401,59588,57813,21716,38023,18810,8555,3045,5510,3755
21,371,District - Jharsuguda (02),Rural,All Ages,348340,176162,172178,68740,140117,69951,113378,43714,69664,20281
21,371,District - Jharsuguda (02),Rural,10-14,34408,17072,17336,6819,15236,7404,1106,488,618,176
21,371,District - Jharsuguda (02),Rural,15-19,35516,17647,17869,7027,15444,7516,1915,726,1189,1423
21,371,District - Jharsuguda (02),Rural,20-24,34681,17623,17058,6826,14145,7147,3216,1009,2207,2198
21,371,District - Jharsuguda (02),Rural,Adolescent (10-19),69924,34719,35205,13846,30680,14920,3021,1214,1807,1599
21,371,District - Jharsuguda (02),Rural,Youth (15-24),70197,35270,34927,13853,29589,14663,5131,1735,3396,3621
21,371,District - Jharsuguda (02),Urban,All Ages,231165,120528,110637,35880,36641,18322,60248,24884,35364,767
21,371,District - Jharsuguda (02),Urban,10-14,21448,11047,10401,3494,3666,1818,976,468,508,1
21,371,District - Jharsuguda (02),Urban,15-19,22690,11707,10983,3843,4215,2071,1306,560,746,49
21,371,District - Jharsuguda (02),Urban,20-24,24514,12611,11903,4020,4219,2076,2118,750,1368,85
21,371,District - Jharsuguda (02),Urban,Adolescent (10-19),44138,22754,21384,7337,7881,3889,2282,1028,1254,50
21,371,District - Jharsuguda (02),Urban,Youth (15-24),47204,24318,22886,7863,8434,4147,3424,1310,2114,134
21,372,District - Sambalpur (03),Total,All Ages,1041099,526877,514222,191827,355261,177565,337408,133685,203723,73078
21,372,District - Sambalpur (03),Total,10-14,100994,51189,49805,18879,39307,19685,4872,2341,2531,801
21,372,District - Sambalpur (03),Total,15-19,102645,51393,51252,19367,38165,18881,6811,2685,4126,5992
21,372,District - Sambalpur (03),Total,20-24,99995,49111,50884,18657,34256,16849,11131,3589,7542,8579
21,372,District - Sambalpur (03),Total,Adolescent (10-19),203639,102582,101057,38246,77472,38566,11683,5026,6657,6793
21,372,District - Sambalpur (03),Total,Youth (15-24),202640,100504,102136,38024,72421,35730,17942,6274,11668,14571
21,372,District - Sambalpur (03),Rural,All Ages,733006,368692,364314,134729,318413,158927,262109,102464,159645,70711
21,372,District - Sambalpur (03),Rural,10-14,73628,37079,36549,13211,35433,17670,3532,1688,1844,786
21,372,District - Sambalpur (03),Rural,15-19,72832,36225,36607,13359,33882,16739,5128,1989,3139,5847
21,372,District - Sambalpur (03),Rural,20-24,68488,33781,34707,12564,30185,14861,8583,2700,5883,8308
21,372,District - Sambalpur (03),Rural,Adolescent (10-19),146460,73304,73156,26570,69315,34409,8660,3677,4983,6633
21,372,District - Sambalpur (03),Rural,Youth (15-24),141320,70006,71314,25923,64067,31600,13711,4689,9022,14155
21,372,District - Sambalpur (03),Urban,All Ages,308093,158185,149908,57098,36848,18638,75299,31221,44078,2367
21,372,District - Sambalpur (03),Urban,10-14,27366,14110,13256,5668,3874,2015,1340,653,687,15
21,372,District - Sambalpur (03),Urban,15-19,29813,15168,14645,6008,4283,2142,1683,696,987,145
21,372,District - Sambalpur (03),Urban,20-24,31507,15330,16177,6093,4071,1988,2548,889,1659,271
21,372,District - Sambalpur (03),Urban,Adolescent (10-19),57179,29278,27901,11676,8157,4157,3023,1349,1674,160
21,372,District - Sambalpur (03),Urban,Youth (15-24),61320,30498,30822,12101,8354,4130,4231,1585,2646,416
21,373,District - Debagarh (04),Total,All Ages,312520,158230,154290,52112,110400,55126,114701,45581,69120,24462
21,373,District - Debagarh (04),Total,10-14,34337,17523,16814,5852,13445,6793,2046,950,1096,167
21,373,District - Debagarh (04),Total,15-19,29783,14792,14991,5066,10783,5338,2765,999,1766,1454
21,373,District - Debagarh (04),Total,20-24,27793,13407,14386,4704,9710,4647,4141,1224,2917,2479
21,373,District - Debagarh (04),Total,Adolescent (10-19),64120,32315,31805,10918,24228,12131,4811,1949,2862,1621
21,373,District - Debagarh (04),Total,Youth (15-24),57576,28199,29377,9770,20493,9985,6906,2223,4683,3933
21,373,District - Debagarh (04),Rural,All Ages,290130,146666,143464,48246,104956,52324,108830,43130,65700,24031
21,373,District - Debagarh (04),Rural,10-14,31991,16288,15703,5460,12638,6332,1953,910,1043,166
21,373,District - Debagarh (04),Rural,15-19,27812,13808,14004,4699,10271,5099,2604,927,1677,1433
21,373,District - Debagarh (04),Rural,20-24,25720,12381,13339,4283,9220,4421,3905,1143,2762,2443
21,373,District - Debagarh (04),Rural,Adolescent (10-19),59803,30096,29707,10159,22909,11431,4557,1837,2720,1599
21,373,District - Debagarh (04),Rural,Youth (15-24),53532,26189,27343,8982,19491,9520,6509,2070,4439,3876
21,373,District - Debagarh (04),Urban,All Ages,22390,11564,10826,3866,5444,2802,5871,2451,3420,431
21,373,District - Debagarh (04),Urban,10-14,2346,1235,1111,392,807,461,93,40,53,1
21,373,District - Debagarh (04),Urban,15-19,1971,984,987,367,512,239,161,72,89,21
21,373,District - Debagarh (04),Urban,20-24,2073,1026,1047,421,490,226,236,81,155,36
21,373,District - Debagarh (04),Urban,Adolescent (10-19),4317,2219,2098,759,1319,700,254,112,142,22
21,373,District - Debagarh (04),Urban,Youth (15-24),4044,2010,2034,788,1002,465,397,153,244,57
21,374,District - Sundargarh (05),Total,All Ages,2093437,1061147,1032290,191660,1062349,526856,751115,311000,440115,59287
21,374,District - Sundargarh (05),Total,10-14,218517,109916,108601,19674,121677,60071,15805,7310,8495,597
21,374,District - Sundargarh (05),Total,15-19,203116,103166,99950,18979,106538,53050,22041,8848,13193,3801
21,374,District - Sundargarh (05),Total,20-24,196990,97842,99148,18861,98043,47353,31189,10370,20819,6498
21,374,District - Sundargarh (05),Total,Adolescent (10-19),421633,213082,208551,38653,228215,113121,37846,16158,21688,4398
21,374,District - Sundargarh (05),Total,Youth (15-24),400106,201008,199098,37840,204581,100403,53230,19218,34012,10299
21,374,District - Sundargarh (05),Rural,All Ages,1355340,676068,679272,115853,908475,450276,573193,234575,338618,57404
21,374,District - Sundargarh (05),Rural,10-14,150122,74847,75275,12114,105166,52141,12335,5611,6724,586
21,374,District - Sundargarh (05),Rural,15-19,131255,65755,65500,11249,89681,44747,17427,6765,10662,3676
21,374,District - Sundargarh (05),Rural,20-24,121788,59020,62768,10671,81711,39343,24588,7952,16636,6262
21,374,District - Sundargarh (05),Rural,Adolescent (10-19),281377,140602,140775,23363,194847,96888,29762,12376,17386,4262
21,374,District - Sundargarh (05),Rural,Youth (15-24),253043,124775,128268,21920,171392,84090,42015,14717,27298,9938
21,374,District - Sundargarh (05),Urban,All Ages,738097,385079,353018,75807,153874,76580,177922,76425,101497,1883
21,374,District - Sundargarh (05),Urban,10-14,68395,35069,33326,7560,16511,7930,3470,1699,1771,11
21,374,District - Sundargarh (05),Urban,15-19,71861,37411,34450,7730,16857,8303,4614,2083,2531,125
21,374,District - Sundargarh (05),Urban,20-24,75202,38822,36380,8190,16332,8010,6601,2418,4183,236
21,374,District - Sundargarh (05),Urban,Adolescent (10-19),140256,72480,67776,15290,33368,16233,8084,3782,4302,136
21,374,District - Sundargarh (05),Urban,Youth (15-24),147063,76233,70830,15920,33189,16313,11215,4501,6714,361
21,375,District - Kendujhar (06),Total,All Ages,1801733,906487,895246,209357,818878,405927,749215,301368,447847,84638
21,375,District - Kendujhar (06),Total,10-14,186946,94841,92105,21418,94631,48065,23938,10618,13320,811
21,375,District - Kendujhar (06),Total,15-19,162254,80654,81600,20405,75137,36960,26808,9649,17159,5136
21,375,District - Kendujhar (06),Total,20-24,161187,77061,84126,20169,72421,33665,34834,10375,24459,9457
21,375,District - Kendujhar (06),Total,Adolescent (10-19),349200,175495,173705,41823,169768,85025,50746,20267,30479,5947
21,375,District - Kendujhar (06),Total,Youth (15-24),323441,157715,165726,40574,147558,70625,61642,20024,41618,14593
21,375,District - Kendujhar (06),Rural,All Ages,1548674,774667,774007,172913,759937,376255,667985,267351,400634,82764
21,375,District - Kendujhar (06),Rural,10-14,161947,81940,80007,17662,87975,44582,20858,9213,11645,798
21,375,District - Kendujhar (06),Rural,15-19,139233,68944,70289,16677,69710,34225,23902,8481,15421,5011
21,375,District - Kendujhar (06),Rural,20-24,136860,65017,71843,16382,66441,30868,30791,9068,21723,9228
21,375,District - Kendujhar (06),Rural,Adolescent (10-19),301180,150884,150296,34339,157685,78807,44760,17694,27066,5809
21,375,District - Kendujhar (06),Rural,Youth (15-24),276093,133961,142132,33059,136151,65093,54693,17549,37144,14239
21,375,District - Kendujhar (06),Urban,All Ages,253059,131820,121239,36444,58941,29672,81230,34017,47213,1874
21,375,District - Kendujhar (06),Urban,10-14,24999,12901,12098,3756,6656,3483,3080,1405,1675,13
21,375,District - Kendujhar (06),Urban,15-19,23021,11710,11311,3728,5427,2735,2906,1168,1738,125
21,375,District - Kendujhar (06),Urban,20-24,24327,12044,12283,3787,5980,2797,4043,1307,2736,229
21,375,District - Kendujhar (06),Urban,Adolescent (10-19),48020,24611,23409,7484,12083,6218,5986,2573,3413,138
21,375,District - Kendujhar (06),Urban,Youth (15-24),47348,23754,23594,7515,11407,5532,6949,2475,4474,354
21,376,District - Mayurbhanj (07),Total,All Ages,2519738,1256213,1263525,184682,1479576,730487,1150341,462042,688299,145285
21,376,District - Mayurbhanj (07),Total,10-14,286358,144421,141937,20425,181488,91142,35826,15427,20399,1753
21,376,District - Mayurbhanj (07),Total,15-19,229826,116965,112861,17881,134677,67915,44288,15650,28638,9110
21,376,District - Mayurbhanj (07),Total,20-24,212210,102128,110082,16370,123591,58198,55147,16794,38353,16067
21,376,District - Mayurbhanj (07),Total,Adolescent (10-19),516184,261386,254798,38306,316165,159057,80114,31077,49037,10863
21,376,District - Mayurbhanj (07),Total,Youth (15-24),442036,219093,222943,34251,258268,126113,99435,32444,66991,25177
21,376,District - Mayurbhanj (07),Rural,All Ages,2326842,1157576,1169266,163237,1439002,710396,1106414,443663,662751,143550
21,376,District - Mayurbhanj (07),Rural,10-14,267671,135194,132477,18351,176145,88755,34954,15015,19939,1743
21,376,District - Mayurbhanj (07),Rural,15-19,209311,106199,103112,15442,129708,65391,43150,15137,28013,9000
21,376,District - Mayurbhanj (07),Rural,20-24,194052,93078,100974,14156,119519,56176,53654,16274,37380,15863
21,376,District - Mayurbhanj (07),Rural,Adolescent (10-19),476982,241393,235589,33793,305853,154146,78104,30152,47952,10743
21,376,District - Mayurbhanj (07),Rural,Youth (15-24),403363,199277,204086,29598,249227,121567,96804,31411,65393,24863
21,376,District - Mayurbhanj (07),Urban,All Ages,192896,98637,94259,21445,40574,20091,43927,18379,25548,1735
21,376,District - Mayurbhanj (07),Urban,10-14,18687,9227,9460,2074,5343,2387,872,412,460,10
21,376,District - Mayurbhanj (07),Urban,15-19,20515,10766,9749,2439,4969,2524,1138,513,625,110
21,376,District - Mayurbhanj (07),Urban,20-24,18158,9050,9108,2214,4072,2022,1493,520,973,204
21,376,District - Mayurbhanj (07),Urban,Adolescent (10-19),39202,19993,19209,4513,10312,4911,2010,925,1085,120
21,376,District - Mayurbhanj (07),Urban,Youth (15-24),38673,19816,18857,4653,9041,4546,2631,1033,1598,314
21,377,District - Baleshwar (08),Total,All Ages,2320529,1185787,1134742,478586,275678,137748,699297,283428,415869,165636
21,377,District - Baleshwar (08),Total,10-14,243440,124011,119429,55086,33797,16997,14902,6607,8295,1307
21,377,District - Baleshwar (08),Total,15-19,214714,109635,105079,45649,26257,13194,18384,6834,11550,10575
21,377,District - Baleshwar (08),Total,20-24,209861,105710,104151,43241,24206,11704,24053,7843,16210,20771
21,377,District - Baleshwar (08),Total,Adolescent (10-19),458154,233646,224508,100735,60054,30191,33286,13441,19845,11882
21,377,District - Baleshwar (08),Total,Youth (15-24),424575,215345,209230,88890,50463,24898,42437,14677,27760,31346
21,377,District - Baleshwar (08),Rural,All Ages,2067236,1056466,1010770,447936,255098,127371,636895,256584,380311,158964
21,377,District - Baleshwar (08),Rural,10-14,219553,111708,107845,51901,31264,15704,13332,5864,7468,1258
21,377,District - Baleshwar (08),Rural,15-19,191140,97594,93546,42599,24123,12061,16543,6048,10495,10117
21,377,District - Baleshwar (08),Rural,20-24,185849,93842,92007,40179,22132,10700,21718,6966,14752,19936
21,377,District - Baleshwar (08),Rural,Adolescent (10-19),410693,209302,201391,94500,55387,27765,29875,11912,17963,11375
21,377,District - Baleshwar (08),Rural,Youth (15-24),376989,191436,185553,82778,46255,22761,38261,13014,25247,30053
21,377,District - Baleshwar (08),Urban,All Ages,253293,129321,123972,30650,20580,10377,62402,26844,35558,6672
21,377,District - Baleshwar (08),Urban,10-14,23887,12303,11584,3185,2533,1293,1570,743,827,49
21,377,District - Baleshwar (08),Urban,15-19,23574,12041,11533,3050,2134,1133,1841,786,1055,458
21,377,District - Baleshwar (08),Urban,20-24,24012,11868,12144,3062,2074,1004,2335,877,1458,835
21,377,District - Baleshwar (08),Urban,Adolescent (10-19),47461,24344,23117,6235,4667,2426,3411,1529,1882,507
21,377,District - Baleshwar (08),Urban,Youth (15-24),47586,23909,23677,6112,4208,2137,4176,1663,2513,1293
21,378,District - Bhadrak (09),Total,All Ages,1506337,760260,746077,334896,30428,15361,412197,163991,248206,75320
21,378,District - Bhadrak (09),Total,10-14,162454,82158,80296,39191,3827,2003,7432,3442,3990,449
21,378,District - Bhadrak (09),Total,15-19,147509,73217,74292,33062,2806,1444,9171,3378,5793,4130
21,378,District - Bhadrak (09),Total,20-24,140434,69202,71232,30701,2701,1333,12074,3938,8136,9111
21,378,District - Bhadrak (09),Total,Adolescent (10-19),309963,155375,154588,72253,6633,3447,16603,6820,9783,4579
21,378,District - Bhadrak (09),Total,Youth (15-24),287943,142419,145524,63763,5507,2777,21245,7316,13929,13241
21,378,District - Bhadrak (09),Rural,All Ages,1320499,665255,655244,316246,24347,12335,355786,139536,216250,70423
21,378,District - Bhadrak (09),Rural,10-14,143120,72310,70810,37157,3158,1660,5732,2553,3179,421
21,378,District - Bhadrak (09),Rural,15-19,128142,63470,64672,31238,2207,1149,6740,2309,4431,3805
21,378,District - Bhadrak (09),Rural,20-24,122217,60120,62097,28842,2118,1039,9373,2857,6516,8498
21,378,District - Bhadrak (09),Rural,Adolescent (10-19),271262,135780,135482,68395,5365,2809,12472,4862,7610,4226
21,378,District - Bhadrak (09),Rural,Youth (15-24),250359,123590,126769,60080,4325,2188,16113,5166,10947,12303
21,378,District - Bhadrak (09),Urban,All Ages,185838,95005,90833,18650,6081,3026,56411,24455,31956,4897
21,378,District - Bhadrak (09),Urban,10-14,19334,9848,9486,2034,669,343,1700,889,811,28
21,378,District - Bhadrak (09),Urban,15-19,19367,9747,9620,1824,599,295,2431,1069,1362,325
21,378,District - Bhadrak (09),Urban,20-24,18217,9082,9135,1859,583,294,2701,1081,1620,613
21,378,District - Bhadrak (09),Urban,Adolescent (10-19),38701,19595,19106,3858,1268,638,4131,1958,2173,353
21,378,District - Bhadrak (09),Urban,Youth (15-24),37584,18829,18755,3683,1182,589,5132,2150,2982,938
21,379,District - Kendrapara (10),Total,All Ages,1440361,717814,722547,309780,9484,4748,351096,137844,213252,70136
21,379,District - Kendrapara (10),Total,10-14,146260,74101,72159,34020,1163,582,3692,1799,1893,210
21,379,District - Kendrapara (10),Total,15-19,135500,66595,68905,29795,871,440,4643,1746,2897,2827
21,379,District - Kendrapara (10),Total,20-24,130371,62335,68036,27523,794,389,6705,2093,4612,7361
21,379,District - Kendrapara (10),Total,Adolescent (10-19),281760,140696,141064,63815,2034,1022,8335,3545,4790,3037
21,379,District - Kendrapara (10),Total,Youth (15-24),265871,128930,136941,57318,1665,829,11348,3839,7509,10188
21,379,District - Kendrapara (10),Rural,All Ages,1356827,675053,681774,293691,8862,4424,333342,130294,203048,68599
21,379,District - Kendrapara (10),Rural,10-14,138391,69959,68432,32239,1105,555,3423,1652,1771,210
21,379,District - Kendrapara (10),Rural,15-19,126750,62201,64549,28160,799,400,4262,1577,2685,2736
21,379,District - Kendrapara (10),Rural,20-24,122417,58365,64052,26070,721,359,6253,1917,4336,7198
21,379,District - Kendrapara (10),Rural,Adolescent (10-19),265141,132160,132981,60399,1904,955,7685,3229,4456,2946
21,379,District - Kendrapara (10),Rural,Youth (15-24),249167,120566,128601,54230,1520,759,10515,3494,7021,9934
21,379,District - Kendrapara (10),Urban,All Ages,83534,42761,40773,16089,622,324,17754,7550,10204,1537
21,379,District - Kendrapara (10),Urban,10-14,7869,4142,3727,1781,58,27,269,147,122,0
21,379,District - Kendrapara (10),Urban,15-19,8750,4394,4356,1635,72,40,381,169,212,91
21,379,District - Kendrapara (10),Urban,20-24,7954,3970,3984,1453,73,30,452,176,276,163
21,379,District - Kendrapara (10),Urban,Adolescent (10-19),16619,8536,8083,3416,130,67,650,316,334,91
21,379,District - Kendrapara (10),Urban,Youth (15-24),16704,8364,8340,3088,145,70,833,345,488,254
21,380,District - Jagatsinghapur (11),Total,All Ages,1136971,577865,559106,248152,7862,4226,247944,96816,151128,56051
21,380,District - Jagatsinghapur (11),Total,10-14,102173,52473,49700,24342,1031,618,2250,1112,1138,210
21,380,District - Jagatsinghapur (11),Total,15-19,101364,51058,50306,22987,755,401,2786,1137,1649,2022
21,380,District - Jagatsinghapur (11),Total,20-24,105529,52109,53420,22991,729,361,4205,1383,2822,5232
21,380,District - Jagatsinghapur (11),Total,Adolescent (10-19),203537,103531,100006,47329,1786,1019,5036,2249,2787,2232
21,380,District - Jagatsinghapur (11),Total,Youth (15-24),206893,103167,103726,45978,1484,762,6991,2520,4471,7254
21,380,District - Jagatsinghapur (11),Rural,All Ages,1020991,516813,504178,231690,4524,2449,222789,85854,136935,54867
21,380,District - Jagatsinghapur (11),Rural,10-14,91139,46699,44440,22743,615,375,1769,868,901,203
21,380,District - Jagatsinghapur (11),Rural,15-19,89618,44966,44652,21248,399,208,2151,831,1320,1979
21,380,District - Jagatsinghapur (11),Rural,20-24,93487,45864,47623,21316,384,181,3435,1085,2350,5126
21,380,District - Jagatsinghapur (11),Rural,Adolescent (10-19),180757,91665,89092,43991,1014,583,3920,1699,2221,2182
21,380,District - Jagatsinghapur (11),Rural,Youth (15-24),183105,90830,92275,42564,783,389,5586,1916,3670,7105
21,380,District - Jagatsinghapur (11),Urban,All Ages,115980,61052,54928,16462,3338,1777,25155,10962,14193,1184
21,380,District - Jagatsinghapur (11),Urban,10-14,11034,5774,5260,1599,416,243,481,244,237,7
21,380,District - Jagatsinghapur (11),Urban,15-19,11746,6092,5654,1739,356,193,635,306,329,43
21,380,District - Jagatsinghapur (11),Urban,20-24,12042,6245,5797,1675,345,180,770,298,472,106
21,380,District - Jagatsinghapur (11),Urban,Adolescent (10-19),22780,11866,10914,3338,772,436,1116,550,566,50
21,380,District - Jagatsinghapur (11),Urban,Youth (15-24),23788,12337,11451,3414,701,373,1405,604,801,149
21,381,District - Cuttack (12),Total,All Ages,2624470,1352760,1271710,498633,93745,47437,613001,249727,363274,132637
21,381,District - Cuttack (12),Total,10-14,238642,121601,117041,49531,11241,5605,7889,3795,4094,549
21,381,District - Cuttack (12),Total,15-19,245866,125374,120492,48028,8651,4390,10186,4025,6161,6299
21,381,District - Cuttack (12),Total,20-24,250178,126966,123212,46153,7881,3958,13792,4929,8863,12716
21,381,District - Cuttack (12),Total,Adolescent (10-19),484508,246975,237533,97559,19892,9995,18075,7820,10255,6848
21,381,District - Cuttack (12),Total,Youth (15-24),496044,252340,243704,94181,16532,8348,23978,8954,15024,19015
21,381,District - Cuttack (12),Rural,All Ages,1888423,970885,917538,406771,81658,41229,480445,190863,289582,129162
21,381,District - Cuttack (12),Rural,10-14,177698,90912,86786,40618,9765,4882,5323,2508,2815,524
21,381,District - Cuttack (12),Rural,15-19,172343,87616,84727,38559,7375,3716,7158,2649,4509,6164
21,381,District - Cuttack (12),Rural,20-24,171693,87192,84501,36607,6688,3324,9923,3330,6593,12376
21,381,District - Cuttack (12),Rural,Adolescent (10-19),350041,178528,171513,79177,17140,8598,12481,5157,7324,6688
21,381,District - Cuttack (12),Rural,Youth (15-24),344036,174808,169228,75166,14063,7040,17081,5979,11102,18540
21,381,District - Cuttack (12),Urban,All Ages,736047,381875,354172,91862,12087,6208,132556,58864,73692,3475
21,381,District - Cuttack (12),Urban,10-14,60944,30689,30255,8913,1476,723,2566,1287,1279,25
21,381,District - Cuttack (12),Urban,15-19,73523,37758,35765,9469,1276,674,3028,1376,1652,135
21,381,District - Cuttack (12),Urban,20-24,78485,39774,38711,9546,1193,634,3869,1599,2270,340
21,381,District - Cuttack (12),Urban,Adolescent (10-19),134467,68447,66020,18382,2752,1397,5594,2663,2931,160
21,381,District - Cuttack (12),Urban,Youth (15-24),152008,77532,74476,19015,2469,1308,6897,2975,3922,475
21,382,District - Jajapur (13),Total,All Ages,1827192,926034,901158,433387,151432,76048,536737,219638,317099,106247
21,382,District - Jajapur (13),Total,10-14,181807,92921,88886,46639,18877,9780,10165,4690,5475,375
21,382,District - Jajapur (13),Total,15-19,174316,86893,87423,44217,14389,7100,13940,5223,8717,4185
21,382,District - Jajapur (13),Total,20-24,177973,87903,90070,43147,13884,6631,18712,6305,12407,11141
21,382,District - Jajapur (13),Total,Adolescent (10-19),356123,179814,176309,90856,33266,16880,24105,9913,14192,4560
21,382,District - Jajapur (13),Total,Youth (15-24),352289,174796,177493,87364,28273,13731,32652,11528,21124,15326
21,382,District - Jajapur (13),Rural,All Ages,1692095,856539,835556,415652,139209,69976,503612,205386,298226,103582
21,382,District - Jajapur (13),Rural,10-14,168768,86074,82694,44864,17414,9036,9526,4412,5114,367
21,382,District - Jajapur (13),Rural,15-19,161880,80646,81234,42388,13242,6553,13065,4874,8191,4044
21,382,District - Jajapur (13),Rural,20-24,164766,81329,83437,41236,12715,6094,17586,5927,11659,10812
21,382,District - Jajapur (13),Rural,Adolescent (10-19),330648,166720,163928,87252,30656,15589,22591,9286,13305,4411
21,382,District - Jajapur (13),Rural,Youth (15-24),326646,161975,164671,83624,25957,12647,30651,10801,19850,14856
21,382,District - Jajapur (13),Urban,All Ages,135097,69495,65602,17735,12223,6072,33125,14252,18873,2665
21,382,District - Jajapur (13),Urban,10-14,13039,6847,6192,1775,1463,744,639,278,361,8
21,382,District - Jajapur (13),Urban,15-19,12436,6247,6189,1829,1147,547,875,349,526,141
21,382,District - Jajapur (13),Urban,20-24,13207,6574,6633,1911,1169,537,1126,378,748,329
21,382,District - Jajapur (13),Urban,Adolescent (10-19),25475,13094,12381,3604,2610,1291,1514,627,887,149
21,382,District - Jajapur (13),Urban,Youth (15-24),25643,12821,12822,3740,2316,1084,2001,727,1274,470
21,383,District - Dhenkanal (14),Total,All Ages,1192811,612593,580218,234079,162056,80878,362901,148500,214401,66856
21,383,District - Dhenkanal (14),Total,10-14,116633,59558,57075,25105,19089,9463,4844,2165,2679,455
21,383,District - Dhenkanal (14),Total,15-19,111728,57172,54556,22071,15155,7703,6697,2538,4159,3284
21,383,District - Dhenkanal (14),Total,20-24,108215,53578,54637,20217,13870,6888,9993,3182,6811,6327
21,383,District - Dhenkanal (14),Total,Adolescent (10-19),228361,116730,111631,47176,34244,17166,11541,4703,6838,3739
21,383,District - Dhenkanal (14),Total,Youth (15-24),219943,110750,109193,42288,29025,14591,16690,5720,10970,9611
21,383,District - Dhenkanal (14),Rural,All Ages,1075305,551326,523979,215178,156671,78204,339782,138559,201223,64785
21,383,District - Dhenkanal (14),Rural,10-14,106540,54309,52231,23160,18492,9153,4552,2020,2532,446
21,383,District - Dhenkanal (14),Rural,15-19,99898,50969,48929,20189,14631,7412,6326,2383,3943,3189
21,383,District - Dhenkanal (14),Rural,20-24,96649,47679,48970,18367,13385,6611,9510,3003,6507,6141
21,383,District - Dhenkanal (14),Rural,Adolescent (10-19),206438,105278,101160,43349,33123,16565,10878,4403,6475,3635
21,383,District - Dhenkanal (14),Rural,Youth (15-24),196547,98648,97899,38556,28016,14023,15836,5386,10450,9330
21,383,District - Dhenkanal (14),Urban,All Ages,117506,61267,56239,18901,5385,2674,23119,9941,13178,2071
21,383,District - Dhenkanal (14),Urban,10-14,10093,5249,4844,1945,597,310,292,145,147,9
21,383,District - Dhenkanal (14),Urban,15-19,11830,6203,5627,1882,524,291,371,155,216,95
21,383,District - Dhenkanal (14),Urban,20-24,11566,5899,5667,1850,485,277,483,179,304,186
21,383,District - Dhenkanal (14),Urban,Adolescent (10-19),21923,11452,10471,3827,1121,601,663,300,363,104
21,383,District - Dhenkanal (14),Urban,Youth (15-24),23396,12102,11294,3732,1009,568,854,334,520,281
21,384,District - Anugul (15),Total,All Ages,1273821,655718,618103,239552,179603,89980,404365,161293,243072,57414
21,384,District - Anugul (15),Total,10-14,134215,68696,65519,27662,22420,11179,6346,2845,3501,549
21,384,District - Anugul (15),Total,15-19,122038,61264,60774,23549,16499,8265,8867,3217,5650,3246
21,384,District - Anugul (15),Total,20-24,119804,59356,60448,22564,15736,7596,13249,4026,9223,5978
21,384,District - Anugul (15),Total,Adolescent (10-19),256253,129960,126293,51211,38919,19444,15213,6062,9151,3795
21,384,District - Anugul (15),Total,Youth (15-24),241842,120620,121222,46113,32235,15861,22116,7243,14873,9224
21,384,District - Anugul (15),Rural,All Ages,1067275,546385,520890,205004,162048,80989,358206,141613,216593,56558
21,384,District - Anugul (15),Rural,10-14,114598,58291,56307,23736,20543,10186,5492,2449,3043,543
21,384,District - Anugul (15),Rural,15-19,101336,50639,50697,19737,14800,7422,7869,2822,5047,3212
21,384,District - Anugul (15),Rural,20-24,99199,48827,50372,18998,13913,6715,11757,3543,8214,5907
21,384,District - Anugul (15),Rural,Adolescent (10-19),215934,108930,107004,43473,35343,17608,13361,5271,8090,3755
21,384,District - Anugul (15),Rural,Youth (15-24),200535,99466,101069,38735,28713,14137,19626,6365,13261,9119
21,384,District - Anugul (15),Urban,All Ages,206546,109333,97213,34548,17555,8991,46159,19680,26479,856
21,384,District - Anugul (15),Urban,10-14,19617,10405,9212,3926,1877,993,854,396,458,6
21,384,District - Anugul (15),Urban,15-19,20702,10625,10077,3812,1699,843,998,395,603,34
21,384,District - Anugul (15),Urban,20-24,20605,10529,10076,3566,1823,881,1492,483,1009,71
21,384,District - Anugul (15),Urban,Adolescent (10-19),40319,21030,19289,7738,3576,1836,1852,791,1061,40
21,384,District - Anugul (15),Urban,Youth (15-24),41307,21154,20153,7378,3522,1724,2490,878,1612,105
21,385,District - Nayagarh (16),Total,All Ages,962789,502636,460153,136399,58691,29173,274427,110303,164124,59247
21,385,District - Nayagarh (16),Total,10-14,94282,48616,45666,14238,6854,3211,2690,1267,1423,331
21,385,District - Nayagarh (16),Total,15-19,85109,44455,40654,12490,4896,2471,3434,1356,2078,3108
21,385,District - Nayagarh (16),Total,20-24,81985,42577,39408,11660,4662,2316,5389,1835,3554,5969
21,385,District - Nayagarh (16),Total,Adolescent (10-19),179391,93071,86320,26728,11750,5682,6124,2623,3501,3439
21,385,District - Nayagarh (16),Total,Youth (15-24),167094,87032,80062,24150,9558,4787,8823,3191,5632,9077
21,385,District - Nayagarh (16),Rural,All Ages,883051,461019,422032,125932,57531,28531,257706,103332,154374,58384
21,385,District - Nayagarh (16),Rural,10-14,87051,44828,42223,13163,6700,3144,2509,1174,1335,328
21,385,District - Nayagarh (16),Rural,15-19,77897,40702,37195,11420,4790,2417,3267,1282,1985,3071
21,385,District - Nayagarh (16),Rural,20-24,74799,38913,35886,10704,4551,2238,5115,1739,3376,5896
21,385,District - Nayagarh (16),Rural,Adolescent (10-19),164948,85530,79418,24583,11490,5561,5776,2456,3320,3399
21,385,District - Nayagarh (16),Rural,Youth (15-24),152696,79615,73081,22124,9341,4655,8382,3021,5361,8967
21,385,District - Nayagarh (16),Urban,All Ages,79738,41617,38121,10467,1160,642,16721,6971,9750,863
21,385,District - Nayagarh (16),Urban,10-14,7231,3788,3443,1075,154,67,181,93,88,3
21,385,District - Nayagarh (16),Urban,15-19,7212,3753,3459,1070,106,54,167,74,93,37
21,385,District - Nayagarh (16),Urban,20-24,7186,3664,3522,956,111,78,274,96,178,73
21,385,District - Nayagarh (16),Urban,Adolescent (10-19),14443,7541,6902,2145,260,121,348,167,181,40
21,385,District - Nayagarh (16),Urban,Youth (15-24),14398,7417,6981,2026,217,132,441,170,271,110
21,386,District - Khordha (17),Total,All Ages,2251673,1167137,1084536,297472,115051,59094,501737,209622,292115,64072
21,386,District - Khordha (17),Total,10-14,204115,106035,98080,30306,15262,8008,7480,3496,3984,344
21,386,District - Khordha (17),Total,15-19,211257,110381,100876,29501,13096,7095,9171,3673,5498,3540
21,386,District - Khordha (17),Total,20-24,223140,113883,109257,29606,10283,5123,12328,4320,8008,6772
21,386,District - Khordha (17),Total,Adolescent (10-19),415372,216416,198956,59807,28358,15103,16651,7169,9482,3884
21,386,District - Khordha (17),Total,Youth (15-24),434397,224264,210133,59107,23379,12218,21499,7993,13506,10312
21,386,District - Khordha (17),Rural,All Ages,1167357,595809,571548,189428,67798,33817,307677,124120,183557,58094
21,386,District - Khordha (17),Rural,10-14,112710,57444,55266,19467,7452,3736,3878,1829,2049,317
21,386,District - Khordha (17),Rural,15-19,107856,54409,53447,18404,6611,3290,4943,1885,3058,3243
21,386,District - Khordha (17),Rural,20-24,109241,55165,54076,18079,5688,2798,6737,2335,4402,6170
21,386,District - Khordha (17),Rural,Adolescent (10-19),220566,111853,108713,37871,14063,7026,8821,3714,5107,3560
21,386,District - Khordha (17),Rural,Youth (15-24),217097,109574,107523,36483,12299,6088,11680,4220,7460,9413
21,386,District - Khordha (17),Urban,All Ages,1084316,571328,512988,108044,47253,25277,194060,85502,108558,5978
21,386,District - Khordha (17),Urban,10-14,91405,48591,42814,10839,7810,4272,3602,1667,1935,27
21,386,District - Khordha (17),Urban,15-19,103401,55972,47429,11097,6485,3805,4228,1788,2440,297
21,386,District - Khordha (17),Urban,20-24,113899,58718,55181,11527,4595,2325,5591,1985,3606,602
21,386,District - Khordha (17),Urban,Adolescent (10-19),194806,104563,90243,21936,14295,8077,7830,3455,4375,324
21,386,District - Khordha (17),Urban,Youth (15-24),217300,114690,102610,22624,11080,6130,9819,3773,6046,899
21,387,District - Puri (18),Total,All Ages,1698730,865380,833350,325133,6129,3240,406791,160523,246268,79505
21,387,District - Puri (18),Total,10-14,161415,82514,78901,33931,1002,614,4036,1930,2106,261
21,387,District - Puri (18),Total,15-19,154296,78016,76280,30713,571,323,4697,2070,2627,3420
21,387,District - Puri (18),Total,20-24,162387,81343,81044,29917,475,249,7211,2376,4835,8084
21,387,District - Puri (18),Total,Adolescent (10-19),315711,160530,155181,64644,1573,937,8733,4000,4733,3681
21,387,District - Puri (18),Total,Youth (15-24),316683,159359,157324,60630,1046,572,11908,4446,7462,11504
21,387,District - Puri (18),Rural,All Ages,1433800,728213,705587,296881,4379,2251,351598,136363,215235,77394
21,387,District - Puri (18),Rural,10-14,138703,70703,68000,30933,466,274,2841,1336,1505,251
21,387,District - Puri (18),Rural,15-19,130153,65211,64942,27744,378,206,3127,1240,1887,3336
21,387,District - Puri (18),Rural,20-24,135100,67595,67505,27032,369,181,5026,1580,3446,7929
21,387,District - Puri (18),Rural,Adolescent (10-19),268856,135914,132942,58677,844,480,5968,2576,3392,3587
21,387,District - Puri (18),Rural,Youth (15-24),265253,132806,132447,54776,747,387,8153,2820,5333,11265
21,387,District - Puri (18),Urban,All Ages,264930,137167,127763,28252,1750,989,55193,24160,31033,2111
21,387,District - Puri (18),Urban,10-14,22712,11811,10901,2998,536,340,1195,594,601,10
21,387,District - Puri (18),Urban,15-19,24143,12805,11338,2969,193,117,1570,830,740,84
21,387,District - Puri (18),Urban,20-24,27287,13748,13539,2885,106,68,2185,796,1389,155
21,387,District - Puri (18),Urban,Adolescent (10-19),46855,24616,22239,5967,729,457,2765,1424,1341,94
21,387,District - Puri (18),Urban,Youth (15-24),51430,26553,24877,5854,299,185,3755,1626,2129,239
21,388,District - Ganjam (19),Total,All Ages,3529031,1779218,1749813,688235,118928,59172,1318981,516566,802415,185015
21,388,District - Ganjam (19),Total,10-14,387949,194554,193395,82126,14877,7487,26793,11509,15284,2140
21,388,District - Ganjam (19),Total,15-19,352040,176966,175074,70589,10877,5474,41503,14424,27079,13700
21,388,District - Ganjam (19),Total,20-24,319599,162910,156689,61739,9480,4653,54500,17070,37430,20517
21,388,District - Ganjam (19),Total,Adolescent (10-19),739989,371520,368469,152715,25754,12961,68296,25933,42363,15840
21,388,District - Ganjam (19),Total,Youth (15-24),671639,339876,331763,132328,20357,10127,96003,31494,64509,34217
21,388,District - Ganjam (19),Rural,All Ages,2761030,1383636,1377394,566923,112338,55701,1125880,437924,687956,176281
21,388,District - Ganjam (19),Rural,10-14,316517,158010,158507,68159,14101,7126,22645,9627,13018,2062
21,388,District - Ganjam (19),Rural,15-19,271075,134264,136811,56696,9941,4973,35569,12151,23418,13137
21,388,District - Ganjam (19),Rural,20-24,241508,122325,119183,49601,8700,4187,47232,14496,32736,19618
21,388,District - Ganjam (19),Rural,Adolescent (10-19),587592,292274,295318,124855,24042,12099,58214,21778,36436,15199
21,388,District - Ganjam (19),Rural,Youth (15-24),512583,256589,255994,106297,18641,9160,82801,26647,56154,32755
21,388,District - Ganjam (19),Urban,All Ages,768001,395582,372419,121312,6590,3471,193101,78642,114459,8734
21,388,District - Ganjam (19),Urban,10-14,71432,36544,34888,13967,776,361,4148,1882,2266,78
21,388,District - Ganjam (19),Urban,15-19,80965,42702,38263,13893,936,501,5934,2273,3661,563
21,388,District - Ganjam (19),Urban,20-24,78091,40585,37506,12138,780,466,7268,2574,4694,899
21,388,District - Ganjam (19),Urban,Adolescent (10-19),152397,79246,73151,27860,1712,862,10082,4155,5927,641
21,388,District - Ganjam (19),Urban,Youth (15-24),159056,83287,75769,26031,1716,967,13202,4847,8355,1462
21,389,District - Gajapati (20),Total,All Ages,577817,282882,294935,39175,313714,151902,315280,129219,186061,68824
21,389,District - Gajapati (20),Total,10-14,66754,33455,33299,4304,39530,19489,11344,4638,6706,1305
21,389,District - Gajapati (20),Total,15-19,54704,27152,27552,4043,29414,14300,13790,4607,9183,6052
21,389,District - Gajapati (20),Total,20-24,48534,22921,25613,3426,25265,11264,17843,5268,12575,8634
21,389,District - Gajapati (20),Total,Adolescent (10-19),121458,60607,60851,8347,68944,33789,25134,9245,15889,7357
21,389,District - Gajapati (20),Total,Youth (15-24),103238,50073,53165,7469,54679,25564,31633,9875,21758,14686
21,389,District - Gajapati (20),Rural,All Ages,507151,247655,259496,29535,308867,149507,293991,120721,173270,67167
21,389,District - Gajapati (20),Rural,10-14,59359,29705,29654,3218,38213,18911,10883,4412,6471,1287
21,389,District - Gajapati (20),Rural,15-19,47662,23546,24116,2985,28724,13906,13134,4325,8809,5946
21,389,District - Gajapati (20),Rural,20-24,41989,19682,22307,2472,24891,11091,16891,4912,11979,8473
21,389,District - Gajapati (20),Rural,Adolescent (10-19),107021,53251,53770,6203,66937,32817,24017,8737,15280,7233
21,389,District - Gajapati (20),Rural,Youth (15-24),89651,43228,46423,5457,53615,24997,30025,9237,20788,14419
21,389,District - Gajapati (20),Urban,All Ages,70666,35227,35439,9640,4847,2395,21289,8498,12791,1657
21,389,District - Gajapati (20),Urban,10-14,7395,3750,3645,1086,1317,578,461,226,235,18
21,389,District - Gajapati (20),Urban,15-19,7042,3606,3436,1058,690,394,656,282,374,106
21,389,District - Gajapati (20),Urban,20-24,6545,3239,3306,954,374,173,952,356,596,161
21,389,District - Gajapati (20),Urban,Adolescent (10-19),14437,7356,7081,2144,2007,972,1117,508,609,124
21,389,District - Gajapati (20),Urban,Youth (15-24),13587,6845,6742,2012,1064,567,1608,638,970,267
21,390,District - Kandhamal (21),Total,All Ages,733110,359945,373165,115544,392820,190506,333324,126045,207279,42795
21,390,District - Kandhamal (21),Total,10-14,86398,43231,43167,13234,48696,24021,7998,3154,4844,422
21,390,District - Kandhamal (21),Total,15-19,64450,30918,33532,10418,34016,15970,10454,2798,7656,2531
21,390,District - Kandhamal (21),Total,20-24,62252,28684,33568,10322,32264,14532,14508,3246,11262,4886
21,390,District - Kandhamal (21),Total,Adolescent (10-19),150848,74149,76699,23652,82712,39991,18452,5952,12500,2953
21,390,District - Kandhamal (21),Total,Youth (15-24),126702,59602,67100,20740,66280,30502,24962,6044,18918,7417
21,390,District - Kandhamal (21),Rural,All Ages,660831,323523,337308,100569,380602,184742,316938,119726,197212,41772
21,390,District - Kandhamal (21),Rural,10-14,78288,39431,38857,11520,46672,23241,7821,3076,4745,417
21,390,District - Kandhamal (21),Rural,15-19,57584,27533,30051,8908,32753,15396,10198,2717,7481,2460
21,390,District - Kandhamal (21),Rural,20-24,55378,25268,30110,8821,31103,13950,14102,3153,10949,4758
21,390,District - Kandhamal (21),Rural,Adolescent (10-19),135872,66964,68908,20428,79425,38637,18019,5793,12226,2877
21,390,District - Kandhamal (21),Rural,Youth (15-24),112962,52801,60161,17729,63856,29346,24300,5870,18430,7218
21,390,District - Kandhamal (21),Urban,All Ages,72279,36422,35857,14975,12218,5764,16386,6319,10067,1023
21,390,District - Kandhamal (21),Urban,10-14,8110,3800,4310,1714,2024,780,177,78,99,5
21,390,District - Kandhamal (21),Urban,15-19,6866,3385,3481,1510,1263,574,256,81,175,71
21,390,District - Kandhamal (21),Urban,20-24,6874,3416,3458,1501,1161,582,406,93,313,128
21,390,District - Kandhamal (21),Urban,Adolescent (10-19),14976,7185,7791,3224,3287,1354,433,159,274,76
21,390,District - Kandhamal (21),Urban,Youth (15-24),13740,6801,6939,3011,2424,1156,662,174,488,199
21,391,District - Baudh (22),Total,All Ages,441162,221625,219537,104934,55364,27362,169550,62977,106573,35244
21,391,District - Baudh (22),Total,10-14,52321,26470,25851,12696,6857,3422,2017,900,1117,374
21,391,District - Baudh (22),Total,15-19,40536,20188,20348,9667,4416,2241,3438,1035,2403,2556
21,391,District - Baudh (22),Total,20-24,36141,17655,18486,8310,4120,2010,5572,1323,4249,3981
21,391,District - Baudh (22),Total,Adolescent (10-19),92857,46658,46199,22363,11273,5663,5455,1935,3520,2930
21,391,District - Baudh (22),Total,Youth (15-24),76677,37843,38834,17977,8536,4251,9010,2358,6652,6537
21,391,District - Baudh (22),Rural,All Ages,420738,211133,209605,99438,54867,27092,165022,61269,103753,35109
21,391,District - Baudh (22),Rural,10-14,50174,25362,24812,12025,6794,3390,1959,869,1090,373
21,391,District - Baudh (22),Rural,15-19,38524,19192,19332,9063,4358,2213,3377,1013,2364,2547
21,391,District - Baudh (22),Rural,20-24,34315,16754,17561,7828,4087,1992,5462,1300,4162,3977
21,391,District - Baudh (22),Rural,Adolescent (10-19),88698,44554,44144,21088,11152,5603,5336,1882,3454,2920
21,391,District - Baudh (22),Rural,Youth (15-24),72839,35946,36893,16891,8445,4205,8839,2313,6526,6524
21,391,District - Baudh (22),Urban,All Ages,20424,10492,9932,5496,497,270,4528,1708,2820,135
21,391,District - Baudh (22),Urban,10-14,2147,1108,1039,671,63,32,58,31,27,1
21,391,District - Baudh (22),Urban,15-19,2012,996,1016,604,58,28,61,22,39,9
21,391,District - Baudh (22),Urban,20-24,1826,901,925,482,33,18,110,23,87,4
21,391,District - Baudh (22),Urban,Adolescent (10-19),4159,2104,2055,1275,121,60,119,53,66,10
21,391,District - Baudh (22),Urban,Youth (15-24),3838,1897,1941,1086,91,46,171,45,126,13
21,392,District - Subarnapur (23),Total,All Ages,610183,311312,298871,156219,57192,28794,211762,80919,130843,53939
21,392,District - Subarnapur (23),Total,10-14,62944,31484,31460,16991,6387,3098,2330,1089,1241,364
21,392,District - Subarnapur (23),Total,15-19,64631,32321,32310,16699,6213,3087,3939,1337,2602,3681
21,392,District - Subarnapur (23),Total,20-24,56706,29379,27327,14053,5152,2727,5719,1624,4095,6346
21,392,District - Subarnapur (23),Total,Adolescent (10-19),127575,63805,63770,33690,12600,6185,6269,2426,3843,4045
21,392,District - Subarnapur (23),Total,Youth (15-24),121337,61700,59637,30752,11365,5814,9658,2961,6697,10027
21,392,District - Subarnapur (23),Rural,All Ages,560242,285634,274608,143381,55256,27795,198744,75968,122776,52787
21,392,District - Subarnapur (23),Rural,10-14,58288,29116,29172,15693,6135,2973,2175,1010,1165,363
21,392,District - Subarnapur (23),Rural,15-19,59543,29709,29834,15268,5976,2962,3663,1240,2423,3641
21,392,District - Subarnapur (23),Rural,20-24,51888,26877,25011,12820,4987,2634,5393,1518,3875,6229
21,392,District - Subarnapur (23),Rural,Adolescent (10-19),117831,58825,59006,30961,12111,5935,5838,2250,3588,4004
21,392,District - Subarnapur (23),Rural,Youth (15-24),111431,56586,54845,28088,10963,5596,9056,2758,6298,9870
21,392,District - Subarnapur (23),Urban,All Ages,49941,25678,24263,12838,1936,999,13018,4951,8067,1152
21,392,District - Subarnapur (23),Urban,10-14,4656,2368,2288,1298,252,125,155,79,76,1
21,392,District - Subarnapur (23),Urban,15-19,5088,2612,2476,1431,237,125,276,97,179,40
21,392,District - Subarnapur (23),Urban,20-24,4818,2502,2316,1233,165,93,326,106,220,117
21,392,District - Subarnapur (23),Urban,Adolescent (10-19),9744,4980,4764,2729,489,250,431,176,255,41
21,392,District - Subarnapur (23),Urban,Youth (15-24),9906,5114,4792,2664,402,218,602,203,399,157
21,393,District - Balangir (24),Total,All Ages,1648997,830097,818900,294777,347164,172489,721737,284425,437312,107920
21,393,District - Balangir (24),Total,10-14,168234,84574,83660,31729,37543,18788,14630,6038,8592,955
21,393,District - Balangir (24),Total,15-19,157508,79033,78475,29416,33195,16460,22084,7357,14727,6991
21,393,District - Balangir (24),Total,20-24,139994,70971,69023,25457,27584,14029,27922,8414,19508,11086
21,393,District - Balangir (24),Total,Adolescent (10-19),325742,163607,162135,61145,70738,35248,36714,13395,23319,7946
21,393,District - Balangir (24),Total,Youth (15-24),297502,150004,147498,54873,60779,30489,50006,15771,34235,18077
21,393,District - Balangir (24),Rural,All Ages,1451616,728770,722846,263126,334672,166214,670959,263888,407071,106564
21,393,District - Balangir (24),Rural,10-14,150381,75392,74989,28644,36259,18138,13806,5665,8141,945
21,393,District - Balangir (24),Rural,15-19,138981,69582,69399,26106,31883,15837,20964,6937,14027,6923
21,393,District - Balangir (24),Rural,20-24,121325,61585,59740,22154,26441,13443,26358,7856,18502,10959
21,393,District - Balangir (24),Rural,Adolescent (10-19),289362,144974,144388,54750,68142,33975,34770,12602,22168,7868
21,393,District - Balangir (24),Rural,Youth (15-24),260306,131167,129139,48260,58324,29280,47322,14793,32529,17882
21,393,District - Balangir (24),Urban,All Ages,197381,101327,96054,31651,12492,6275,50778,20537,30241,1356
21,393,District - Balangir (24),Urban,10-14,17853,9182,8671,3085,1284,650,824,373,451,10
21,393,District - Balangir (24),Urban,15-19,18527,9451,9076,3310,1312,623,1120,420,700,68
21,393,District - Balangir (24),Urban,20-24,18669,9386,9283,3303,1143,586,1564,558,1006,127
21,393,District - Balangir (24),Urban,Adolescent (10-19),36380,18633,17747,6395,2596,1273,1944,793,1151,78
21,393,District - Balangir (24),Urban,Youth (15-24),37196,18837,18359,6613,2455,1209,2684,978,1706,195
21,394,District - Nuapada (25),Total,All Ages,610382,301962,308420,82159,206327,100469,310999,121059,189940,37130
21,394,District - Nuapada (25),Total,10-14,68215,34270,33945,9317,24720,12289,6961,2705,4256,452
21,394,District - Nuapada (25),Total,15-19,53796,26652,27144,7915,17782,8629,10239,2930,7309,2677
21,394,District - Nuapada (25),Total,20-24,48760,23638,25122,6760,15684,7396,14384,3755,10629,4205
21,394,District - Nuapada (25),Total,Adolescent (10-19),122011,60922,61089,17232,42502,20918,17200,5635,11565,3129
21,394,District - Nuapada (25),Total,Youth (15-24),102556,50290,52266,14675,33466,16025,24623,6685,17938,6882
21,394,District - Nuapada (25),Rural,All Ages,576328,284792,291536,75346,204121,99371,300464,116855,183609,36791
21,394,District - Nuapada (25),Rural,10-14,64948,32585,32363,8595,24454,12153,6767,2615,4152,449
21,394,District - Nuapada (25),Rural,15-19,50495,24980,25515,7176,17562,8502,9960,2820,7140,2644
21,394,District - Nuapada (25),Rural,20-24,45521,22003,23518,6072,15516,7310,14030,3630,10400,4174
21,394,District - Nuapada (25),Rural,Adolescent (10-19),115443,57565,57878,15771,42016,20655,16727,5435,11292,3093
21,394,District - Nuapada (25),Rural,Youth (15-24),96016,46983,49033,13248,33078,15812,23990,6450,17540,6818
21,394,District - Nuapada (25),Urban,All Ages,34054,17170,16884,6813,2206,1098,10535,4204,6331,339
21,394,District - Nuapada (25),Urban,10-14,3267,1685,1582,722,266,136,194,90,104,3
21,394,District - Nuapada (25),Urban,15-19,3301,1672,1629,739,220,127,279,110,169,33
21,394,District - Nuapada (25),Urban,20-24,3239,1635,1604,688,168,86,354,125,229,31
21,394,District - Nuapada (25),Urban,Adolescent (10-19),6568,3357,3211,1461,486,263,473,200,273,36
21,394,District - Nuapada (25),Urban,Youth (15-24),6540,3307,3233,1427,388,213,633,235,398,64
21,395,District - Kalahandi (26),Total,All Ages,1576869,787101,789768,286580,449456,221171,774833,302924,471909,143873
21,395,District - Kalahandi (26),Total,10-14,175070,88148,86922,34447,52396,26413,21611,8059,13552,1602
21,395,District - Kalahandi (26),Total,15-19,137442,68805,68637,27590,38307,18738,25767,7748,18019,8402
21,395,District - Kalahandi (26),Total,20-24,123931,60492,63439,23654,33141,15884,33112,8609,24503,13808
21,395,District - Kalahandi (26),Total,Adolescent (10-19),312512,156953,155559,62037,90703,45151,47378,15807,31571,10004
21,395,District - Kalahandi (26),Total,Youth (15-24),261373,129297,132076,51244,71448,34622,58879,16357,42522,22210
21,395,District - Kalahandi (26),Rural,All Ages,1454882,724646,730236,264974,440775,216883,741120,289316,451804,142016
21,395,District - Kalahandi (26),Rural,10-14,162597,81845,80752,31948,51116,25852,21041,7794,13247,1590
21,395,District - Kalahandi (26),Rural,15-19,125650,62836,62814,25276,37397,18280,25059,7486,17573,8291
21,395,District - Kalahandi (26),Rural,20-24,112850,54929,57921,21540,32457,15521,32092,8283,23809,13646
21,395,District - Kalahandi (26),Rural,Adolescent (10-19),288247,144681,143566,57224,88513,44132,46100,15280,30820,9881
21,395,District - Kalahandi (26),Rural,Youth (15-24),238500,117765,120735,46816,69854,33801,57151,15769,41382,21937
21,395,District - Kalahandi (26),Urban,All Ages,121987,62455,59532,21606,8681,4288,33713,13608,20105,1857
21,395,District - Kalahandi (26),Urban,10-14,12473,6303,6170,2499,1280,561,570,265,305,12
21,395,District - Kalahandi (26),Urban,15-19,11792,5969,5823,2314,910,458,708,262,446,111
21,395,District - Kalahandi (26),Urban,20-24,11081,5563,5518,2114,684,363,1020,326,694,162
21,395,District - Kalahandi (26),Urban,Adolescent (10-19),24265,12272,11993,4813,2190,1019,1278,527,751,123
21,395,District - Kalahandi (26),Urban,Youth (15-24),22873,11532,11341,4428,1594,821,1728,588,1140,273
21,396,District - Rayagada (27),Total,All Ages,967911,471960,495951,139514,541905,259040,560176,230001,330175,67059
21,396,District - Rayagada (27),Total,10-14,108545,54800,53745,16834,63713,31974,23530,9703,13827,1244
21,396,District - Rayagada (27),Total,15-19,86596,42140,44456,14065,47178,22358,28446,9465,18981,5889
21,396,District - Rayagada (27),Total,20-24,80515,37629,42886,12409,42247,19031,34845,10557,24288,8327
21,396,District - Rayagada (27),Total,Adolescent (10-19),195141,96940,98201,30899,110891,54332,51976,19168,32808,7133
21,396,District - Rayagada (27),Total,Youth (15-24),167111,79769,87342,26474,89425,41389,63291,20022,43269,14216
21,396,District - Rayagada (27),Rural,All Ages,820945,397774,423171,116657,522208,249459,515187,212144,303043,65487
21,396,District - Rayagada (27),Rural,10-14,94377,47503,46874,14273,61145,30689,22515,9248,13267,1210
21,396,District - Rayagada (27),Rural,15-19,72467,34947,37520,11599,44936,21203,27025,8919,18106,5760
21,396,District - Rayagada (27),Rural,20-24,66113,30536,35577,9984,40395,18115,32674,9839,22835,8152
21,396,District - Rayagada (27),Rural,Adolescent (10-19),166844,82450,84394,25872,106081,51892,49540,18167,31373,6970
21,396,District - Rayagada (27),Rural,Youth (15-24),138580,65483,73097,21583,85331,39318,59699,18758,40941,13912
21,396,District - Rayagada (27),Urban,All Ages,146966,74186,72780,22857,19697,9581,44989,17857,27132,1572
21,396,District - Rayagada (27),Urban,10-14,14168,7297,6871,2561,2568,1285,1015,455,560,34
21,396,District - Rayagada (27),Urban,15-19,14129,7193,6936,2466,2242,1155,1421,546,875,129
21,396,District - Rayagada (27),Urban,20-24,14402,7093,7309,2425,1852,916,2171,718,1453,175
21,396,District - Rayagada (27),Urban,Adolescent (10-19),28297,14490,13807,5027,4810,2440,2436,1001,1435,163
21,396,District - Rayagada (27),Urban,Youth (15-24),28531,14286,14245,4891,4094,2071,3592,1264,2328,304
21,397,District - Nabarangapur (28),Total,All Ages,1220946,604812,616134,177384,681173,335028,750567,317828,432739,72307
21,397,District - Nabarangapur (28),Total,10-14,142497,71710,70787,20923,81933,40954,31924,13940,17984,1540
21,397,District - Nabarangapur (28),Total,15-19,105291,52077,53214,16344,57409,27832,37597,12967,24630,6584
21,397,District - Nabarangapur (28),Total,20-24,97925,45842,52083,15144,52652,24144,47766,14788,32978,9323
21,397,District - Nabarangapur (28),Total,Adolescent (10-19),247788,123787,124001,37267,139342,68786,69521,26907,42614,8124
21,397,District - Nabarangapur (28),Total,Youth (15-24),203216,97919,105297,31488,110061,51976,85363,27755,57608,15907
21,397,District - Nabarangapur (28),Rural,All Ages,1133321,560771,572550,157676,668056,328693,722786,306550,416236,70737
21,397,District - Nabarangapur (28),Rural,10-14,132568,66779,65789,18559,80032,40075,31330,13665,17665,1518
21,397,District - Nabarangapur (28),Rural,15-19,96844,47759,49085,14265,56109,27180,36748,12639,24109,6417
21,397,District - Nabarangapur (28),Rural,20-24,89837,41820,48017,13292,51559,23619,46513,14409,32104,9122
21,397,District - Nabarangapur (28),Rural,Adolescent (10-19),229412,114538,114874,32824,136141,67255,68078,26304,41774,7935
21,397,District - Nabarangapur (28),Rural,Youth (15-24),186681,89579,97102,27557,107668,50799,83261,27048,56213,15539
21,397,District - Nabarangapur (28),Urban,All Ages,87625,44041,43584,19708,13117,6335,27781,11278,16503,1570
21,397,District - Nabarangapur (28),Urban,10-14,9929,4931,4998,2364,1901,879,594,275,319,22
21,397,District - Nabarangapur (28),Urban,15-19,8447,4318,4129,2079,1300,652,849,328,521,167
21,397,District - Nabarangapur (28),Urban,20-24,8088,4022,4066,1852,1093,525,1253,379,874,201
21,397,District - Nabarangapur (28),Urban,Adolescent (10-19),18376,9249,9127,4443,3201,1531,1443,603,840,189
21,397,District - Nabarangapur (28),Urban,Youth (15-24),16535,8340,8195,3931,2393,1177,2102,707,1395,368
21,398,District - Koraput (29),Total,All Ages,1379647,678809,700838,196540,697583,337373,811557,337966,473591,89164
21,398,District - Koraput (29),Total,10-14,149501,75119,74382,22451,78502,39086,30843,12666,18177,2389
21,398,District - Koraput (29),Total,15-19,117147,56680,60467,18434,56397,26382,39987,12535,27452,8627
21,398,District - Koraput (29),Total,20-24,113428,53033,60395,17191,54376,24770,51987,15275,36712,11604
21,398,District - Koraput (29),Total,Adolescent (10-19),266648,131799,134849,40885,134899,65468,70830,25201,45629,11016
21,398,District - Koraput (29),Total,Youth (15-24),230575,109713,120862,35625,110773,51152,91974,27810,64164,20231
21,398,District - Koraput (29),Rural,All Ages,1153478,563771,589707,160697,662719,320130,749053,312845,436208,88003
21,398,District - Koraput (29),Rural,10-14,127279,63832,63447,18384,74257,37008,29511,12122,17389,2371
21,398,District - Koraput (29),Rural,15-19,95524,45770,49754,14607,52742,24600,37949,11874,26075,8532
21,398,District - Koraput (29),Rural,20-24,92102,42559,49543,13522,50811,22999,48932,14399,34533,11475
21,398,District - Koraput (29),Rural,Adolescent (10-19),222803,109602,113201,32991,126999,61608,67460,23996,43464,10903
21,398,District - Koraput (29),Rural,Youth (15-24),187626,88329,99297,28129,103553,47599,86881,26273,60608,20007
21,398,District - Koraput (29),Urban,All Ages,226169,115038,111131,35843,34864,17243,62504,25121,37383,1161
21,398,District - Koraput (29),Urban,10-14,22222,11287,10935,4067,4245,2078,1332,544,788,18
21,398,District - Koraput (29),Urban,15-19,21623,10910,10713,3827,3655,1782,2038,661,1377,95
21,398,District - Koraput (29),Urban,20-24,21326,10474,10852,3669,3565,1771,3055,876,2179,129
21,398,District - Koraput (29),Urban,Adolescent (10-19),43845,22197,21648,7894,7900,3860,3370,1205,2165,113
21,398,District - Koraput (29),Urban,Youth (15-24),42949,21384,21565,7496,7220,3553,5093,1537,3556,224
21,399,District - Malkangiri (30),Total,All Ages,613192,303624,309568,138295,354614,171717,368486,156623,211863,23913
21,399,District - Malkangiri (30),Total,10-14,69745,35419,34326,16330,40727,20691,14272,6050,8222,560
21,399,District - Malkangiri (30),Total,15-19,51411,24564,26847,12981,28222,12674,18538,6280,12258,2650
21,399,District - Malkangiri (30),Total,20-24,50434,23686,26748,12590,27616,12220,23829,7774,16055,3588
21,399,District - Malkangiri (30),Total,Adolescent (10-19),121156,59983,61173,29311,68949,33365,32810,12330,20480,3210
21,399,District - Malkangiri (30),Total,Youth (15-24),101845,48250,53595,25571,55838,24894,42367,14054,28313,6238
21,399,District - Malkangiri (30),Rural,All Ages,563664,277901,285763,122797,346465,167644,350783,149428,201355,23010
21,399,District - Malkangiri (30),Rural,10-14,64307,32681,31626,14529,39536,20100,13788,5849,7939,534
21,399,District - Malkangiri (30),Rural,15-19,46988,22383,24605,11452,27464,12323,17836,6005,11831,2578
21,399,District - Malkangiri (30),Rural,20-24,45877,21481,24396,11101,26892,11861,22912,7493,15419,3498
21,399,District - Malkangiri (30),Rural,Adolescent (10-19),111295,55064,56231,25981,67000,32423,31624,11854,19770,3112
21,399,District - Malkangiri (30),Rural,Youth (15-24),92865,43864,49001,22553,54356,24184,40748,13498,27250,6076
21,399,District - Malkangiri (30),Urban,All Ages,49528,25723,23805,15498,8149,4073,17703,7195,10508,903
21,399,District - Malkangiri (30),Urban,10-14,5438,2738,2700,1801,1191,591,484,201,283,26
21,399,District - Malkangiri (30),Urban,15-19,4423,2181,2242,1529,758,351,702,275,427,72
21,399,District - Malkangiri (30),Urban,20-24,4557,2205,2352,1489,724,359,917,281,636,90
21,399,District - Malkangiri (30),Urban,Adolescent (10-19),9861,4919,4942,3330,1949,942,1186,476,710,98
21,399,District - Malkangiri (30),Urban,Youth (15-24),8980,4386,4594,3018,1482,710,1619,556,1063,162
22,0,State - CHHATTISGARH (22),Total,All Ages,25545198,12832895,12712303,3274269,7822902,3873191,10165276,4025002,6140274,2505999
22,0,State - CHHATTISGARH (22),Total,10-14,2884013,1461185,1422828,393050,915623,460551,191309,84962,106347,22064
22,0,State - CHHATTISGARH (22),Total,15-19,2599842,1319451,1280391,353657,779640,387807,253876,92070,161806,200494
22,0,State - CHHATTISGARH (22),Total,20-24,2389497,1193378,1196119,313222,705606,342437,372095,108881,263214,363047
22,0,State - CHHATTISGARH (22),Total,Adolescent (10-19),5483855,2780636,2703219,746707,1695263,848358,445185,177032,268153,222558
22,0,State - CHHATTISGARH (22),Total,Youth (15-24),4989339,2512829,2476510,666879,1485246,730244,625971,200951,425020,563541
22,0,State - CHHATTISGARH (22),Rural,All Ages,19607961,9797426,9810535,2511949,7231082,3577134,8599005,3394414,5204591,2392521
22,0,State - CHHATTISGARH (22),Rural,10-14,2289627,1155074,1134553,308905,845285,425428,168988,73876,95112,21211
22,0,State - CHHATTISGARH (22),Rural,15-19,1998051,1009334,988717,269632,710769,353522,225301,79961,145340,192229
22,0,State - CHHATTISGARH (22),Rural,20-24,1773929,885162,888767,231449,642070,311254,328126,94762,233364,348216
22,0,State - CHHATTISGARH (22),Rural,Adolescent (10-19),4287678,2164408,2123270,578537,1556054,778950,394289,153837,240452,213440
22,0,State - CHHATTISGARH (22),Rural,Youth (15-24),3771980,1894496,1877484,501081,1352839,664776,553427,174723,378704,540445
22,0,State - CHHATTISGARH (22),Urban,All Ages,5937237,3035469,2901768,762320,591820,296057,1566271,630588,935683,113478
22,0,State - CHHATTISGARH (22),Urban,10-14,594386,306111,288275,84145,70338,35123,22321,11086,11235,853
22,0,State - CHHATTISGARH (22),Urban,15-19,601791,310117,291674,84025,68871,34285,28575,12109,16466,8265
22,0,State - CHHATTISGARH (22),Urban,20-24,615568,308216,307352,81773,63536,31183,43969,14119,29850,14831
22,0,State - CHHATTISGARH (22),Urban,Adolescent (10-19),1196177,616228,579949,168170,139209,69408,50896,23195,27701,9118
22,0,State - CHHATTISGARH (22),Urban,Youth (15-24),1217359,618333,599026,165798,132407,65468,72544,26228,46316,23096
22,400,District - Koriya (01),Total,All Ages,658917,334737,324180,54776,304280,152659,261094,104814,156280,27213
22,400,District - Koriya (01),Total,10-14,73306,37245,36061,6330,35134,17612,3212,1468,1744,266
22,400,District - Koriya (01),Total,15-19,67899,34794,33105,5997,30139,15204,5185,1877,3308,2106
22,400,District - Koriya (01),Total,20-24,65971,33317,32654,6037,28835,14338,9717,2915,6802,4407
22,400,District - Koriya (01),Total,Adolescent (10-19),141205,72039,69166,12327,65273,32816,8397,3345,5052,2372
22,400,District - Koriya (01),Total,Youth (15-24),133870,68111,65759,12034,58974,29542,14902,4792,10110,6513
22,400,District - Koriya (01),Rural,All Ages,453618,228338,225280,31238,274059,137286,204462,82487,121975,26585
22,400,District - Koriya (01),Rural,10-14,51956,26127,25829,3726,31766,15890,2609,1198,1411,264
22,400,District - Koriya (01),Rural,15-19,44273,22464,21809,3062,26576,13315,4321,1509,2812,2081
22,400,District - Koriya (01),Rural,20-24,43170,21444,21726,3239,25589,12670,8207,2394,5813,4351
22,400,District - Koriya (01),Rural,Adolescent (10-19),96229,48591,47638,6788,58342,29205,6930,2707,4223,2345
22,400,District - Koriya (01),Rural,Youth (15-24),87443,43908,43535,6301,52165,25985,12528,3903,8625,6432
22,400,District - Koriya (01),Urban,All Ages,205299,106399,98900,23538,30221,15373,56632,22327,34305,628
22,400,District - Koriya (01),Urban,10-14,21350,11118,10232,2604,3368,1722,603,270,333,2
22,400,District - Koriya (01),Urban,15-19,23626,12330,11296,2935,3563,1889,864,368,496,25
22,400,District - Koriya (01),Urban,20-24,22801,11873,10928,2798,3246,1668,1510,521,989,56
22,400,District - Koriya (01),Urban,Adolescent (10-19),44976,23448,21528,5539,6931,3611,1467,638,829,27
22,400,District - Koriya (01),Urban,Youth (15-24),46427,24203,22224,5733,6809,3557,2374,889,1485,81
22,401,District - Surguja (02),Total,All Ages,2359886,1193129,1166757,115652,1300628,652799,1171945,498443,673502,168037
22,401,District - Surguja (02),Total,10-14,281136,143057,138079,13979,158355,80087,24854,11268,13586,1896
22,401,District - Surguja (02),Total,15-19,223980,114878,109102,10658,121873,61750,35817,13680,22137,12121
22,401,District - Surguja (02),Total,20-24,207910,101989,105921,10587,110587,53669,55062,17141,37921,24656
22,401,District - Surguja (02),Total,Adolescent (10-19),505116,257935,247181,24637,280228,141837,60671,24948,35723,14017
22,401,District - Surguja (02),Total,Youth (15-24),431890,216867,215023,21245,232460,115419,90879,30821,60058,36777
22,401,District - Surguja (02),Rural,All Ages,2116965,1067908,1049057,103230,1248135,626923,1108567,471621,636946,164969
22,401,District - Surguja (02),Rural,10-14,254423,129275,125148,12541,151577,76910,23984,10854,13130,1872
22,401,District - Surguja (02),Rural,15-19,198047,101635,96412,9318,115613,58729,34696,13160,21536,11922
22,401,District - Surguja (02),Rural,20-24,183067,89823,93244,9297,105057,51107,53296,16550,36746,24229
22,401,District - Surguja (02),Rural,Adolescent (10-19),452470,230910,221560,21859,267190,135639,58680,24014,34666,13794
22,401,District - Surguja (02),Rural,Youth (15-24),381114,191458,189656,18615,220670,109836,87992,29710,58282,36151
22,401,District - Surguja (02),Urban,All Ages,242921,125221,117700,12422,52493,25876,63378,26822,36556,3068
22,401,District - Surguja (02),Urban,10-14,26713,13782,12931,1438,6778,3177,870,414,456,24
22,401,District - Surguja (02),Urban,15-19,25933,13243,12690,1340,6260,3021,1121,520,601,199
22,401,District - Surguja (02),Urban,20-24,24843,12166,12677,1290,5530,2562,1766,591,1175,427
22,401,District - Surguja (02),Urban,Adolescent (10-19),52646,27025,25621,2778,13038,6198,1991,934,1057,223
22,401,District - Surguja (02),Urban,Youth (15-24),50776,25409,25367,2630,11790,5583,2887,1111,1776,626
22,402,District - Jashpur (03),Total,All Ages,851669,424747,426922,48844,530378,262731,356254,144091,212163,93151
22,402,District - Jashpur (03),Total,10-14,92491,46360,46131,5295,57997,28962,4091,1846,2245,1058
22,402,District - Jashpur (03),Total,15-19,81408,41550,39858,4722,50779,25785,6122,2401,3721,7371
22,402,District - Jashpur (03),Total,20-24,75792,37015,38777,4691,45745,22300,10154,2999,7155,13396
22,402,District - Jashpur (03),Total,Adolescent (10-19),173899,87910,85989,10017,108776,54747,10213,4247,5966,8429
22,402,District - Jashpur (03),Total,Youth (15-24),157200,78565,78635,9413,96524,48085,16276,5400,10876,20767
22,402,District - Jashpur (03),Rural,All Ages,775677,386307,389370,42138,501130,248560,335859,135690,200169,91073
22,402,District - Jashpur (03),Rural,10-14,83703,41771,41932,4498,54180,26963,3882,1751,2131,1044
22,402,District - Jashpur (03),Rural,15-19,72573,37077,35496,3922,46795,23861,5844,2267,3577,7250
22,402,District - Jashpur (03),Rural,20-24,67803,33299,34504,3988,42686,20987,9647,2834,6813,13107
22,402,District - Jashpur (03),Rural,Adolescent (10-19),156276,78848,77428,8420,100975,50824,9726,4018,5708,8294
22,402,District - Jashpur (03),Rural,Youth (15-24),140376,70376,70000,7910,89481,44848,15491,5101,10390,20357
22,402,District - Jashpur (03),Urban,All Ages,75992,38440,37552,6706,29248,14171,20395,8401,11994,2078
22,402,District - Jashpur (03),Urban,10-14,8788,4589,4199,797,3817,1999,209,95,114,14
22,402,District - Jashpur (03),Urban,15-19,8835,4473,4362,800,3984,1924,278,134,144,121
22,402,District - Jashpur (03),Urban,20-24,7989,3716,4273,703,3059,1313,507,165,342,289
22,402,District - Jashpur (03),Urban,Adolescent (10-19),17623,9062,8561,1597,7801,3923,487,229,258,135
22,402,District - Jashpur (03),Urban,Youth (15-24),16824,8189,8635,1503,7043,3237,785,299,486,410
22,403,District - Raigarh (04),Total,All Ages,1493984,750278,743706,224942,505609,250473,542345,207522,334823,181281
22,403,District - Raigarh (04),Total,10-14,157382,79909,77473,25191,56061,28031,5390,2353,3037,1070
22,403,District - Raigarh (04),Total,15-19,145101,73910,71191,23441,47997,24328,7874,2838,5036,12181
22,403,District - Raigarh (04),Total,20-24,137385,68385,69000,21407,43959,21662,13467,3728,9739,23377
22,403,District - Raigarh (04),Total,Adolescent (10-19),302483,153819,148664,48632,104058,52359,13264,5191,8073,13251
22,403,District - Raigarh (04),Total,Youth (15-24),282486,142295,140191,44848,91956,45990,21341,6566,14775,35558
22,403,District - Raigarh (04),Rural,All Ages,1247682,623817,623865,188059,475594,235465,479531,182486,297045,176621
22,403,District - Raigarh (04),Rural,10-14,133742,67620,66122,21252,52822,26382,4698,1996,2702,1050
22,403,District - Raigarh (04),Rural,15-19,121253,61536,59717,19587,44603,22629,6890,2406,4484,11870
22,403,District - Raigarh (04),Rural,20-24,111893,55681,56212,17488,40881,20163,11935,3254,8681,22816
22,403,District - Raigarh (04),Rural,Adolescent (10-19),254995,129156,125839,40839,97425,49011,11588,4402,7186,12920
22,403,District - Raigarh (04),Rural,Youth (15-24),233146,117217,115929,37075,85484,42792,18825,5660,13165,34686
22,403,District - Raigarh (04),Urban,All Ages,246302,126461,119841,36883,30015,15008,62814,25036,37778,4660
22,403,District - Raigarh (04),Urban,10-14,23640,12289,11351,3939,3239,1649,692,357,335,20
22,403,District - Raigarh (04),Urban,15-19,23848,12374,11474,3854,3394,1699,984,432,552,311
22,403,District - Raigarh (04),Urban,20-24,25492,12704,12788,3919,3078,1499,1532,474,1058,561
22,403,District - Raigarh (04),Urban,Adolescent (10-19),47488,24663,22825,7793,6633,3348,1676,789,887,331
22,403,District - Raigarh (04),Urban,Youth (15-24),49340,25078,24262,7773,6472,3198,2516,906,1610,872
22,404,District - Korba (05),Total,All Ages,1206640,612915,593725,124679,493559,246323,457881,179524,278357,94589
22,404,District - Korba (05),Total,10-14,134493,68022,66471,14132,58027,28859,7266,3419,3847,826
22,404,District - Korba (05),Total,15-19,124859,64306,60553,13408,50839,26151,10154,3937,6217,7312
22,404,District - Korba (05),Total,20-24,121363,61440,59923,13511,46579,23148,16532,4836,11696,13798
22,404,District - Korba (05),Total,Adolescent (10-19),259352,132328,127024,27540,108866,55010,17420,7356,10064,8138
22,404,District - Korba (05),Total,Youth (15-24),246222,125746,120476,26919,97418,49299,26686,8773,17913,21110
22,404,District - Korba (05),Rural,All Ages,760350,381424,378926,67843,434129,216320,337600,131560,206040,90911
22,404,District - Korba (05),Rural,10-14,88821,44480,44341,8002,51210,25492,5611,2579,3032,808
22,404,District - Korba (05),Rural,15-19,78011,40135,37876,7049,43742,22552,8215,3116,5099,7087
22,404,District - Korba (05),Rural,20-24,71666,36215,35451,6742,39849,19828,13130,3726,9404,13275
22,404,District - Korba (05),Rural,Adolescent (10-19),166832,84615,82217,15051,94952,48044,13826,5695,8131,7895
22,404,District - Korba (05),Rural,Youth (15-24),149677,76350,73327,13791,83591,42380,21345,6842,14503,20362
22,404,District - Korba (05),Urban,All Ages,446290,231491,214799,56836,59430,30003,120281,47964,72317,3678
22,404,District - Korba (05),Urban,10-14,45672,23542,22130,6130,6817,3367,1655,840,815,18
22,404,District - Korba (05),Urban,15-19,46848,24171,22677,6359,7097,3599,1939,821,1118,225
22,404,District - Korba (05),Urban,20-24,49697,25225,24472,6769,6730,3320,3402,1110,2292,523
22,404,District - Korba (05),Urban,Adolescent (10-19),92520,47713,44807,12489,13914,6966,3594,1661,1933,243
22,404,District - Korba (05),Urban,Youth (15-24),96545,49396,47149,13128,13827,6919,5341,1931,3410,748
22,405,District - Janjgir - Champa (06),Total,All Ages,1619707,815717,803990,397908,187196,93186,600073,222038,378035,153721
22,405,District - Janjgir - Champa (06),Total,10-14,189918,95929,93989,50185,22329,11145,7550,3400,4150,1565
22,405,District - Janjgir - Champa (06),Total,15-19,182341,92099,90242,46513,21356,10747,11440,3917,7523,12135
22,405,District - Janjgir - Champa (06),Total,20-24,150923,78498,72425,37176,16847,8666,16434,4385,12049,21136
22,405,District - Janjgir - Champa (06),Total,Adolescent (10-19),372259,188028,184231,96698,43685,21892,18990,7317,11673,13700
22,405,District - Janjgir - Champa (06),Total,Youth (15-24),333264,170597,162667,83689,38203,19413,27874,8302,19572,33271
22,405,District - Janjgir - Champa (06),Rural,All Ages,1394646,701401,693245,357632,174887,87008,535246,197657,337589,143970
22,405,District - Janjgir - Champa (06),Rural,10-14,166660,83950,82710,45280,20888,10420,6719,2994,3725,1438
22,405,District - Janjgir - Champa (06),Rural,15-19,158466,79961,78505,41846,19925,10006,10312,3471,6841,11382
22,405,District - Janjgir - Champa (06),Rural,20-24,128475,67211,61264,33278,15716,8101,14731,3903,10828,19852
22,405,District - Janjgir - Champa (06),Rural,Adolescent (10-19),325126,163911,161215,87126,40813,20426,17031,6465,10566,12820
22,405,District - Janjgir - Champa (06),Rural,Youth (15-24),286941,147172,139769,75124,35641,18107,25043,7374,17669,31234
22,405,District - Janjgir - Champa (06),Urban,All Ages,225061,114316,110745,40276,12309,6178,64827,24381,40446,9751
22,405,District - Janjgir - Champa (06),Urban,10-14,23258,11979,11279,4905,1441,725,831,406,425,127
22,405,District - Janjgir - Champa (06),Urban,15-19,23875,12138,11737,4667,1431,741,1128,446,682,753
22,405,District - Janjgir - Champa (06),Urban,20-24,22448,11287,11161,3898,1131,565,1703,482,1221,1284
22,405,District - Janjgir - Champa (06),Urban,Adolescent (10-19),47133,24117,23016,9572,2872,1466,1959,852,1107,880
22,405,District - Janjgir - Champa (06),Urban,Youth (15-24),46323,23425,22898,8565,2562,1306,2831,928,1903,2037
22,406,District - Bilaspur (07),Total,All Ages,2663629,1351574,1312055,552992,498469,248172,1067069,419100,647969,311256
22,406,District - Bilaspur (07),Total,10-14,310771,158607,152164,70097,59032,29790,22208,9274,12934,2948
22,406,District - Bilaspur (07),Total,15-19,271760,141737,130023,59361,50717,25635,27971,9637,18334,23269
22,406,District - Bilaspur (07),Total,20-24,240967,122943,118024,50274,44106,21871,39104,10552,28552,43987
22,406,District - Bilaspur (07),Total,Adolescent (10-19),582531,300344,282187,129458,109749,55425,50179,18911,31268,26217
22,406,District - Bilaspur (07),Total,Youth (15-24),512727,264680,248047,109635,94823,47506,67075,20189,46886,67256
22,406,District - Bilaspur (07),Rural,All Ages,1983759,1002520,981239,456247,453120,225348,888272,346255,542017,298088
22,406,District - Bilaspur (07),Rural,10-14,243318,123478,119840,58927,53627,26995,19062,7776,11286,2867
22,406,District - Bilaspur (07),Rural,15-19,204954,106987,97967,48694,45533,22991,24287,8092,16195,22281
22,406,District - Bilaspur (07),Rural,20-24,173767,89255,84512,40249,39645,19676,33675,8938,24737,42283
22,406,District - Bilaspur (07),Rural,Adolescent (10-19),448272,230465,217807,107621,99160,49986,43349,15868,27481,25148
22,406,District - Bilaspur (07),Rural,Youth (15-24),378721,196242,182479,88943,85178,42667,57962,17030,40932,64564
22,406,District - Bilaspur (07),Urban,All Ages,679870,349054,330816,96745,45349,22824,178797,72845,105952,13168
22,406,District - Bilaspur (07),Urban,10-14,67453,35129,32324,11170,5405,2795,3146,1498,1648,81
22,406,District - Bilaspur (07),Urban,15-19,66806,34750,32056,10667,5184,2644,3684,1545,2139,988
22,406,District - Bilaspur (07),Urban,20-24,67200,33688,33512,10025,4461,2195,5429,1614,3815,1704
22,406,District - Bilaspur (07),Urban,Adolescent (10-19),134259,69879,64380,21837,10589,5439,6830,3043,3787,1069
22,406,District - Bilaspur (07),Urban,Youth (15-24),134006,68438,65568,20692,9645,4839,9113,3159,5954,2692
22,407,District - Kabeerdham (08),Total,All Ages,822526,412058,410468,119798,167043,82597,408359,163555,244804,120669
22,407,District - Kabeerdham (08),Total,10-14,97035,49043,47992,14532,20538,10409,8436,3466,4970,1238
22,407,District - Kabeerdham (08),Total,15-19,78198,40204,37994,11890,16323,8060,12066,3785,8281,10066
22,407,District - Kabeerdham (08),Total,20-24,74609,37283,37326,11186,15345,7459,19417,5058,14359,19708
22,407,District - Kabeerdham (08),Total,Adolescent (10-19),175233,89247,85986,26422,36861,18469,20502,7251,13251,11304
22,407,District - Kabeerdham (08),Total,Youth (15-24),152807,77487,75320,23076,31668,15519,31483,8843,22640,29774
22,407,District - Kabeerdham (08),Rural,All Ages,735131,367941,367190,104474,159983,79123,377830,150955,226875,116642
22,407,District - Kabeerdham (08),Rural,10-14,87344,44216,43128,12648,19502,9923,7712,3104,4608,1202
22,407,District - Kabeerdham (08),Rural,15-19,69357,35664,33693,10274,15481,7641,11248,3432,7816,9799
22,407,District - Kabeerdham (08),Rural,20-24,66012,33064,32948,9699,14665,7143,18242,4695,13547,19167
22,407,District - Kabeerdham (08),Rural,Adolescent (10-19),156701,79880,76821,22922,34983,17564,18960,6536,12424,11001
22,407,District - Kabeerdham (08),Rural,Youth (15-24),135369,68728,66641,19973,30146,14784,29490,8127,21363,28966
22,407,District - Kabeerdham (08),Urban,All Ages,87395,44117,43278,15324,7060,3474,30529,12600,17929,4027
22,407,District - Kabeerdham (08),Urban,10-14,9691,4827,4864,1884,1036,486,724,362,362,36
22,407,District - Kabeerdham (08),Urban,15-19,8841,4540,4301,1616,842,419,818,353,465,267
22,407,District - Kabeerdham (08),Urban,20-24,8597,4219,4378,1487,680,316,1175,363,812,541
22,407,District - Kabeerdham (08),Urban,Adolescent (10-19),18532,9367,9165,3500,1878,905,1542,715,827,303
22,407,District - Kabeerdham (08),Urban,Youth (15-24),17438,8759,8679,3103,1522,735,1993,716,1277,808
22,408,District - Rajnandgaon (09),Total,All Ages,1537133,762855,774278,156623,405194,198032,528754,201500,327254,165948
22,408,District - Rajnandgaon (09),Total,10-14,173245,86518,86727,17571,47484,23475,5707,2717,2990,1377
22,408,District - Rajnandgaon (09),Total,15-19,155473,76624,78849,15990,41207,19883,6802,2656,4146,15906
22,408,District - Rajnandgaon (09),Total,20-24,144827,72579,72248,15001,37433,18378,10756,3395,7361,26478
22,408,District - Rajnandgaon (09),Total,Adolescent (10-19),328718,163142,165576,33561,88691,43358,12509,5373,7136,17283
22,408,District - Rajnandgaon (09),Total,Youth (15-24),300300,149203,151097,30991,78640,38261,17558,6051,11507,42384
22,408,District - Rajnandgaon (09),Rural,All Ages,1264621,626212,638409,118079,385785,188600,461695,174988,286707,158411
22,408,District - Rajnandgaon (09),Rural,10-14,147274,73374,73900,13748,45164,22376,4829,2254,2575,1325
22,408,District - Rajnandgaon (09),Rural,15-19,128515,62932,65583,11966,38915,18815,5810,2178,3632,15290
22,408,District - Rajnandgaon (09),Rural,20-24,117130,58769,58361,11095,35392,17335,9308,2860,6448,25520
22,408,District - Rajnandgaon (09),Rural,Adolescent (10-19),275789,136306,139483,25714,84079,41191,10639,4432,6207,16615
22,408,District - Rajnandgaon (09),Rural,Youth (15-24),245645,121701,123944,23061,74307,36150,15118,5038,10080,40810
22,408,District - Rajnandgaon (09),Urban,All Ages,272512,136643,135869,38544,19409,9432,67059,26512,40547,7537
22,408,District - Rajnandgaon (09),Urban,10-14,25971,13144,12827,3823,2320,1099,878,463,415,52
22,408,District - Rajnandgaon (09),Urban,15-19,26958,13692,13266,4024,2292,1068,992,478,514,616
22,408,District - Rajnandgaon (09),Urban,20-24,27697,13810,13887,3906,2041,1043,1448,535,913,958
22,408,District - Rajnandgaon (09),Urban,Adolescent (10-19),52929,26836,26093,7847,4612,2167,1870,941,929,668
22,408,District - Rajnandgaon (09),Urban,Youth (15-24),54655,27502,27153,7930,4333,2111,2440,1013,1427,1574
22,409,District - Durg (10),Total,All Ages,3343872,1682101,1661771,458040,397416,196008,1040494,397489,643005,363454
22,409,District - Durg (10),Total,10-14,357471,181323,176148,51318,42327,21343,11317,5276,6041,2506
22,409,District - Durg (10),Total,15-19,344217,175521,168696,48576,41637,20711,14450,5529,8921,28786
22,409,District - Durg (10),Total,20-24,321621,162131,159490,45852,38276,18976,22233,6205,16028,52511
22,409,District - Durg (10),Total,Adolescent (10-19),701688,356844,344844,99894,83964,42054,25767,10805,14962,31292
22,409,District - Durg (10),Total,Youth (15-24),665838,337652,328186,94428,79913,39687,36683,11734,24949,81297
22,409,District - Durg (10),Rural,All Ages,2059107,1026152,1032955,284513,317955,155925,728954,273932,455022,341868
22,409,District - Durg (10),Rural,10-14,234797,117866,116931,33647,33503,16802,7820,3486,4334,2336
22,409,District - Durg (10),Rural,15-19,214362,108248,106114,29879,32614,16079,9773,3526,6247,27177
22,409,District - Durg (10),Rural,20-24,188902,95192,93710,26751,29877,14814,15335,3954,11381,49730
22,409,District - Durg (10),Rural,Adolescent (10-19),449159,226114,223045,63526,66117,32881,17593,7012,10581,29513
22,409,District - Durg (10),Rural,Youth (15-24),403264,203440,199824,56630,62491,30893,25108,7480,17628,76907
22,409,District - Durg (10),Urban,All Ages,1284765,655949,628816,173527,79461,40083,311540,123557,187983,21586
22,409,District - Durg (10),Urban,10-14,122674,63457,59217,17671,8824,4541,3497,1790,1707,170
22,409,District - Durg (10),Urban,15-19,129855,67273,62582,18697,9023,4632,4677,2003,2674,1609
22,409,District - Durg (10),Urban,20-24,132719,66939,65780,19101,8399,4162,6898,2251,4647,2781
22,409,District - Durg (10),Urban,Adolescent (10-19),252529,130730,121799,36368,17847,9173,8174,3793,4381,1779
22,409,District - Durg (10),Urban,Youth (15-24),262574,134212,128362,37798,17422,8794,11575,4254,7321,4390
22,410,District - Raipur (11),Total,All Ages,4063872,2048186,2015686,724250,476446,235271,1434123,555028,879095,354429
22,410,District - Raipur (11),Total,10-14,461956,234989,226967,90311,56333,28416,22541,10214,12327,2813
22,410,District - Raipur (11),Total,15-19,429067,218134,210933,81959,50981,25294,30588,11043,19545,27290
22,410,District - Raipur (11),Total,20-24,387787,194390,193397,69586,44247,21801,45307,12366,32941,49680
22,410,District - Raipur (11),Total,Adolescent (10-19),891023,453123,437900,172270,107314,53710,53129,21257,31872,30103
22,410,District - Raipur (11),Total,Youth (15-24),816854,412524,404330,151545,95228,47095,75895,23409,52486,76970
22,410,District - Raipur (11),Rural,All Ages,2580583,1288567,1292016,524846,407912,200597,1034869,390269,644600,330902
22,410,District - Raipur (11),Rural,10-14,313413,158457,154956,67438,48713,24569,16000,6913,9087,2629
22,410,District - Raipur (11),Rural,15-19,282417,142184,140233,59516,43616,21590,22315,7513,14802,25564
22,410,District - Raipur (11),Rural,20-24,234038,117928,116110,48297,36495,17947,33231,8425,24806,46677
22,410,District - Raipur (11),Rural,Adolescent (10-19),595830,300641,295189,126954,92329,46159,38315,14426,23889,28193
22,410,District - Raipur (11),Rural,Youth (15-24),516455,260112,256343,107813,80111,39537,55546,15938,39608,72241
22,410,District - Raipur (11),Urban,All Ages,1483289,759619,723670,199404,68534,34674,399254,164759,234495,23527
22,410,District - Raipur (11),Urban,10-14,148543,76532,72011,22873,7620,3847,6541,3301,3240,184
22,410,District - Raipur (11),Urban,15-19,146650,75950,70700,22443,7365,3704,8273,3530,4743,1726
22,410,District - Raipur (11),Urban,20-24,153749,76462,77287,21289,7752,3854,12076,3941,8135,3003
22,410,District - Raipur (11),Urban,Adolescent (10-19),295193,152482,142711,45316,14985,7551,14814,6831,7983,1910
22,410,District - Raipur (11),Urban,Youth (15-24),300399,152412,147987,43732,15117,7558,20349,7471,12878,4729
22,411,District - Mahasamund (12),Total,All Ages,1032754,511967,520787,139581,279896,137339,394791,147878,246913,156599
22,411,District - Mahasamund (12),Total,10-14,113780,57143,56637,16774,31949,15981,3875,1785,2090,1031
22,411,District - Mahasamund (12),Total,15-19,108701,54607,54094,14934,30007,14990,6092,2152,3940,11826
22,411,District - Mahasamund (12),Total,20-24,90455,45250,45205,11961,23484,11880,9790,2497,7293,19442
22,411,District - Mahasamund (12),Total,Adolescent (10-19),222481,111750,110731,31708,61956,30971,9967,3937,6030,12857
22,411,District - Mahasamund (12),Total,Youth (15-24),199156,99857,99299,26895,53491,26870,15882,4649,11233,31268
22,411,District - Mahasamund (12),Rural,All Ages,912602,451691,460911,120662,270124,132597,360535,134520,226015,153577
22,411,District - Mahasamund (12),Rural,10-14,101402,50904,50498,14540,30764,15377,3291,1481,1810,1001
22,411,District - Mahasamund (12),Rural,15-19,96040,48198,47842,12804,28775,14392,5374,1867,3507,11601
22,411,District - Mahasamund (12),Rural,20-24,78441,39271,39170,10078,22504,11375,8720,2172,6548,19099
22,411,District - Mahasamund (12),Rural,Adolescent (10-19),197442,99102,98340,27344,59539,29769,8665,3348,5317,12602
22,411,District - Mahasamund (12),Rural,Youth (15-24),174481,87469,87012,22882,51279,25767,14094,4039,10055,30700
22,411,District - Mahasamund (12),Urban,All Ages,120152,60276,59876,18919,9772,4742,34256,13358,20898,3022
22,411,District - Mahasamund (12),Urban,10-14,12378,6239,6139,2234,1185,604,584,304,280,30
22,411,District - Mahasamund (12),Urban,15-19,12661,6409,6252,2130,1232,598,718,285,433,225
22,411,District - Mahasamund (12),Urban,20-24,12014,5979,6035,1883,980,505,1070,325,745,343
22,411,District - Mahasamund (12),Urban,Adolescent (10-19),25039,12648,12391,4364,2417,1202,1302,589,713,255
22,411,District - Mahasamund (12),Urban,Youth (15-24),24675,12388,12287,4013,2212,1103,1788,610,1178,568
22,412,District - Dhamtari (13),Total,All Ages,799781,397897,401884,58581,207633,102058,252948,93973,158975,135855
22,412,District - Dhamtari (13),Total,10-14,86560,43222,43338,6675,21530,10519,1702,823,879,626
22,412,District - Dhamtari (13),Total,15-19,84876,42563,42313,6450,21641,10713,2510,1120,1390,11198
22,412,District - Dhamtari (13),Total,20-24,77438,38650,38788,5569,20332,10085,4607,1418,3189,21202
22,412,District - Dhamtari (13),Total,Adolescent (10-19),171436,85785,85651,13125,43171,21232,4212,1943,2269,11824
22,412,District - Dhamtari (13),Total,Youth (15-24),162314,81213,81101,12019,41973,20798,7117,2538,4579,32400
22,412,District - Dhamtari (13),Rural,All Ages,650586,323420,327166,45455,190463,93682,214761,79370,135391,127452
22,412,District - Dhamtari (13),Rural,10-14,71413,35574,35839,5239,19629,9625,1317,629,688,593
22,412,District - Dhamtari (13),Rural,15-19,69451,34705,34746,5004,19685,9786,2004,870,1134,10644
22,412,District - Dhamtari (13),Rural,20-24,62140,31025,31115,4198,18523,9137,3797,1110,2687,20059
22,412,District - Dhamtari (13),Rural,Adolescent (10-19),140864,70279,70585,10243,39314,19411,3321,1499,1822,11237
22,412,District - Dhamtari (13),Rural,Youth (15-24),131591,65730,65861,9202,38208,18923,5801,1980,3821,30703
22,412,District - Dhamtari (13),Urban,All Ages,149195,74477,74718,13126,17170,8376,38187,14603,23584,8403
22,412,District - Dhamtari (13),Urban,10-14,15147,7648,7499,1436,1901,894,385,194,191,33
22,412,District - Dhamtari (13),Urban,15-19,15425,7858,7567,1446,1956,927,506,250,256,554
22,412,District - Dhamtari (13),Urban,20-24,15298,7625,7673,1371,1809,948,810,308,502,1143
22,412,District - Dhamtari (13),Urban,Adolescent (10-19),30572,15506,15066,2882,3857,1821,891,444,447,587
22,412,District - Dhamtari (13),Urban,Youth (15-24),30723,15483,15240,2817,3765,1875,1316,558,758,1697
22,413,District - Uttar Bastar Kanker (14),Total,All Ages,748941,373338,375603,31543,414770,203934,292899,115040,177859,64677
22,413,District - Uttar Bastar Kanker (14),Total,10-14,80630,40730,39900,3208,45805,23034,4259,1860,2399,592
22,413,District - Uttar Bastar Kanker (14),Total,15-19,76068,38358,37710,3191,42740,21211,6286,2332,3954,6082
22,413,District - Uttar Bastar Kanker (14),Total,20-24,72327,35443,36884,3270,39347,18954,9627,2957,6670,11120
22,413,District - Uttar Bastar Kanker (14),Total,Adolescent (10-19),156698,79088,77610,6399,88545,44245,10545,4192,6353,6674
22,413,District - Uttar Bastar Kanker (14),Total,Youth (15-24),148395,73801,74594,6461,82087,40165,15913,5289,10624,17202
22,413,District - Uttar Bastar Kanker (14),Rural,All Ages,672180,335149,337031,26043,395978,194974,275321,108086,167235,62201
22,413,District - Uttar Bastar Kanker (14),Rural,10-14,73018,37060,35958,2699,43505,22065,4098,1779,2319,581
22,413,District - Uttar Bastar Kanker (14),Rural,15-19,68264,34547,33717,2633,40438,20184,6084,2236,3848,5902
22,413,District - Uttar Bastar Kanker (14),Rural,20-24,64209,31540,32669,2684,37308,17978,9300,2831,6469,10745
22,413,District - Uttar Bastar Kanker (14),Rural,Adolescent (10-19),141282,71607,69675,5332,83943,42249,10182,4015,6167,6483
22,413,District - Uttar Bastar Kanker (14),Rural,Youth (15-24),132473,66087,66386,5317,77746,38162,15384,5067,10317,16647
22,413,District - Uttar Bastar Kanker (14),Urban,All Ages,76761,38189,38572,5500,18792,8960,17578,6954,10624,2476
22,413,District - Uttar Bastar Kanker (14),Urban,10-14,7612,3670,3942,509,2300,969,161,81,80,11
22,413,District - Uttar Bastar Kanker (14),Urban,15-19,7804,3811,3993,558,2302,1027,202,96,106,180
22,413,District - Uttar Bastar Kanker (14),Urban,20-24,8118,3903,4215,586,2039,976,327,126,201,375
22,413,District - Uttar Bastar Kanker (14),Urban,Adolescent (10-19),15416,7481,7935,1067,4602,1996,363,177,186,191
22,413,District - Uttar Bastar Kanker (14),Urban,Youth (15-24),15922,7714,8208,1144,4341,2003,529,222,307,555
22,414,District - Bastar (15),Total,All Ages,1413199,698487,714712,37963,931780,456841,762336,316152,446184,83458
22,414,District - Bastar (15),Total,10-14,161362,80848,80514,4201,111162,55414,21198,8979,12219,1242
22,414,District - Bastar (15),Total,15-19,137808,68048,69760,3905,92087,44720,31690,10747,20943,8717
22,414,District - Bastar (15),Total,20-24,133562,63617,69945,4099,85501,40042,45182,13060,32122,13181
22,414,District - Bastar (15),Total,Adolescent (10-19),299170,148896,150274,8106,203249,100134,52888,19726,33162,9959
22,414,District - Bastar (15),Total,Youth (15-24),271370,131665,139705,8004,177588,84762,76872,23807,53065,21898
22,414,District - Bastar (15),Rural,All Ages,1219705,600652,619053,25881,880221,431157,708648,294754,413894,80629
22,414,District - Bastar (15),Rural,10-14,142284,71197,71087,2914,105055,52472,20570,8683,11887,1216
22,414,District - Bastar (15),Rural,15-19,118400,58252,60148,2578,85900,41691,30665,10367,20298,8480
22,414,District - Bastar (15),Rural,20-24,112754,53096,59658,2743,79560,36997,43246,12461,30785,12768
22,414,District - Bastar (15),Rural,Adolescent (10-19),260684,129449,131235,5492,190955,94163,51235,19050,32185,9696
22,414,District - Bastar (15),Rural,Youth (15-24),231154,111348,119806,5321,165460,78688,73911,22828,51083,21248
22,414,District - Bastar (15),Urban,All Ages,193494,97835,95659,12082,51559,25684,53688,21398,32290,2829
22,414,District - Bastar (15),Urban,10-14,19078,9651,9427,1287,6107,2942,628,296,332,26
22,414,District - Bastar (15),Urban,15-19,19408,9796,9612,1327,6187,3029,1025,380,645,237
22,414,District - Bastar (15),Urban,20-24,20808,10521,10287,1356,5941,3045,1936,599,1337,413
22,414,District - Bastar (15),Urban,Adolescent (10-19),38486,19447,19039,2614,12294,5971,1653,676,977,263
22,414,District - Bastar (15),Urban,Youth (15-24),40216,20317,19899,2683,12128,6074,2961,979,1982,650
22,415,District - Narayanpur (16),Total,All Ages,139820,70104,69716,4979,108161,53518,83199,36655,46544,3018
22,415,District - Narayanpur (16),Total,10-14,18274,9251,9023,629,14813,7488,4770,2170,2600,51
22,415,District - Narayanpur (16),Total,15-19,13518,6665,6853,501,10549,5172,4412,1767,2645,322
22,415,District - Narayanpur (16),Total,20-24,12454,5890,6564,512,9223,4257,5206,1720,3486,456
22,415,District - Narayanpur (16),Total,Adolescent (10-19),31792,15916,15876,1130,25362,12660,9182,3937,5245,373
22,415,District - Narayanpur (16),Total,Youth (15-24),25972,12555,13417,1013,19772,9429,9618,3487,6131,778
22,415,District - Narayanpur (16),Rural,All Ages,117714,58653,59061,3803,97372,47933,77247,34407,42840,2390
22,415,District - Narayanpur (16),Rural,10-14,15663,7835,7828,499,13270,6629,4689,2137,2552,45
22,415,District - Narayanpur (16),Rural,15-19,11042,5431,5611,392,9109,4446,4294,1731,2563,284
22,415,District - Narayanpur (16),Rural,20-24,9934,4620,5314,371,7958,3622,4989,1659,3330,391
22,415,District - Narayanpur (16),Rural,Adolescent (10-19),26705,13266,13439,891,22379,11075,8983,3868,5115,329
22,415,District - Narayanpur (16),Rural,Youth (15-24),20976,10051,10925,763,17067,8068,9283,3390,5893,675
22,415,District - Narayanpur (16),Urban,All Ages,22106,11451,10655,1176,10789,5585,5952,2248,3704,628
22,415,District - Narayanpur (16),Urban,10-14,2611,1416,1195,130,1543,859,81,33,48,6
22,415,District - Narayanpur (16),Urban,15-19,2476,1234,1242,109,1440,726,118,36,82,38
22,415,District - Narayanpur (16),Urban,20-24,2520,1270,1250,141,1265,635,217,61,156,65
22,415,District - Narayanpur (16),Urban,Adolescent (10-19),5087,2650,2437,239,2983,1585,199,69,130,44
22,415,District - Narayanpur (16),Urban,Youth (15-24),4996,2504,2492,250,2705,1361,335,97,238,103
22,416,District - Dakshin Bastar Dantewada (17),Total,All Ages,533638,264142,269496,12996,410255,199731,342401,147613,194788,18108
22,416,District - Dakshin Bastar Dantewada (17),Total,10-14,62909,32507,30402,1451,50802,26260,20906,9080,11826,551
22,416,District - Dakshin Bastar Dantewada (17),Total,15-19,51228,24231,26997,1246,39981,18480,23328,8374,14954,2558
22,416,District - Dakshin Bastar Dantewada (17),Total,20-24,50796,23610,27186,1434,37795,16833,26994,9219,17775,2923
22,416,District - Dakshin Bastar Dantewada (17),Total,Adolescent (10-19),114137,56738,57399,2697,90783,44740,44234,17454,26780,3109
22,416,District - Dakshin Bastar Dantewada (17),Total,Youth (15-24),102024,47841,54183,2680,77776,35313,50322,17593,32729,5481
22,416,District - Dakshin Bastar Dantewada (17),Rural,All Ages,437405,213930,223475,4239,375708,181872,312024,135165,176859,16787
22,416,District - Dakshin Bastar Dantewada (17),Rural,10-14,52702,27195,25507,466,46266,23840,20340,8823,11517,540
22,416,District - Dakshin Bastar Dantewada (17),Rural,15-19,42240,19558,22682,423,36344,16591,22450,8043,14407,2458
22,416,District - Dakshin Bastar Dantewada (17),Rural,20-24,40568,18428,22140,490,34127,15031,25490,8731,16759,2717
22,416,District - Dakshin Bastar Dantewada (17),Rural,Adolescent (10-19),94942,46753,48189,889,82610,40431,42790,16866,25924,2998
22,416,District - Dakshin Bastar Dantewada (17),Rural,Youth (15-24),82808,37986,44822,913,70471,31622,47940,16774,31166,5175
22,416,District - Dakshin Bastar Dantewada (17),Urban,All Ages,96233,50212,46021,8757,34547,17859,30377,12448,17929,1321
22,416,District - Dakshin Bastar Dantewada (17),Urban,10-14,10207,5312,4895,985,4536,2420,566,257,309,11
22,416,District - Dakshin Bastar Dantewada (17),Urban,15-19,8988,4673,4315,823,3637,1889,878,331,547,100
22,416,District - Dakshin Bastar Dantewada (17),Urban,20-24,10228,5182,5046,944,3668,1802,1504,488,1016,206
22,416,District - Dakshin Bastar Dantewada (17),Urban,Adolescent (10-19),19195,9985,9210,1808,8173,4309,1444,588,856,111
22,416,District - Dakshin Bastar Dantewada (17),Urban,Youth (15-24),19216,9855,9361,1767,7305,3691,2382,819,1563,306
22,417,District - Bijapur (18),Total,All Ages,255230,128663,126567,10122,204189,101519,168311,74587,93724,10536
22,417,District - Bijapur (18),Total,10-14,31294,16482,14812,1171,25945,13726,12027,5564,6463,408
22,417,District - Bijapur (18),Total,15-19,23340,11222,12118,915,18787,8973,11089,4278,6811,1248
22,417,District - Bijapur (18),Total,20-24,23310,10948,12362,1069,17965,8118,12506,4430,8076,1589
22,417,District - Bijapur (18),Total,Adolescent (10-19),54634,27704,26930,2086,44732,22699,23116,9842,13274,1656
22,417,District - Bijapur (18),Total,Youth (15-24),46650,22170,24480,1984,36752,17091,23595,8708,14887,2837
22,417,District - Bijapur (18),Rural,All Ages,225630,113344,112286,7567,188527,93764,157584,70212,87372,9445
22,417,District - Bijapur (18),Rural,10-14,27694,14695,12999,841,23844,12698,11757,5439,6318,400
22,417,District - Bijapur (18),Rural,15-19,20386,9820,10566,685,17105,8224,10719,4177,6542,1157
22,417,District - Bijapur (18),Rural,20-24,19960,9301,10659,762,16238,7343,11847,4265,7582,1430
22,417,District - Bijapur (18),Rural,Adolescent (10-19),48080,24515,23565,1526,40949,20922,22476,9616,12860,1557
22,417,District - Bijapur (18),Rural,Youth (15-24),40346,19121,21225,1447,33343,15567,22566,8442,14124,2587
22,417,District - Bijapur (18),Urban,All Ages,29600,15319,14281,2555,15662,7755,10727,4375,6352,1091
22,417,District - Bijapur (18),Urban,10-14,3600,1787,1813,330,2101,1028,270,125,145,8
22,417,District - Bijapur (18),Urban,15-19,2954,1402,1552,230,1682,749,370,101,269,91
22,417,District - Bijapur (18),Urban,20-24,3350,1647,1703,307,1727,775,659,165,494,159
22,417,District - Bijapur (18),Urban,Adolescent (10-19),6554,3189,3365,560,3783,1777,640,226,414,99
22,417,District - Bijapur (18),Urban,Youth (15-24),6304,3049,3255,537,3409,1524,1029,266,763,250
23,0,State - MADHYA PRADESH (23),Total,All Ages,72626809,37612306,35014503,11342320,15316784,7719404,29775640,12437978,17337662,6630821
23,0,State - MADHYA PRADESH (23),Total,10-14,8564501,4439329,4125172,1418209,2016999,1018139,689375,328489,360886,98544
23,0,State - MADHYA PRADESH (23),Total,15-19,7446789,3980072,3466717,1210070,1525559,778214,915865,368496,547369,596860
23,0,State - MADHYA PRADESH (23),Total,20-24,6727579,3554088,3173491,1064620,1301583,650509,1393518,453809,939709,987871
23,0,State - MADHYA PRADESH (23),Total,Adolescent (10-19),16011290,8419401,7591889,2628279,3542558,1796353,1605240,696985,908255,695404
23,0,State - MADHYA PRADESH (23),Total,Youth (15-24),14174368,7534160,6640208,2274690,2827142,1428723,2309383,822305,1487078,1584731
23,0,State - MADHYA PRADESH (23),Rural,All Ages,52557404,27149388,25408016,8268002,14276874,7187769,24275418,10094406,14181012,6303841
23,0,State - MADHYA PRADESH (23),Rural,10-14,6481035,3338101,3142934,1064449,1885170,950919,568486,266106,302380,95206
23,0,State - MADHYA PRADESH (23),Rural,15-19,5359720,2862347,2497373,859743,1405702,715249,770163,296735,473428,572930
23,0,State - MADHYA PRADESH (23),Rural,20-24,4678759,2481628,2197131,737175,1197825,598028,1189205,373857,815348,946070
23,0,State - MADHYA PRADESH (23),Rural,Adolescent (10-19),11840755,6200448,5640307,1924192,3290872,1666168,1338649,562841,775808,668136
23,0,State - MADHYA PRADESH (23),Rural,Youth (15-24),10038479,5343975,4694504,1596918,2603527,1313277,1959368,670592,1288776,1519000
23,0,State - MADHYA PRADESH (23),Urban,All Ages,20069405,10462918,9606487,3074318,1039910,531635,5500222,2343572,3156650,326980
23,0,State - MADHYA PRADESH (23),Urban,10-14,2083466,1101228,982238,353760,131829,67220,120889,62383,58506,3338
23,0,State - MADHYA PRADESH (23),Urban,15-19,2087069,1117725,969344,350327,119857,62965,145702,71761,73941,23930
23,0,State - MADHYA PRADESH (23),Urban,20-24,2048820,1072460,976360,327445,103758,52481,204313,79952,124361,41801
23,0,State - MADHYA PRADESH (23),Urban,Adolescent (10-19),4170535,2218953,1951582,704087,251686,130185,266591,134144,132447,27268
23,0,State - MADHYA PRADESH (23),Urban,Youth (15-24),4135889,2190185,1945704,677772,223615,115446,350015,151713,198302,65731
23,418,District - Sheopur (01),Total,All Ages,687861,361784,326077,108391,161448,82637,359836,153583,206253,57548
23,418,District - Sheopur (01),Total,10-14,90937,47909,43028,14639,22885,11951,9707,4448,5259,515
23,418,District - Sheopur (01),Total,15-19,71799,38124,33675,12273,13514,6771,15729,5533,10196,4981
23,418,District - Sheopur (01),Total,20-24,65743,34996,30747,10536,14278,6920,25563,7823,17740,10202
23,418,District - Sheopur (01),Total,Adolescent (10-19),162736,86033,76703,26912,36399,18722,25436,9981,15455,5496
23,418,District - Sheopur (01),Total,Youth (15-24),137542,73120,64422,22809,27792,13691,41292,13356,27936,15183
23,418,District - Sheopur (01),Rural,All Ages,580509,305360,275149,91800,157227,80403,319456,136967,182489,56474
23,418,District - Sheopur (01),Rural,10-14,77561,40812,36749,12384,22253,11627,8199,3715,4484,509
23,418,District - Sheopur (01),Rural,15-19,59516,31566,27950,10247,13021,6472,13921,4757,9164,4896
23,418,District - Sheopur (01),Rural,20-24,55002,29266,25736,8861,13832,6679,23332,7022,16310,10041
23,418,District - Sheopur (01),Rural,Adolescent (10-19),137077,72378,64699,22631,35274,18099,22120,8472,13648,5405
23,418,District - Sheopur (01),Rural,Youth (15-24),114518,60832,53686,19108,26853,13151,37253,11779,25474,14937
23,418,District - Sheopur (01),Urban,All Ages,107352,56424,50928,16591,4221,2234,40380,16616,23764,1074
23,418,District - Sheopur (01),Urban,10-14,13376,7097,6279,2255,632,324,1508,733,775,6
23,418,District - Sheopur (01),Urban,15-19,12283,6558,5725,2026,493,299,1808,776,1032,85
23,418,District - Sheopur (01),Urban,20-24,10741,5730,5011,1675,446,241,2231,801,1430,161
23,418,District - Sheopur (01),Urban,Adolescent (10-19),25659,13655,12004,4281,1125,623,3316,1509,1807,91
23,418,District - Sheopur (01),Urban,Youth (15-24),23024,12288,10736,3701,939,540,4039,1577,2462,246
23,419,District - Morena (02),Total,All Ages,1965970,1068417,897553,421519,17030,8947,786285,320765,465520,84783
23,419,District - Morena (02),Total,10-14,250881,137417,113464,57515,2529,1328,15204,7124,8080,954
23,419,District - Morena (02),Total,15-19,221929,129338,92591,49466,1684,930,21658,8775,12883,8261
23,419,District - Morena (02),Total,20-24,185397,104095,81302,39602,1465,795,38288,10061,28227,15555
23,419,District - Morena (02),Total,Adolescent (10-19),472810,266755,206055,106981,4213,2258,36862,15899,20963,9215
23,419,District - Morena (02),Total,Youth (15-24),407326,233433,173893,89068,3149,1725,59946,18836,41110,23816
23,419,District - Morena (02),Rural,All Ages,1495508,815218,680290,321530,14362,7524,629822,256470,373352,78515
23,419,District - Morena (02),Rural,10-14,194665,106110,88555,44373,2195,1150,11342,5155,6187,917
23,419,District - Morena (02),Rural,15-19,167828,98761,69067,36978,1365,748,16686,6452,10234,7802
23,419,District - Morena (02),Rural,20-24,137884,78303,59581,29455,1203,645,30998,7724,23274,14644
23,419,District - Morena (02),Rural,Adolescent (10-19),362493,204871,157622,81351,3560,1898,28028,11607,16421,8719
23,419,District - Morena (02),Rural,Youth (15-24),305712,177064,128648,66433,2568,1393,47684,14176,33508,22446
23,419,District - Morena (02),Urban,All Ages,470462,253199,217263,99989,2668,1423,156463,64295,92168,6268
23,419,District - Morena (02),Urban,10-14,56216,31307,24909,13142,334,178,3862,1969,1893,37
23,419,District - Morena (02),Urban,15-19,54101,30577,23524,12488,319,182,4972,2323,2649,459
23,419,District - Morena (02),Urban,20-24,47513,25792,21721,10147,262,150,7290,2337,4953,911
23,419,District - Morena (02),Urban,Adolescent (10-19),110317,61884,48433,25630,653,360,8834,4292,4542,496
23,419,District - Morena (02),Urban,Youth (15-24),101614,56369,45245,22635,581,332,12262,4660,7602,1370
23,420,District - Bhind (03),Total,All Ages,1703005,926843,776162,374799,6131,3283,608088,250330,357758,101241
23,420,District - Bhind (03),Total,10-14,204219,111679,92540,47887,795,458,9512,4545,4967,1027
23,420,District - Bhind (03),Total,15-19,189577,111225,78352,42375,675,385,12533,5746,6787,8736
23,420,District - Bhind (03),Total,20-24,158274,90208,68066,35193,562,304,22905,6866,16039,17760
23,420,District - Bhind (03),Total,Adolescent (10-19),393796,222904,170892,90262,1470,843,22045,10291,11754,9763
23,420,District - Bhind (03),Total,Youth (15-24),347851,201433,146418,77568,1237,689,35438,12612,22826,26496
23,420,District - Bhind (03),Rural,All Ages,1270083,694756,575327,284499,1425,758,470048,192864,277184,87959
23,420,District - Bhind (03),Rural,10-14,153009,83329,69680,36056,177,112,6401,2959,3442,932
23,420,District - Bhind (03),Rural,15-19,139807,83044,56763,31461,122,70,8536,3736,4800,7801
23,420,District - Bhind (03),Rural,20-24,115474,66917,48557,26243,114,60,17204,4883,12321,15799
23,420,District - Bhind (03),Rural,Adolescent (10-19),292816,166373,126443,67517,299,182,14937,6695,8242,8733
23,420,District - Bhind (03),Rural,Youth (15-24),255281,149961,105320,57704,236,130,25740,8619,17121,23600
23,420,District - Bhind (03),Urban,All Ages,432922,232087,200835,90300,4706,2525,138040,57466,80574,13282
23,420,District - Bhind (03),Urban,10-14,51210,28350,22860,11831,618,346,3111,1586,1525,95
23,420,District - Bhind (03),Urban,15-19,49770,28181,21589,10914,553,315,3997,2010,1987,935
23,420,District - Bhind (03),Urban,20-24,42800,23291,19509,8950,448,244,5701,1983,3718,1961
23,420,District - Bhind (03),Urban,Adolescent (10-19),100980,56531,44449,22745,1171,661,7108,3596,3512,1030
23,420,District - Bhind (03),Urban,Youth (15-24),92570,51472,41098,19864,1001,559,9698,3993,5705,2896
23,421,District - Gwalior (04),Total,All Ages,2032036,1090327,941709,393068,72133,37704,674826,287213,387613,63755
23,421,District - Gwalior (04),Total,10-14,227405,124743,102662,47761,9454,5162,15745,8004,7741,813
23,421,District - Gwalior (04),Total,15-19,225071,126423,98648,46683,7229,4056,21752,10222,11530,5410
23,421,District - Gwalior (04),Total,20-24,206778,113371,93407,40705,6541,3302,32692,11621,21071,9523
23,421,District - Gwalior (04),Total,Adolescent (10-19),452476,251166,201310,94444,16683,9218,37497,18226,19271,6223
23,421,District - Gwalior (04),Total,Youth (15-24),431849,239794,192055,87388,13770,7358,54444,21843,32601,14933
23,421,District - Gwalior (04),Rural,All Ages,758244,409349,348895,161091,54777,28381,338883,142332,196551,54976
23,421,District - Gwalior (04),Rural,10-14,96820,52214,44606,21431,7324,3929,7444,3609,3835,744
23,421,District - Gwalior (04),Rural,15-19,84480,48429,36051,18521,5129,2897,11294,4792,6502,4885
23,421,District - Gwalior (04),Rural,20-24,70813,39960,30853,14708,4733,2330,18654,5880,12774,8530
23,421,District - Gwalior (04),Rural,Adolescent (10-19),181300,100643,80657,39952,12453,6826,18738,8401,10337,5629
23,421,District - Gwalior (04),Rural,Youth (15-24),155293,88389,66904,33229,9862,5227,29948,10672,19276,13415
23,421,District - Gwalior (04),Urban,All Ages,1273792,680978,592814,231977,17356,9323,335943,144881,191062,8779
23,421,District - Gwalior (04),Urban,10-14,130585,72529,58056,26330,2130,1233,8301,4395,3906,69
23,421,District - Gwalior (04),Urban,15-19,140591,77994,62597,28162,2100,1159,10458,5430,5028,525
23,421,District - Gwalior (04),Urban,20-24,135965,73411,62554,25997,1808,972,14038,5741,8297,993
23,421,District - Gwalior (04),Urban,Adolescent (10-19),271176,150523,120653,54492,4230,2392,18759,9825,8934,594
23,421,District - Gwalior (04),Urban,Youth (15-24),276556,151405,125151,54159,3908,2131,24496,11171,13325,1518
23,422,District - Datia (05),Total,All Ages,786754,420157,366597,200270,15061,7870,295309,116342,178967,57194
23,422,District - Datia (05),Total,10-14,92997,49929,43068,24725,2038,1087,4360,2159,2201,522
23,422,District - Datia (05),Total,15-19,82223,46900,35323,21152,1350,753,6333,2724,3609,4725
23,422,District - Datia (05),Total,20-24,73371,40355,33016,18800,1250,641,12778,3561,9217,9056
23,422,District - Datia (05),Total,Adolescent (10-19),175220,96829,78391,45877,3388,1840,10693,4883,5810,5247
23,422,District - Datia (05),Total,Youth (15-24),155594,87255,68339,39952,2600,1394,19111,6285,12826,13781
23,422,District - Datia (05),Rural,All Ages,604772,323966,280806,164777,10889,5712,239205,93065,146140,53055
23,422,District - Datia (05),Rural,10-14,72492,38890,33602,20297,1453,775,3145,1542,1603,492
23,422,District - Datia (05),Rural,15-19,62156,35775,26381,16884,954,534,4644,1836,2808,4402
23,422,District - Datia (05),Rural,20-24,54869,30395,24474,15057,885,441,10370,2602,7768,8465
23,422,District - Datia (05),Rural,Adolescent (10-19),134648,74665,59983,37181,2407,1309,7789,3378,4411,4894
23,422,District - Datia (05),Rural,Youth (15-24),117025,66170,50855,31941,1839,975,15014,4438,10576,12867
23,422,District - Datia (05),Urban,All Ages,181982,96191,85791,35493,4172,2158,56104,23277,32827,4139
23,422,District - Datia (05),Urban,10-14,20505,11039,9466,4428,585,312,1215,617,598,30
23,422,District - Datia (05),Urban,15-19,20067,11125,8942,4268,396,219,1689,888,801,323
23,422,District - Datia (05),Urban,20-24,18502,9960,8542,3743,365,200,2408,959,1449,591
23,422,District - Datia (05),Urban,Adolescent (10-19),40572,22164,18408,8696,981,531,2904,1505,1399,353
23,422,District - Datia (05),Urban,Youth (15-24),38569,21085,17484,8011,761,419,4097,1847,2250,914
23,423,District - Shivpuri (06),Total,All Ages,1726050,919795,806255,321515,227802,117111,825204,346553,478651,131673
23,423,District - Shivpuri (06),Total,10-14,218900,116342,102558,42868,30203,16074,18172,8297,9875,1727
23,423,District - Shivpuri (06),Total,15-19,176187,99248,76939,34627,18807,10072,26659,9908,16751,11723
23,423,District - Shivpuri (06),Total,20-24,158408,86474,71934,29793,18473,9063,48934,13697,35237,21349
23,423,District - Shivpuri (06),Total,Adolescent (10-19),395087,215590,179497,77495,49010,26146,44831,18205,26626,13450
23,423,District - Shivpuri (06),Total,Youth (15-24),334595,185722,148873,64420,37280,19135,75593,23605,51988,33072
23,423,District - Shivpuri (06),Rural,All Ages,1430627,763554,667073,273869,219140,112698,726987,304849,422138,127947
23,423,District - Shivpuri (06),Rural,10-14,185489,98513,86976,36988,29040,15484,15542,6991,8551,1689
23,423,District - Shivpuri (06),Rural,15-19,143530,81627,61903,28692,17852,9556,23134,8230,14904,11476
23,423,District - Shivpuri (06),Rural,20-24,127556,69990,57566,24567,17772,8736,43854,11828,32026,20813
23,423,District - Shivpuri (06),Rural,Adolescent (10-19),329019,180140,148879,65680,46892,25040,38676,15221,23455,13165
23,423,District - Shivpuri (06),Rural,Youth (15-24),271086,151617,119469,53259,35624,18292,66988,20058,46930,32289
23,423,District - Shivpuri (06),Urban,All Ages,295423,156241,139182,47646,8662,4413,98217,41704,56513,3726
23,423,District - Shivpuri (06),Urban,10-14,33411,17829,15582,5880,1163,590,2630,1306,1324,38
23,423,District - Shivpuri (06),Urban,15-19,32657,17621,15036,5935,955,516,3525,1678,1847,247
23,423,District - Shivpuri (06),Urban,20-24,30852,16484,14368,5226,701,327,5080,1869,3211,536
23,423,District - Shivpuri (06),Urban,Adolescent (10-19),66068,35450,30618,11815,2118,1106,6155,2984,3171,285
23,423,District - Shivpuri (06),Urban,Youth (15-24),63509,34105,29404,11161,1656,843,8605,3547,5058,783
23,424,District - Tikamgarh (07),Total,All Ages,1445166,760355,684811,361604,67857,34923,697226,301002,396224,126209
23,424,District - Tikamgarh (07),Total,10-14,180988,94466,86522,48079,9137,4673,15057,7408,7649,1340
23,424,District - Tikamgarh (07),Total,15-19,142405,78124,64281,37746,6007,3236,21722,8584,13138,10230
23,424,District - Tikamgarh (07),Total,20-24,128450,68050,60400,31707,5484,2724,37680,10889,26791,20127
23,424,District - Tikamgarh (07),Total,Adolescent (10-19),323393,172590,150803,85825,15144,7909,36779,15992,20787,11570
23,424,District - Tikamgarh (07),Total,Youth (15-24),270855,146174,124681,69453,11491,5960,59402,19473,39929,30357
23,424,District - Tikamgarh (07),Rural,All Ages,1195293,629477,565816,308062,61540,31648,608300,262726,345574,118038
23,424,District - Tikamgarh (07),Rural,10-14,151662,79097,72565,41042,8184,4201,12697,6203,6494,1280
23,424,District - Tikamgarh (07),Rural,15-19,116004,63883,52121,31492,5377,2872,18886,7302,11584,9634
23,424,District - Tikamgarh (07),Rural,20-24,103758,55056,48702,26302,5023,2484,33385,9352,24033,18911
23,424,District - Tikamgarh (07),Rural,Adolescent (10-19),267666,142980,124686,72534,13561,7073,31583,13505,18078,10914
23,424,District - Tikamgarh (07),Rural,Youth (15-24),219762,118939,100823,57794,10400,5356,52271,16654,35617,28545
23,424,District - Tikamgarh (07),Urban,All Ages,249873,130878,118995,53542,6317,3275,88926,38276,50650,8171
23,424,District - Tikamgarh (07),Urban,10-14,29326,15369,13957,7037,953,472,2360,1205,1155,60
23,424,District - Tikamgarh (07),Urban,15-19,26401,14241,12160,6254,630,364,2836,1282,1554,596
23,424,District - Tikamgarh (07),Urban,20-24,24692,12994,11698,5405,461,240,4295,1537,2758,1216
23,424,District - Tikamgarh (07),Urban,Adolescent (10-19),55727,29610,26117,13291,1583,836,5196,2487,2709,656
23,424,District - Tikamgarh (07),Urban,Youth (15-24),51093,27235,23858,11659,1091,604,7131,2819,4312,1812
23,425,District - Chhatarpur (08),Total,All Ages,1762375,936121,826254,405313,73597,38081,819342,364111,455231,130732
23,425,District - Chhatarpur (08),Total,10-14,228806,120522,108284,58656,10551,5510,20420,9902,10518,1315
23,425,District - Chhatarpur (08),Total,15-19,185110,102314,82796,44746,7068,3931,25272,11107,14165,11789
23,425,District - Chhatarpur (08),Total,20-24,155626,85723,69903,33176,5363,2748,38894,12526,26368,20411
23,425,District - Chhatarpur (08),Total,Adolescent (10-19),413916,222836,191080,103402,17619,9441,45692,21009,24683,13104
23,425,District - Chhatarpur (08),Total,Youth (15-24),340736,188037,152699,77922,12431,6679,64166,23633,40533,32200
23,425,District - Chhatarpur (08),Rural,All Ages,1363359,725273,638086,334176,68928,35622,691801,308336,383465,121262
23,425,District - Chhatarpur (08),Rural,10-14,181923,95693,86230,48669,9801,5090,17020,8186,8834,1247
23,425,District - Chhatarpur (08),Rural,15-19,141155,78433,62722,35789,6513,3598,21568,9251,12317,11035
23,425,District - Chhatarpur (08),Rural,20-24,115923,64535,51388,26241,5009,2561,33861,10642,23219,19151
23,425,District - Chhatarpur (08),Rural,Adolescent (10-19),323078,174126,148952,84458,16314,8688,38588,17437,21151,12282
23,425,District - Chhatarpur (08),Rural,Youth (15-24),257078,142968,114110,62030,11522,6159,55429,19893,35536,30186
23,425,District - Chhatarpur (08),Urban,All Ages,399016,210848,188168,71137,4669,2459,127541,55775,71766,9470
23,425,District - Chhatarpur (08),Urban,10-14,46883,24829,22054,9987,750,420,3400,1716,1684,68
23,425,District - Chhatarpur (08),Urban,15-19,43955,23881,20074,8957,555,333,3704,1856,1848,754
23,425,District - Chhatarpur (08),Urban,20-24,39703,21188,18515,6935,354,187,5033,1884,3149,1260
23,425,District - Chhatarpur (08),Urban,Adolescent (10-19),90838,48710,42128,18944,1305,753,7104,3572,3532,822
23,425,District - Chhatarpur (08),Urban,Youth (15-24),83658,45069,38589,15892,909,520,8737,3740,4997,2014
23,426,District - Panna (09),Total,All Ages,1016520,533480,483040,207990,170879,87697,463961,201340,262621,99961
23,426,District - Panna (09),Total,10-14,131227,67765,63462,28701,23087,11742,9271,4702,4569,829
23,426,District - Panna (09),Total,15-19,105853,58133,47720,21904,16700,9105,11456,5401,6055,7393
23,426,District - Panna (09),Total,20-24,84523,46611,37912,16262,12799,6586,19387,6520,12867,13943
23,426,District - Panna (09),Total,Adolescent (10-19),237080,125898,111182,50605,39787,20847,20727,10103,10624,8222
23,426,District - Panna (09),Total,Youth (15-24),190376,104744,85632,38166,29499,15691,30843,11921,18922,21336
23,426,District - Panna (09),Rural,All Ages,891185,467473,423712,184883,164136,84196,425719,184900,240819,96030
23,426,District - Panna (09),Rural,10-14,116563,59961,56602,25538,22103,11232,8222,4115,4107,801
23,426,District - Panna (09),Rural,15-19,92038,50630,41408,19099,15963,8686,10487,4874,5613,7118
23,426,District - Panna (09),Rural,20-24,72351,40062,32289,14083,12307,6331,18011,5961,12050,13471
23,426,District - Panna (09),Rural,Adolescent (10-19),208601,110591,98010,44637,38066,19918,18709,8989,9720,7919
23,426,District - Panna (09),Rural,Youth (15-24),164389,90692,73697,33182,28270,15017,28498,10835,17663,20589
23,426,District - Panna (09),Urban,All Ages,125335,66007,59328,23107,6743,3501,38242,16440,21802,3931
23,426,District - Panna (09),Urban,10-14,14664,7804,6860,3163,984,510,1049,587,462,28
23,426,District - Panna (09),Urban,15-19,13815,7503,6312,2805,737,419,969,527,442,275
23,426,District - Panna (09),Urban,20-24,12172,6549,5623,2179,492,255,1376,559,817,472
23,426,District - Panna (09),Urban,Adolescent (10-19),28479,15307,13172,5968,1721,929,2018,1114,904,303
23,426,District - Panna (09),Urban,Youth (15-24),25987,14052,11935,4984,1229,674,2345,1086,1259,747
23,427,District - Sagar (10),Total,All Ages,2378458,1256257,1122201,501630,221936,114771,832739,347650,485089,249084
23,427,District - Sagar (10),Total,10-14,283714,147212,136502,63320,29097,14916,12439,6260,6179,2127
23,427,District - Sagar (10),Total,15-19,245067,136776,108291,53197,21634,12064,14793,7308,7485,22143
23,427,District - Sagar (10),Total,20-24,226889,125748,101141,48382,18570,9620,28920,10143,18777,40720
23,427,District - Sagar (10),Total,Adolescent (10-19),528781,283988,244793,116517,50731,26980,27232,13568,13664,24270
23,427,District - Sagar (10),Total,Youth (15-24),471956,262524,209432,101579,40204,21684,43713,17451,26262,62863
23,427,District - Sagar (10),Rural,All Ages,1669662,884133,785529,349843,208315,107661,657680,273778,383902,238110
23,427,District - Sagar (10),Rural,10-14,208850,108276,100574,45289,27352,14052,8990,4540,4450,2050
23,427,District - Sagar (10),Rural,15-19,171438,97206,74232,35733,20128,11261,11599,5666,5933,21339
23,427,District - Sagar (10),Rural,20-24,153445,86206,67239,32297,17215,8907,24226,8181,16045,39190
23,427,District - Sagar (10),Rural,Adolescent (10-19),380288,205482,174806,81022,47480,25313,20589,10206,10383,23389
23,427,District - Sagar (10),Rural,Youth (15-24),324883,183412,141471,68030,37343,20168,35825,13847,21978,60529
23,427,District - Sagar (10),Urban,All Ages,708796,372124,336672,151787,13621,7110,175059,73872,101187,10974
23,427,District - Sagar (10),Urban,10-14,74864,38936,35928,18031,1745,864,3449,1720,1729,77
23,427,District - Sagar (10),Urban,15-19,73629,39570,34059,17464,1506,803,3194,1642,1552,804
23,427,District - Sagar (10),Urban,20-24,73444,39542,33902,16085,1355,713,4694,1962,2732,1530
23,427,District - Sagar (10),Urban,Adolescent (10-19),148493,78506,69987,35495,3251,1667,6643,3362,3281,881
23,427,District - Sagar (10),Urban,Youth (15-24),147073,79112,67961,33549,2861,1516,7888,3604,4284,2334
23,428,District - Damoh (11),Total,All Ages,1264219,661873,602346,246337,166295,84809,516504,216136,300368,143256
23,428,District - Damoh (11),Total,10-14,149691,77463,72228,30264,21709,10905,8184,4242,3942,1344
23,428,District - Damoh (11),Total,15-19,124119,69702,54417,24585,15924,8750,11357,5668,5689,11555
23,428,District - Damoh (11),Total,20-24,113878,62982,50896,21981,13327,7017,21343,7630,13713,21320
23,428,District - Damoh (11),Total,Adolescent (10-19),273810,147165,126645,54849,37633,19655,19541,9910,9631,12899
23,428,District - Damoh (11),Total,Youth (15-24),237997,132684,105313,46566,29251,15767,32700,13298,19402,32875
23,428,District - Damoh (11),Rural,All Ages,1013668,530471,483197,195673,160453,81796,449528,187738,261790,139460
23,428,District - Damoh (11),Rural,10-14,123293,63711,59582,24354,20829,10480,6943,3564,3379,1321
23,428,District - Damoh (11),Rural,15-19,98145,55756,42389,18959,15225,8358,9970,4891,5079,11303
23,428,District - Damoh (11),Rural,20-24,88264,49099,39165,16724,12799,6731,19085,6625,12460,20804
23,428,District - Damoh (11),Rural,Adolescent (10-19),221438,119467,101971,43313,36054,18838,16913,8455,8458,12624
23,428,District - Damoh (11),Rural,Youth (15-24),186409,104855,81554,35683,28024,15089,29055,11516,17539,32107
23,428,District - Damoh (11),Urban,All Ages,250551,131402,119149,50664,5842,3013,66976,28398,38578,3796
23,428,District - Damoh (11),Urban,10-14,26398,13752,12646,5910,880,425,1241,678,563,23
23,428,District - Damoh (11),Urban,15-19,25974,13946,12028,5626,699,392,1387,777,610,252
23,428,District - Damoh (11),Urban,20-24,25614,13883,11731,5257,528,286,2258,1005,1253,516
23,428,District - Damoh (11),Urban,Adolescent (10-19),52372,27698,24674,11536,1579,817,2628,1455,1173,275
23,428,District - Damoh (11),Urban,Youth (15-24),51588,27829,23759,10883,1227,678,3645,1782,1863,768
23,429,District - Satna (12),Total,All Ages,2228935,1157495,1071440,398569,319975,163166,857154,356444,500710,191105
23,429,District - Satna (12),Total,10-14,273366,141505,131861,54354,41004,20989,11999,5845,6154,1561
23,429,District - Satna (12),Total,15-19,237481,126520,110961,44713,30978,16194,16848,7014,9834,13697
23,429,District - Satna (12),Total,20-24,199951,107065,92886,35742,25700,12915,28683,8678,20005,27280
23,429,District - Satna (12),Total,Adolescent (10-19),510847,268025,242822,99067,71982,37183,28847,12859,15988,15258
23,429,District - Satna (12),Total,Youth (15-24),437432,233585,203847,80455,56678,29109,45531,15692,29839,40977
23,429,District - Satna (12),Rural,All Ages,1754517,907904,846613,320757,298980,152363,725273,300624,424649,183160
23,429,District - Satna (12),Rural,10-14,218729,112395,106334,43753,38266,19577,9634,4677,4957,1516
23,429,District - Satna (12),Rural,15-19,185090,98300,86790,35191,28786,14989,13919,5574,8345,13178
23,429,District - Satna (12),Rural,20-24,153763,82478,71285,28295,23873,11953,24622,7052,17570,26323
23,429,District - Satna (12),Rural,Adolescent (10-19),403819,210695,193124,78944,67052,34566,23553,10251,13302,14694
23,429,District - Satna (12),Rural,Youth (15-24),338853,180778,158075,63486,52659,26942,38541,12626,25915,39501
23,429,District - Satna (12),Urban,All Ages,474418,249591,224827,77812,20995,10803,131881,55820,76061,7945
23,429,District - Satna (12),Urban,10-14,54637,29110,25527,10601,2738,1412,2365,1168,1197,45
23,429,District - Satna (12),Urban,15-19,52391,28220,24171,9522,2192,1205,2929,1440,1489,519
23,429,District - Satna (12),Urban,20-24,46188,24587,21601,7447,1827,962,4061,1626,2435,957
23,429,District - Satna (12),Urban,Adolescent (10-19),107028,57330,49698,20123,4930,2617,5294,2608,2686,564
23,429,District - Satna (12),Urban,Youth (15-24),98579,52807,45772,16969,4019,2167,6990,3066,3924,1476
23,430,District - Rewa (13),Total,All Ages,2365106,1225100,1140006,383508,311985,161696,923349,379528,543821,241629
23,430,District - Rewa (13),Total,10-14,298342,154810,143532,55595,42851,22125,16834,7971,8863,2833
23,430,District - Rewa (13),Total,15-19,258513,136685,121828,44047,30659,16676,20132,8106,12026,17758
23,430,District - Rewa (13),Total,20-24,210645,112302,98343,32442,25142,12774,30588,8515,22073,32632
23,430,District - Rewa (13),Total,Adolescent (10-19),556855,291495,265360,99642,73510,38801,36966,16077,20889,20591
23,430,District - Rewa (13),Total,Youth (15-24),469158,248987,220171,76489,55801,29450,50720,16621,34099,50390
23,430,District - Rewa (13),Rural,All Ages,1969321,1017839,951482,334878,286278,148251,812404,333520,478884,229593
23,430,District - Rewa (13),Rural,10-14,252541,130364,122177,48695,39489,20364,14685,6912,7773,2726
23,430,District - Rewa (13),Rural,15-19,213555,112765,100790,37797,27978,15222,17459,6877,10582,16804
23,430,District - Rewa (13),Rural,20-24,170846,91135,79711,27777,22905,11590,27035,7259,19776,31078
23,430,District - Rewa (13),Rural,Adolescent (10-19),466096,243129,222967,86492,67467,35586,32144,13789,18355,19530
23,430,District - Rewa (13),Rural,Youth (15-24),384401,203900,180501,65574,50883,26812,44494,14136,30358,47882
23,430,District - Rewa (13),Urban,All Ages,395785,207261,188524,48630,25707,13445,110945,46008,64937,12036
23,430,District - Rewa (13),Urban,10-14,45801,24446,21355,6900,3362,1761,2149,1059,1090,107
23,430,District - Rewa (13),Urban,15-19,44958,23920,21038,6250,2681,1454,2673,1229,1444,954
23,430,District - Rewa (13),Urban,20-24,39799,21167,18632,4665,2237,1184,3553,1256,2297,1554
23,430,District - Rewa (13),Urban,Adolescent (10-19),90759,48366,42393,13150,6043,3215,4822,2288,2534,1061
23,430,District - Rewa (13),Urban,Youth (15-24),84757,45087,39670,10915,4918,2638,6226,2485,3741,2508
23,431,District - Umaria (14),Total,All Ages,644758,330674,314084,58147,300687,151988,288086,119767,168319,41545
23,431,District - Umaria (14),Total,10-14,78678,39884,38794,7268,38485,19360,4359,2082,2277,485
23,431,District - Umaria (14),Total,15-19,64077,32943,31134,6026,28985,14650,7275,2757,4518,2709
23,431,District - Umaria (14),Total,20-24,59844,30799,29045,5620,26603,13222,13187,3813,9374,5966
23,431,District - Umaria (14),Total,Adolescent (10-19),142755,72827,69928,13294,67470,34010,11634,4839,6795,3194
23,431,District - Umaria (14),Total,Youth (15-24),123921,63742,60179,11646,55588,27872,20462,6570,13892,8675
23,431,District - Umaria (14),Rural,All Ages,534214,273064,261150,45117,274774,138906,254572,106215,148357,40024
23,431,District - Umaria (14),Rural,10-14,66164,33338,32826,5646,35068,17652,3735,1739,1996,442
23,431,District - Umaria (14),Rural,15-19,51724,26517,25207,4450,25878,13049,6420,2345,4075,2614
23,431,District - Umaria (14),Rural,20-24,48448,24811,23637,4202,24065,11933,11983,3398,8585,5776
23,431,District - Umaria (14),Rural,Adolescent (10-19),117888,59855,58033,10096,60946,30701,10155,4084,6071,3056
23,431,District - Umaria (14),Rural,Youth (15-24),100172,51328,48844,8652,49943,24982,18403,5743,12660,8390
23,431,District - Umaria (14),Urban,All Ages,110544,57610,52934,13030,25913,13082,33514,13552,19962,1521
23,431,District - Umaria (14),Urban,10-14,12514,6546,5968,1622,3417,1708,624,343,281,43
23,431,District - Umaria (14),Urban,15-19,12353,6426,5927,1576,3107,1601,855,412,443,95
23,431,District - Umaria (14),Urban,20-24,11396,5988,5408,1418,2538,1289,1204,415,789,190
23,431,District - Umaria (14),Urban,Adolescent (10-19),24867,12972,11895,3198,6524,3309,1479,755,724,138
23,431,District - Umaria (14),Urban,Youth (15-24),23749,12414,11335,2994,5645,2890,2059,827,1232,285
23,432,District - Neemuch (15),Total,All Ages,826067,422653,403414,111162,71441,36738,317233,114764,202469,96350
23,432,District - Neemuch (15),Total,10-14,88282,45746,42536,12650,8247,4368,5573,2332,3241,1754
23,432,District - Neemuch (15),Total,15-19,82534,42487,40047,11579,6604,3546,9650,3067,6583,10203
23,432,District - Neemuch (15),Total,20-24,79498,41272,38226,10739,6395,3261,15479,4018,11461,15071
23,432,District - Neemuch (15),Total,Adolescent (10-19),170816,88233,82583,24229,14851,7914,15223,5399,9824,11957
23,432,District - Neemuch (15),Total,Youth (15-24),162032,83759,78273,22318,12999,6807,25129,7085,18044,25274
23,432,District - Neemuch (15),Rural,All Ages,580837,295013,285824,79193,62901,32214,250191,88744,161447,88209
23,432,District - Neemuch (15),Rural,10-14,63216,32533,30683,8955,7154,3800,4295,1692,2603,1676
23,432,District - Neemuch (15),Rural,15-19,57874,29494,28380,7861,5729,3058,7896,2277,5619,9614
23,432,District - Neemuch (15),Rural,20-24,54698,27970,26728,7367,5559,2815,12954,3145,9809,13979
23,432,District - Neemuch (15),Rural,Adolescent (10-19),121090,62027,59063,16816,12883,6858,12191,3969,8222,11290
23,432,District - Neemuch (15),Rural,Youth (15-24),112572,57464,55108,15228,11288,5873,20850,5422,15428,23593
23,432,District - Neemuch (15),Urban,All Ages,245230,127640,117590,31969,8540,4524,67042,26020,41022,8141
23,432,District - Neemuch (15),Urban,10-14,25066,13213,11853,3695,1093,568,1278,640,638,78
23,432,District - Neemuch (15),Urban,15-19,24660,12993,11667,3718,875,488,1754,790,964,589
23,432,District - Neemuch (15),Urban,20-24,24800,13302,11498,3372,836,446,2525,873,1652,1092
23,432,District - Neemuch (15),Urban,Adolescent (10-19),49726,26206,23520,7413,1968,1056,3032,1430,1602,667
23,432,District - Neemuch (15),Urban,Youth (15-24),49460,26295,23165,7090,1711,934,4279,1663,2616,1681
23,433,District - Mandsaur (16),Total,All Ages,1340411,682851,657560,249024,33092,17023,505820,179953,325867,169713
23,433,District - Mandsaur (16),Total,10-14,148592,76860,71732,29688,4214,2230,6761,2724,4037,2467
23,433,District - Mandsaur (16),Total,15-19,133204,68832,64372,24705,3185,1694,12679,3576,9103,17819
23,433,District - Mandsaur (16),Total,20-24,127088,65945,61143,23183,2917,1551,22225,5216,17009,26831
23,433,District - Mandsaur (16),Total,Adolescent (10-19),281796,145692,136104,54393,7399,3924,19440,6300,13140,20286
23,433,District - Mandsaur (16),Total,Youth (15-24),260292,134777,125515,47888,6102,3245,34904,8792,26112,44650
23,433,District - Mandsaur (16),Rural,All Ages,1062807,540987,521820,218175,28643,14751,433073,151930,281143,160774
23,433,District - Mandsaur (16),Rural,10-14,121049,62589,58460,26289,3675,1931,5754,2234,3520,2394
23,433,District - Mandsaur (16),Rural,15-19,105964,54660,51304,21420,2740,1470,11185,2940,8245,17206
23,433,District - Mandsaur (16),Rural,20-24,99969,52007,47962,19982,2526,1361,19912,4400,15512,25673
23,433,District - Mandsaur (16),Rural,Adolescent (10-19),227013,117249,109764,47709,6415,3401,16939,5174,11765,19600
23,433,District - Mandsaur (16),Rural,Youth (15-24),205933,106667,99266,41402,5266,2831,31097,7340,23757,42879
23,433,District - Mandsaur (16),Urban,All Ages,277604,141864,135740,30849,4449,2272,72747,28023,44724,8939
23,433,District - Mandsaur (16),Urban,10-14,27543,14271,13272,3399,539,299,1007,490,517,73
23,433,District - Mandsaur (16),Urban,15-19,27240,14172,13068,3285,445,224,1494,636,858,613
23,433,District - Mandsaur (16),Urban,20-24,27119,13938,13181,3201,391,190,2313,816,1497,1158
23,433,District - Mandsaur (16),Urban,Adolescent (10-19),54783,28443,26340,6684,984,523,2501,1126,1375,686
23,433,District - Mandsaur (16),Urban,Youth (15-24),54359,28110,26249,6486,836,414,3807,1452,2355,1771
23,434,District - Ratlam (17),Total,All Ages,1455069,738241,716828,198612,409865,206290,629189,253151,376038,148234
23,434,District - Ratlam (17),Total,10-14,167789,86114,81675,23081,54822,27708,16957,7601,9356,3605
23,434,District - Ratlam (17),Total,15-19,145506,75062,70444,20171,41082,20189,25038,8662,16376,15927
23,434,District - Ratlam (17),Total,20-24,132180,68109,64071,18450,34418,17441,33364,10667,22697,22381
23,434,District - Ratlam (17),Total,Adolescent (10-19),313295,161176,152119,43252,95904,47897,41995,16263,25732,19532
23,434,District - Ratlam (17),Total,Youth (15-24),277686,143171,134515,38621,75500,37630,58402,19329,39073,38308
23,434,District - Ratlam (17),Rural,All Ages,1020038,516468,503570,151828,387743,194869,512934,205414,307520,139501
23,434,District - Ratlam (17),Rural,10-14,124253,63385,60868,18229,51850,26139,14417,6241,8176,3474
23,434,District - Ratlam (17),Rural,15-19,101756,52092,49664,14863,38399,18746,21873,7141,14732,15135
23,434,District - Ratlam (17),Rural,20-24,89696,46540,43156,13593,32215,16329,29247,8986,20261,21223
23,434,District - Ratlam (17),Rural,Adolescent (10-19),226009,115477,110532,33092,90249,44885,36290,13382,22908,18609
23,434,District - Ratlam (17),Rural,Youth (15-24),191452,98632,92820,28456,70614,35075,51120,16127,34993,36358
23,434,District - Ratlam (17),Urban,All Ages,435031,221773,213258,46784,22122,11421,116255,47737,68518,8733
23,434,District - Ratlam (17),Urban,10-14,43536,22729,20807,4852,2972,1569,2540,1360,1180,131
23,434,District - Ratlam (17),Urban,15-19,43750,22970,20780,5308,2683,1443,3165,1521,1644,792
23,434,District - Ratlam (17),Urban,20-24,42484,21569,20915,4857,2203,1112,4117,1681,2436,1158
23,434,District - Ratlam (17),Urban,Adolescent (10-19),87286,45699,41587,10160,5655,3012,5705,2881,2824,923
23,434,District - Ratlam (17),Urban,Youth (15-24),86234,44539,41695,10165,4886,2555,7282,3202,4080,1950
23,435,District - Ujjain (18),Total,All Ages,1986864,1016289,970575,523869,48730,24925,745874,285472,460402,170365
23,435,District - Ujjain (18),Total,10-14,218925,113801,105124,61868,6075,3133,12861,5304,7557,2700
23,435,District - Ujjain (18),Total,15-19,194812,103401,91411,52536,4861,2617,20672,6776,13896,16213
23,435,District - Ujjain (18),Total,20-24,183832,95506,88326,48913,4407,2290,32158,8796,23362,25042
23,435,District - Ujjain (18),Total,Adolescent (10-19),413737,217202,196535,114404,10936,5750,33533,12080,21453,18913
23,435,District - Ujjain (18),Total,Youth (15-24),378644,198907,179737,101449,9268,4907,52830,15572,37258,41255
23,435,District - Ujjain (18),Rural,All Ages,1207651,616353,591298,375705,33656,17233,536268,199362,336906,159692
23,435,District - Ujjain (18),Rural,10-14,141733,73285,68448,46055,4295,2218,8695,3229,5466,2592
23,435,District - Ujjain (18),Rural,15-19,118060,62604,55456,36931,3257,1779,15577,4325,11252,15379
23,435,District - Ujjain (18),Rural,20-24,107902,56747,51155,33344,2914,1540,25043,6098,18945,23621
23,435,District - Ujjain (18),Rural,Adolescent (10-19),259793,135889,123904,82986,7552,3997,24272,7554,16718,17971
23,435,District - Ujjain (18),Rural,Youth (15-24),225962,119351,106611,70275,6171,3319,40620,10423,30197,39000
23,435,District - Ujjain (18),Urban,All Ages,779213,399936,379277,148164,15074,7692,209606,86110,123496,10673
23,435,District - Ujjain (18),Urban,10-14,77192,40516,36676,15813,1780,915,4166,2075,2091,108
23,435,District - Ujjain (18),Urban,15-19,76752,40797,35955,15605,1604,838,5095,2451,2644,834
23,435,District - Ujjain (18),Urban,20-24,75930,38759,37171,15569,1493,750,7115,2698,4417,1421
23,435,District - Ujjain (18),Urban,Adolescent (10-19),153944,81313,72631,31418,3384,1753,9261,4526,4735,942
23,435,District - Ujjain (18),Urban,Youth (15-24),152682,79556,73126,31174,3097,1588,12210,5149,7061,2255
23,436,District - Shajapur (19),Total,All Ages,1512681,780520,732161,353914,37836,19416,618069,237011,381058,166691
23,436,District - Shajapur (19),Total,10-14,179228,92687,86541,44703,4970,2488,9080,3719,5361,2329
23,436,District - Shajapur (19),Total,15-19,150466,80719,69747,35675,3913,2126,15088,4600,10488,15150
23,436,District - Shajapur (19),Total,20-24,133332,70676,62656,30755,3024,1612,25626,6256,19370,23756
23,436,District - Shajapur (19),Total,Adolescent (10-19),329694,173406,156288,80378,8883,4614,24168,8319,15849,17479
23,436,District - Shajapur (19),Total,Youth (15-24),283798,151395,132403,66430,6937,3738,40714,10856,29858,38906
23,436,District - Shajapur (19),Rural,All Ages,1219133,629273,589860,312523,34226,17600,528759,201903,326856,157977
23,436,District - Shajapur (19),Rural,10-14,145874,75365,70509,39565,4486,2247,7492,2936,4556,2262
23,436,District - Shajapur (19),Rural,15-19,119984,64521,55463,30955,3475,1895,13131,3776,9355,14478
23,436,District - Shajapur (19),Rural,20-24,105466,56338,49128,26724,2739,1461,22508,5337,17171,22624
23,436,District - Shajapur (19),Rural,Adolescent (10-19),265858,139886,125972,70520,7961,4142,20623,6712,13911,16740
23,436,District - Shajapur (19),Rural,Youth (15-24),225450,120859,104591,57679,6214,3356,35639,9113,26526,37102
23,436,District - Shajapur (19),Urban,All Ages,293548,151247,142301,41391,3610,1816,89310,35108,54202,8714
23,436,District - Shajapur (19),Urban,10-14,33354,17322,16032,5138,484,241,1588,783,805,67
23,436,District - Shajapur (19),Urban,15-19,30482,16198,14284,4720,438,231,1957,824,1133,672
23,436,District - Shajapur (19),Urban,20-24,27866,14338,13528,4031,285,151,3118,919,2199,1132
23,436,District - Shajapur (19),Urban,Adolescent (10-19),63836,33520,30316,9858,922,472,3545,1607,1938,739
23,436,District - Shajapur (19),Urban,Youth (15-24),58348,30536,27812,8751,723,382,5075,1743,3332,1804
23,437,District - Dewas (20),Total,All Ages,1563715,805359,758356,292007,272701,139174,638346,254643,383703,177162
23,437,District - Dewas (20),Total,10-14,184213,95142,89071,35779,39267,19920,13887,6357,7530,3008
23,437,District - Dewas (20),Total,15-19,159999,85844,74155,30645,29190,15589,18597,7242,11355,16960
23,437,District - Dewas (20),Total,20-24,142601,74980,67621,27455,22492,11509,28401,8494,19907,26600
23,437,District - Dewas (20),Total,Adolescent (10-19),344212,180986,163226,66424,68457,35509,32484,13599,18885,19968
23,437,District - Dewas (20),Total,Youth (15-24),302600,160824,141776,58100,51682,27098,46998,15736,31262,43560
23,437,District - Dewas (20),Rural,All Ages,1111956,571720,540236,214408,247061,126064,507662,201761,305901,161616
23,437,District - Dewas (20),Rural,10-14,135356,69424,65932,26579,35931,18233,11519,5266,6253,2877
23,437,District - Dewas (20),Rural,15-19,112686,60675,52011,21926,26292,14080,15614,6024,9590,15737
23,437,District - Dewas (20),Rural,20-24,97999,51946,46053,19300,20039,10281,23876,7059,16817,24501
23,437,District - Dewas (20),Rural,Adolescent (10-19),248042,130099,117943,48505,62223,32313,27133,11290,15843,18614
23,437,District - Dewas (20),Rural,Youth (15-24),210685,112621,98064,41226,46331,24361,39490,13083,26407,40238
23,437,District - Dewas (20),Urban,All Ages,451759,233639,218120,77599,25640,13110,130684,52882,77802,15546
23,437,District - Dewas (20),Urban,10-14,48857,25718,23139,9200,3336,1687,2368,1091,1277,131
23,437,District - Dewas (20),Urban,15-19,47313,25169,22144,8719,2898,1509,2983,1218,1765,1223
23,437,District - Dewas (20),Urban,20-24,44602,23034,21568,8155,2453,1228,4525,1435,3090,2099
23,437,District - Dewas (20),Urban,Adolescent (10-19),96170,50887,45283,17919,6234,3196,5351,2309,3042,1354
23,437,District - Dewas (20),Urban,Youth (15-24),91915,48203,43712,16874,5351,2737,7508,2653,4855,3322
23,438,District - Dhar (21),Total,All Ages,2185793,1112725,1073068,145436,1222814,614619,1108455,474246,634209,266422
23,438,District - Dhar (21),Total,10-14,270040,138446,131594,17627,166105,83725,38477,18220,20257,7143
23,438,District - Dhar (21),Total,15-19,218376,113004,105372,14948,125146,62923,52035,19875,32160,29162
23,438,District - Dhar (21),Total,20-24,194000,99164,94836,14050,102121,50838,69151,24241,44910,39966
23,438,District - Dhar (21),Total,Adolescent (10-19),488416,251450,236966,32575,291251,146648,90512,38095,52417,36305
23,438,District - Dhar (21),Total,Youth (15-24),412376,212168,200208,28998,227267,113761,121186,44116,77070,69128
23,438,District - Dhar (21),Rural,All Ages,1772572,895113,877459,109481,1142263,573746,976099,417282,558817,252337
23,438,District - Dhar (21),Rural,10-14,225640,114963,110677,13559,155332,78445,35099,16607,18492,6862
23,438,District - Dhar (21),Rural,15-19,177375,90762,86613,11107,115797,58082,47847,17996,29851,27799
23,438,District - Dhar (21),Rural,20-24,150776,76131,74645,10066,93746,46752,63082,22046,41036,38128
23,438,District - Dhar (21),Rural,Adolescent (10-19),403015,205725,197290,24666,271129,136527,82946,34603,48343,34661
23,438,District - Dhar (21),Rural,Youth (15-24),328151,166893,161258,21173,209543,104834,110929,40042,70887,65927
23,438,District - Dhar (21),Urban,All Ages,413221,217612,195609,35955,80551,40873,132356,56964,75392,14085
23,438,District - Dhar (21),Urban,10-14,44400,23483,20917,4068,10773,5280,3378,1613,1765,281
23,438,District - Dhar (21),Urban,15-19,41001,22242,18759,3841,9349,4841,4188,1879,2309,1363
23,438,District - Dhar (21),Urban,20-24,43224,23033,20191,3984,8375,4086,6069,2195,3874,1838
23,438,District - Dhar (21),Urban,Adolescent (10-19),85401,45725,39676,7909,20122,10121,7566,3492,4074,1644
23,438,District - Dhar (21),Urban,Youth (15-24),84225,45275,38950,7825,17724,8927,10257,4074,6183,3201
23,439,District - Indore (22),Total,All Ages,3276697,1699627,1577070,545239,217679,112687,967567,409996,557571,133745
23,439,District - Indore (22),Total,10-14,324136,171050,153086,59234,28040,14516,21780,10644,11136,2358
23,439,District - Indore (22),Total,15-19,314616,168882,145734,57491,23072,12386,25868,11602,14266,11608
23,439,District - Indore (22),Total,20-24,327146,169302,157844,57161,20602,10474,38297,13434,24863,18101
23,439,District - Indore (22),Total,Adolescent (10-19),638752,339932,298820,116725,51112,26902,47648,22246,25402,13966
23,439,District - Indore (22),Total,Youth (15-24),641762,338184,303578,114652,43674,22860,64165,25036,39129,29709
23,439,District - Indore (22),Rural,All Ages,848988,436755,412233,164465,134702,69227,349851,136856,212995,118461
23,439,District - Indore (22),Rural,10-14,97229,50265,46964,19859,18287,9363,7119,3218,3901,2192
23,439,District - Indore (22),Rural,15-19,84282,45309,38973,16867,13990,7650,9505,3587,5918,10672
23,439,District - Indore (22),Rural,20-24,79604,41665,37939,15619,11866,6124,15092,4344,10748,16353
23,439,District - Indore (22),Rural,Adolescent (10-19),181511,95574,85937,36726,32277,17013,16624,6805,9819,12864
23,439,District - Indore (22),Rural,Youth (15-24),163886,86974,76912,32486,25856,13774,24597,7931,16666,27025
23,439,District - Indore (22),Urban,All Ages,2427709,1262872,1164837,380774,82977,43460,617716,273140,344576,15284
23,439,District - Indore (22),Urban,10-14,226907,120785,106122,39375,9753,5153,14661,7426,7235,166
23,439,District - Indore (22),Urban,15-19,230334,123573,106761,40624,9082,4736,16363,8015,8348,936
23,439,District - Indore (22),Urban,20-24,247542,127637,119905,41542,8736,4350,23205,9090,14115,1748
23,439,District - Indore (22),Urban,Adolescent (10-19),457241,244358,212883,79999,18835,9889,31024,15441,15583,1102
23,439,District - Indore (22),Urban,Youth (15-24),477876,251210,226666,82166,17818,9086,39568,17105,22463,2684
23,440,District - Khargone (West Nimar) (23),Total,All Ages,1873046,953121,919925,209091,730169,366827,886812,377693,509119,333076
23,440,District - Khargone (West Nimar) (23),Total,10-14,232091,117277,114814,25721,104843,51931,35372,17285,18087,8803
23,440,District - Khargone (West Nimar) (23),Total,15-19,191115,99400,91715,22946,73436,36925,40937,17415,23522,38549
23,440,District - Khargone (West Nimar) (23),Total,20-24,163882,85680,78202,19206,60122,30175,52332,19528,32804,48220
23,440,District - Khargone (West Nimar) (23),Total,Adolescent (10-19),423206,216677,206529,48667,178279,88856,76309,34700,41609,47352
23,440,District - Khargone (West Nimar) (23),Total,Youth (15-24),354997,185080,169917,42152,133558,67100,93269,36943,56326,86769
23,440,District - Khargone (West Nimar) (23),Rural,All Ages,1574190,799396,774794,177708,700953,352144,801401,341625,459776,323415
23,440,District - Khargone (West Nimar) (23),Rural,10-14,199354,100310,99044,21990,100761,49942,32953,16037,16916,8638
23,440,District - Khargone (West Nimar) (23),Rural,15-19,159254,82508,76746,19218,69778,35028,38218,16061,22157,37712
23,440,District - Khargone (West Nimar) (23),Rural,20-24,134634,70361,64273,15970,57334,28782,48933,18183,30750,47143
23,440,District - Khargone (West Nimar) (23),Rural,Adolescent (10-19),358608,182818,175790,41208,170539,84970,71171,32098,39073,46350
23,440,District - Khargone (West Nimar) (23),Rural,Youth (15-24),293888,152869,141019,35188,127112,63810,87151,34244,52907,84855
23,440,District - Khargone (West Nimar) (23),Urban,All Ages,298856,153725,145131,31383,29216,14683,85411,36068,49343,9661
23,440,District - Khargone (West Nimar) (23),Urban,10-14,32737,16967,15770,3731,4082,1989,2419,1248,1171,165
23,440,District - Khargone (West Nimar) (23),Urban,15-19,31861,16892,14969,3728,3658,1897,2719,1354,1365,837
23,440,District - Khargone (West Nimar) (23),Urban,20-24,29248,15319,13929,3236,2788,1393,3399,1345,2054,1077
23,440,District - Khargone (West Nimar) (23),Urban,Adolescent (10-19),64598,33859,30739,7459,7740,3886,5138,2602,2536,1002
23,440,District - Khargone (West Nimar) (23),Urban,Youth (15-24),61109,32211,28898,6964,6446,3290,6118,2699,3419,1914
23,441,District - Barwani (24),Total,All Ages,1385881,699340,686541,87991,962145,482182,835955,385698,450257,185335
23,441,District - Barwani (24),Total,10-14,185302,93089,92213,11275,137034,67988,44797,22582,22215,6996
23,441,District - Barwani (24),Total,15-19,135413,67935,67478,9049,93081,45735,49850,20930,28920,25404
23,441,District - Barwani (24),Total,20-24,118808,60228,58580,7845,80836,40399,61739,25626,36113,30652
23,441,District - Barwani (24),Total,Adolescent (10-19),320715,161024,159691,20324,230115,113723,94647,43512,51135,32400
23,441,District - Barwani (24),Total,Youth (15-24),254221,128163,126058,16894,173917,86134,111589,46556,65033,56056
23,441,District - Barwani (24),Rural,All Ages,1181812,594907,586905,64344,925650,463463,768660,356645,412015,173688
23,441,District - Barwani (24),Rural,10-14,162170,80936,81234,8437,131921,65261,42760,21486,21274,6621
23,441,District - Barwani (24),Rural,15-19,113744,56626,57118,6385,88543,43333,47406,19739,27667,24113
23,441,District - Barwani (24),Rural,20-24,99743,50493,49250,5584,77407,38717,58696,24386,34310,29191
23,441,District - Barwani (24),Rural,Adolescent (10-19),275914,137562,138352,14822,220464,108594,90166,41225,48941,30734
23,441,District - Barwani (24),Rural,Youth (15-24),213487,107119,106368,11969,165950,82050,106102,44125,61977,53304
23,441,District - Barwani (24),Urban,All Ages,204069,104433,99636,23647,36495,18719,67295,29053,38242,11647
23,441,District - Barwani (24),Urban,10-14,23132,12153,10979,2838,5113,2727,2037,1096,941,375
23,441,District - Barwani (24),Urban,15-19,21669,11309,10360,2664,4538,2402,2444,1191,1253,1291
23,441,District - Barwani (24),Urban,20-24,19065,9735,9330,2261,3429,1682,3043,1240,1803,1461
23,441,District - Barwani (24),Urban,Adolescent (10-19),44801,23462,21339,5502,9651,5129,4481,2287,2194,1666
23,441,District - Barwani (24),Urban,Youth (15-24),40734,21044,19690,4925,7967,4084,5487,2431,3056,2752
23,442,District - Rajgarh (25),Total,All Ages,1545814,790212,755602,295718,53751,27477,741569,301415,440154,139546
23,442,District - Rajgarh (25),Total,10-14,185713,94982,90731,38485,6878,3466,14208,5851,8357,1849
23,442,District - Rajgarh (25),Total,15-19,152143,77841,74302,29026,5307,2879,23407,6939,16468,11876
23,442,District - Rajgarh (25),Total,20-24,138444,70814,67630,26079,4665,2340,37612,9745,27867,20840
23,442,District - Rajgarh (25),Total,Adolescent (10-19),337856,172823,165033,67511,12185,6345,37615,12790,24825,13725
23,442,District - Rajgarh (25),Total,Youth (15-24),290587,148655,141932,55105,9972,5219,61019,16684,44335,32716
23,442,District - Rajgarh (25),Rural,All Ages,1269357,648407,620950,249329,48668,24827,649044,263813,385231,131879
23,442,District - Rajgarh (25),Rural,10-14,153913,78510,75403,32289,6178,3074,12295,4903,7392,1756
23,442,District - Rajgarh (25),Rural,15-19,123480,62904,60576,23887,4761,2583,20940,5944,14996,11177
23,442,District - Rajgarh (25),Rural,20-24,112018,57406,54612,21551,4203,2113,33844,8543,25301,19794
23,442,District - Rajgarh (25),Rural,Adolescent (10-19),277393,141414,135979,56176,10939,5657,33235,10847,22388,12933
23,442,District - Rajgarh (25),Rural,Youth (15-24),235498,120310,115188,45438,8964,4696,54784,14487,40297,30971
23,442,District - Rajgarh (25),Urban,All Ages,276457,141805,134652,46389,5083,2650,92525,37602,54923,7667
23,442,District - Rajgarh (25),Urban,10-14,31800,16472,15328,6196,700,392,1913,948,965,93
23,442,District - Rajgarh (25),Urban,15-19,28663,14937,13726,5139,546,296,2467,995,1472,699
23,442,District - Rajgarh (25),Urban,20-24,26426,13408,13018,4528,462,227,3768,1202,2566,1046
23,442,District - Rajgarh (25),Urban,Adolescent (10-19),60463,31409,29054,11335,1246,688,4380,1943,2437,792
23,442,District - Rajgarh (25),Urban,Youth (15-24),55089,28345,26744,9667,1008,523,6235,2197,4038,1745
23,443,District - Vidisha (26),Total,All Ages,1458875,769568,689307,292144,67603,34993,595957,257224,338733,119295
23,443,District - Vidisha (26),Total,10-14,183520,95017,88503,39642,8880,4555,12122,6044,6078,1283
23,443,District - Vidisha (26),Total,15-19,146426,82664,63762,28714,5544,3240,15722,7725,7997,10776
23,443,District - Vidisha (26),Total,20-24,128079,70773,57306,24523,5044,2551,24484,8741,15743,17518
23,443,District - Vidisha (26),Total,Adolescent (10-19),329946,177681,152265,68356,14424,7795,27844,13769,14075,12059
23,443,District - Vidisha (26),Total,Youth (15-24),274505,153437,121068,53237,10588,5791,40206,16466,23740,28294
23,443,District - Vidisha (26),Rural,All Ages,1119257,591962,527295,237791,63134,32668,495064,212780,282284,115163
23,443,District - Vidisha (26),Rural,10-14,145172,75018,70154,32720,8336,4279,9912,4816,5096,1229
23,443,District - Vidisha (26),Rural,15-19,111121,63370,47751,22729,5106,3004,13109,6302,6807,10440
23,443,District - Vidisha (26),Rural,20-24,94982,53381,41601,19141,4658,2349,21014,7289,13725,17008
23,443,District - Vidisha (26),Rural,Adolescent (10-19),256293,138388,117905,55449,13442,7283,23021,11118,11903,11669
23,443,District - Vidisha (26),Rural,Youth (15-24),206103,116751,89352,41870,9764,5353,34123,13591,20532,27448
23,443,District - Vidisha (26),Urban,All Ages,339618,177606,162012,54353,4469,2325,100893,44444,56449,4132
23,443,District - Vidisha (26),Urban,10-14,38348,19999,18349,6922,544,276,2210,1228,982,54
23,443,District - Vidisha (26),Urban,15-19,35305,19294,16011,5985,438,236,2613,1423,1190,336
23,443,District - Vidisha (26),Urban,20-24,33097,17392,15705,5382,386,202,3470,1452,2018,510
23,443,District - Vidisha (26),Urban,Adolescent (10-19),73653,39293,34360,12907,982,512,4823,2651,2172,390
23,443,District - Vidisha (26),Urban,Youth (15-24),68402,36686,31716,11367,824,438,6083,2875,3208,846
23,444,District - Bhopal (27),Total,All Ages,2371061,1236130,1134931,357516,69429,35966,710371,315816,394555,54950
23,444,District - Bhopal (27),Total,10-14,244474,128465,116009,41407,7809,4001,19075,9874,9201,696
23,444,District - Bhopal (27),Total,15-19,249734,133756,115978,40057,7375,3901,22089,10968,11121,4503
23,444,District - Bhopal (27),Total,20-24,248169,130244,117925,37765,6931,3512,29570,12031,17539,7764
23,444,District - Bhopal (27),Total,Adolescent (10-19),494208,262221,231987,81464,15184,7902,41164,20842,20322,5199
23,444,District - Bhopal (27),Total,Youth (15-24),497903,264000,233903,77822,14306,7413,51659,22999,28660,12267
23,444,District - Bhopal (27),Rural,All Ages,454010,238025,215985,95945,19124,9916,199200,84881,114319,45738
23,444,District - Bhopal (27),Rural,10-14,58409,30797,27612,13116,2358,1199,4625,2233,2392,616
23,444,District - Bhopal (27),Rural,15-19,49741,27176,22565,10521,1982,1127,5881,2455,3426,3947
23,444,District - Bhopal (27),Rural,20-24,41099,22143,18956,8412,1555,798,8861,2945,5916,6693
23,444,District - Bhopal (27),Rural,Adolescent (10-19),108150,57973,50177,23637,4340,2326,10506,4688,5818,4563
23,444,District - Bhopal (27),Rural,Youth (15-24),90840,49319,41521,18933,3537,1925,14742,5400,9342,10640
23,444,District - Bhopal (27),Urban,All Ages,1917051,998105,918946,261571,50305,26050,511171,230935,280236,9212
23,444,District - Bhopal (27),Urban,10-14,186065,97668,88397,28291,5451,2802,14450,7641,6809,80
23,444,District - Bhopal (27),Urban,15-19,199993,106580,93413,29536,5393,2774,16208,8513,7695,556
23,444,District - Bhopal (27),Urban,20-24,207070,108101,98969,29353,5376,2714,20709,9086,11623,1071
23,444,District - Bhopal (27),Urban,Adolescent (10-19),386058,204248,181810,57827,10844,5576,30658,16154,14504,636
23,444,District - Bhopal (27),Urban,Youth (15-24),407063,214681,192382,58889,10769,5488,36917,17599,19318,1627
23,445,District - Sehore (28),Total,All Ages,1311332,683743,627589,271281,145512,74391,530970,214535,316435,103531
23,445,District - Sehore (28),Total,10-14,164334,85403,78931,35968,20612,10287,8560,4071,4489,1109
23,445,District - Sehore (28),Total,15-19,142131,76786,65345,30292,14987,7773,12541,5014,7527,8803
23,445,District - Sehore (28),Total,20-24,122679,66566,56113,24936,12674,6700,20697,6336,14361,15878
23,445,District - Sehore (28),Total,Adolescent (10-19),306465,162189,144276,66260,35599,18060,21101,9085,12016,9912
23,445,District - Sehore (28),Total,Youth (15-24),264810,143352,121458,55228,27661,14473,33238,11350,21888,24681
23,445,District - Sehore (28),Rural,All Ages,1062870,554636,508234,231398,137928,70324,459024,183978,275046,100051
23,445,District - Sehore (28),Rural,10-14,136538,70893,65645,31102,19567,9739,7409,3438,3971,1089
23,445,District - Sehore (28),Rural,15-19,113860,61625,52235,25275,14010,7209,11138,4236,6902,8583
23,445,District - Sehore (28),Rural,20-24,96956,53170,43786,20616,11850,6247,18537,5391,13146,15437
23,445,District - Sehore (28),Rural,Adolescent (10-19),250398,132518,117880,56377,33577,16948,18547,7674,10873,9672
23,445,District - Sehore (28),Rural,Youth (15-24),210816,114795,96021,45891,25860,13456,29675,9627,20048,24020
23,445,District - Sehore (28),Urban,All Ages,248462,129107,119355,39883,7584,4067,71946,30557,41389,3480
23,445,District - Sehore (28),Urban,10-14,27796,14510,13286,4866,1045,548,1151,633,518,20
23,445,District - Sehore (28),Urban,15-19,28271,15161,13110,5017,977,564,1403,778,625,220
23,445,District - Sehore (28),Urban,20-24,25723,13396,12327,4320,824,453,2160,945,1215,441
23,445,District - Sehore (28),Urban,Adolescent (10-19),56067,29671,26396,9883,2022,1112,2554,1411,1143,240
23,445,District - Sehore (28),Urban,Youth (15-24),53994,28557,25437,9337,1801,1017,3563,1723,1840,661
23,446,District - Raisen (29),Total,All Ages,1331597,700358,631239,225891,205006,105627,511377,221265,290112,125867
23,446,District - Raisen (29),Total,10-14,165044,85392,79652,29157,29205,14819,9520,4732,4788,1250
23,446,District - Raisen (29),Total,15-19,137383,76063,61320,23274,20240,10763,10828,5341,5487,10384
23,446,District - Raisen (29),Total,20-24,122457,67838,54619,20580,16643,8707,17939,6539,11400,18318
23,446,District - Raisen (29),Total,Adolescent (10-19),302427,161455,140972,52431,49445,25582,20348,10073,10275,11634
23,446,District - Raisen (29),Total,Youth (15-24),259840,143901,115939,43854,36883,19470,28767,11880,16887,28702
23,446,District - Raisen (29),Rural,All Ages,1028172,539960,488212,183615,190082,97795,420223,181128,239095,120540
23,446,District - Raisen (29),Rural,10-14,129662,66786,62876,23995,26587,13484,7886,3835,4051,1209
23,446,District - Raisen (29),Rural,15-19,105695,58713,46982,18758,18626,9900,8992,4348,4644,10037
23,446,District - Raisen (29),Rural,20-24,91223,51148,40075,16080,15336,8006,14849,5258,9591,17651
23,446,District - Raisen (29),Rural,Adolescent (10-19),235357,125499,109858,42753,45213,23384,16878,8183,8695,11246
23,446,District - Raisen (29),Rural,Youth (15-24),196918,109861,87057,34838,33962,17906,23841,9606,14235,27688
23,446,District - Raisen (29),Urban,All Ages,303425,160398,143027,42276,14924,7832,91154,40137,51017,5327
23,446,District - Raisen (29),Urban,10-14,35382,18606,16776,5162,2618,1335,1634,897,737,41
23,446,District - Raisen (29),Urban,15-19,31688,17350,14338,4516,1614,863,1836,993,843,347
23,446,District - Raisen (29),Urban,20-24,31234,16690,14544,4500,1307,701,3090,1281,1809,667
23,446,District - Raisen (29),Urban,Adolescent (10-19),67070,35956,31114,9678,4232,2198,3470,1890,1580,388
23,446,District - Raisen (29),Urban,Youth (15-24),62922,34040,28882,9016,2921,1564,4926,2274,2652,1014
23,447,District - Betul (30),Total,All Ages,1575362,799236,776126,159296,667018,333166,635593,269453,366140,171105
23,447,District - Betul (30),Total,10-14,178051,89667,88384,16526,88749,44169,12211,6026,6185,2867
23,447,District - Betul (30),Total,15-19,172207,87138,85069,17887,76254,37675,21485,8619,12866,17356
23,447,District - Betul (30),Total,20-24,155491,78304,77187,16829,63241,30919,30300,10525,19775,26726
23,447,District - Betul (30),Total,Adolescent (10-19),350258,176805,173453,34413,165003,81844,33696,14645,19051,20223
23,447,District - Betul (30),Total,Youth (15-24),327698,165442,162256,34716,139495,68594,51785,19144,32641,44082
23,447,District - Betul (30),Rural,All Ages,1266211,640358,625853,107791,638348,318925,566113,240183,325930,166045
23,447,District - Betul (30),Rural,10-14,148898,74929,73969,11725,85076,42513,11346,5578,5768,2834
23,447,District - Betul (30),Rural,15-19,139763,70418,69345,12187,72378,35697,20313,8004,12309,17050
23,447,District - Betul (30),Rural,20-24,121792,61271,60521,10760,59958,29303,28560,9756,18804,26089
23,447,District - Betul (30),Rural,Adolescent (10-19),288661,145347,143314,23912,157454,78210,31659,13582,18077,19884
23,447,District - Betul (30),Rural,Youth (15-24),261555,131689,129866,22947,132336,65000,48873,17760,31113,43139
23,447,District - Betul (30),Urban,All Ages,309151,158878,150273,51505,28670,14241,69480,29270,40210,5060
23,447,District - Betul (30),Urban,10-14,29153,14738,14415,4801,3673,1656,865,448,417,33
23,447,District - Betul (30),Urban,15-19,32444,16720,15724,5700,3876,1978,1172,615,557,306
23,447,District - Betul (30),Urban,20-24,33699,17033,16666,6069,3283,1616,1740,769,971,637
23,447,District - Betul (30),Urban,Adolescent (10-19),61597,31458,30139,10501,7549,3634,2037,1063,974,339
23,447,District - Betul (30),Urban,Youth (15-24),66143,33753,32390,11769,7159,3594,2912,1384,1528,943
23,448,District - Harda (31),Total,All Ages,570465,294838,275627,92865,159678,81446,217915,91031,126884,56157
23,448,District - Harda (31),Total,10-14,67292,34851,32441,11592,22177,11307,4882,2331,2551,900
23,448,District - Harda (31),Total,15-19,60389,31867,28522,10808,16449,8539,6829,2712,4117,5239
23,448,District - Harda (31),Total,20-24,53362,28271,25091,9369,13833,6954,10052,3323,6729,8465
23,448,District - Harda (31),Total,Adolescent (10-19),127681,66718,60963,22400,38626,19846,11711,5043,6668,6139
23,448,District - Harda (31),Total,Youth (15-24),113751,60138,53613,20177,30282,15493,16881,6035,10846,13704
23,448,District - Harda (31),Rural,All Ages,451101,233312,217789,73519,153583,78456,189872,79272,110600,54687
23,448,District - Harda (31),Rural,10-14,54636,28340,26296,9430,21206,10900,4440,2111,2329,889
23,448,District - Harda (31),Rural,15-19,47294,24956,22338,8386,15589,8121,6302,2460,3842,5153
23,448,District - Harda (31),Rural,20-24,41552,22230,19322,7210,13304,6683,9360,3059,6301,8289
23,448,District - Harda (31),Rural,Adolescent (10-19),101930,53296,48634,17816,36795,19021,10742,4571,6171,6042
23,448,District - Harda (31),Rural,Youth (15-24),88846,47186,41660,15596,28893,14804,15662,5519,10143,13442
23,448,District - Harda (31),Urban,All Ages,119364,61526,57838,19346,6095,2990,28043,11759,16284,1470
23,448,District - Harda (31),Urban,10-14,12656,6511,6145,2162,971,407,442,220,222,11
23,448,District - Harda (31),Urban,15-19,13095,6911,6184,2422,860,418,527,252,275,86
23,448,District - Harda (31),Urban,20-24,11810,6041,5769,2159,529,271,692,264,428,176
23,448,District - Harda (31),Urban,Adolescent (10-19),25751,13422,12329,4584,1831,825,969,472,497,97
23,448,District - Harda (31),Urban,Youth (15-24),24905,12952,11953,4581,1389,689,1219,516,703,262
23,449,District - Hoshangabad (32),Total,All Ages,1241350,648725,592625,205007,197300,101041,430706,179526,251180,104560
23,449,District - Hoshangabad (32),Total,10-14,136357,70536,65821,23788,25439,12855,6655,3340,3315,975
23,449,District - Hoshangabad (32),Total,15-19,130215,70402,59813,22784,21957,11600,9730,4428,5302,8081
23,449,District - Hoshangabad (32),Total,20-24,119694,65040,54654,20677,18115,9446,16307,5776,10531,14671
23,449,District - Hoshangabad (32),Total,Adolescent (10-19),266572,140938,125634,46572,47396,24455,16385,7768,8617,9056
23,449,District - Hoshangabad (32),Total,Youth (15-24),249909,135442,114467,43461,40072,21046,26037,10204,15833,22752
23,449,District - Hoshangabad (32),Rural,All Ages,851364,445062,406302,138650,175876,90086,341153,141973,199180,101251
23,449,District - Hoshangabad (32),Rural,10-14,99087,51010,48077,17099,23079,11685,5237,2574,2663,961
23,449,District - Hoshangabad (32),Rural,15-19,90940,49515,41425,15454,19406,10286,8069,3548,4521,7907
23,449,District - Hoshangabad (32),Rural,20-24,79122,43834,35288,13178,15657,8203,13784,4725,9059,14239
23,449,District - Hoshangabad (32),Rural,Adolescent (10-19),190027,100525,89502,32553,42485,21971,13306,6122,7184,8868
23,449,District - Hoshangabad (32),Rural,Youth (15-24),170062,93349,76713,28632,35063,18489,21853,8273,13580,22146
23,449,District - Hoshangabad (32),Urban,All Ages,389986,203663,186323,66357,21424,10955,89553,37553,52000,3309
23,449,District - Hoshangabad (32),Urban,10-14,37270,19526,17744,6689,2360,1170,1418,766,652,14
23,449,District - Hoshangabad (32),Urban,15-19,39275,20887,18388,7330,2551,1314,1661,880,781,174
23,449,District - Hoshangabad (32),Urban,20-24,40572,21206,19366,7499,2458,1243,2523,1051,1472,432
23,449,District - Hoshangabad (32),Urban,Adolescent (10-19),76545,40413,36132,14019,4911,2484,3079,1646,1433,188
23,449,District - Hoshangabad (32),Urban,Youth (15-24),79847,42093,37754,14829,5009,2557,4184,1931,2253,606
23,450,District - Katni (33),Total,All Ages,1292042,662013,630029,155717,317699,159799,501269,201430,299839,83913
23,450,District - Katni (33),Total,10-14,151602,77350,74252,19444,40035,19843,8337,4027,4310,834
23,450,District - Katni (33),Total,15-19,130145,68112,62033,16938,31319,16114,11435,4594,6841,5393
23,450,District - Katni (33),Total,20-24,114601,59445,55156,14340,25844,12844,19297,5651,13646,11125
23,450,District - Katni (33),Total,Adolescent (10-19),281747,145462,136285,36382,71354,35957,19772,8621,11151,6227
23,450,District - Katni (33),Total,Youth (15-24),244746,127557,117189,31278,57163,28958,30732,10245,20487,16518
23,450,District - Katni (33),Rural,All Ages,1028499,525188,503311,121924,296037,148907,435547,173348,262199,82452
23,450,District - Katni (33),Rural,10-14,124981,63271,61710,15496,37520,18572,7063,3341,3722,823
23,450,District - Katni (33),Rural,15-19,104101,54346,49755,12916,28965,14893,9838,3794,6044,5308
23,450,District - Katni (33),Rural,20-24,88524,46179,42345,10756,23713,11812,17140,4766,12374,10955
23,450,District - Katni (33),Rural,Adolescent (10-19),229082,117617,111465,28412,66485,33465,16901,7135,9766,6131
23,450,District - Katni (33),Rural,Youth (15-24),192625,100525,92100,23672,52678,26705,26978,8560,18418,16263
23,450,District - Katni (33),Urban,All Ages,263543,136825,126718,33793,21662,10892,65722,28082,37640,1461
23,450,District - Katni (33),Urban,10-14,26621,14079,12542,3948,2515,1271,1274,686,588,11
23,450,District - Katni (33),Urban,15-19,26044,13766,12278,4022,2354,1221,1597,800,797,85
23,450,District - Katni (33),Urban,20-24,26077,13266,12811,3584,2131,1032,2157,885,1272,170
23,450,District - Katni (33),Urban,Adolescent (10-19),52665,27845,24820,7970,4869,2492,2871,1486,1385,96
23,450,District - Katni (33),Urban,Youth (15-24),52121,27032,25089,7606,4485,2253,3754,1685,2069,255
23,451,District - Jabalpur (34),Total,All Ages,2463289,1277278,1186011,348029,375231,189915,706821,296971,409850,144856
23,451,District - Jabalpur (34),Total,10-14,244150,126478,117672,37162,43429,21718,11314,5850,5464,1107
23,451,District - Jabalpur (34),Total,15-19,247601,132565,115036,37392,39322,20933,15808,7817,7991,10613
23,451,District - Jabalpur (34),Total,20-24,247013,131524,115489,36411,34483,17871,23399,9367,14032,19228
23,451,District - Jabalpur (34),Total,Adolescent (10-19),491751,259043,232708,74554,82751,42651,27122,13667,13455,11720
23,451,District - Jabalpur (34),Total,Youth (15-24),494614,264089,230525,73803,73805,38804,39207,17184,22023,29841
23,451,District - Jabalpur (34),Rural,All Ages,1023255,527031,496224,138878,294787,148536,385431,155686,229745,132246
23,451,District - Jabalpur (34),Rural,10-14,113887,58232,55655,16135,35035,17485,4896,2339,2557,1034
23,451,District - Jabalpur (34),Rural,15-19,105305,56731,48574,14673,30389,16147,7337,3192,4145,9871
23,451,District - Jabalpur (34),Rural,20-24,94038,50596,43442,13068,25473,13151,12675,4178,8497,17730
23,451,District - Jabalpur (34),Rural,Adolescent (10-19),219192,114963,104229,30808,65424,33632,12233,5531,6702,10905
23,451,District - Jabalpur (34),Rural,Youth (15-24),199343,107327,92016,27741,55862,29298,20012,7370,12642,27601
23,451,District - Jabalpur (34),Urban,All Ages,1440034,750247,689787,209151,80444,41379,321390,141285,180105,12610
23,451,District - Jabalpur (34),Urban,10-14,130263,68246,62017,21027,8394,4233,6418,3511,2907,73
23,451,District - Jabalpur (34),Urban,15-19,142296,75834,66462,22719,8933,4786,8471,4625,3846,742
23,451,District - Jabalpur (34),Urban,20-24,152975,80928,72047,23343,9010,4720,10724,5189,5535,1498
23,451,District - Jabalpur (34),Urban,Adolescent (10-19),272559,144080,128479,43746,17327,9019,14889,8136,6753,815
23,451,District - Jabalpur (34),Urban,Youth (15-24),295271,156762,138509,46062,17943,9506,19195,9814,9381,2240
23,452,District - Narsimhapur (35),Total,All Ages,1091854,568810,523044,184155,145879,74127,373069,155319,217750,165445
23,452,District - Narsimhapur (35),Total,10-14,115246,59995,55251,21098,16998,8631,4115,1995,2120,1170
23,452,District - Narsimhapur (35),Total,15-19,106238,58419,47819,18617,14993,7998,7007,3268,3739,11122
23,452,District - Narsimhapur (35),Total,20-24,100999,54160,46839,17703,13556,6912,13802,4675,9127,22425
23,452,District - Narsimhapur (35),Total,Adolescent (10-19),221484,118414,103070,39715,31991,16629,11122,5263,5859,12292
23,452,District - Narsimhapur (35),Total,Youth (15-24),207237,112579,94658,36320,28549,14910,20809,7943,12866,33547
23,452,District - Narsimhapur (35),Rural,All Ages,888314,462699,425615,153789,135056,68576,326227,134965,191262,160366
23,452,District - Narsimhapur (35),Rural,10-14,95175,49349,45826,17664,15700,7930,3501,1660,1841,1146
23,452,District - Narsimhapur (35),Rural,15-19,86370,47751,38619,15392,13709,7293,6069,2742,3327,10809
23,452,District - Narsimhapur (35),Rural,20-24,81245,43817,37428,14536,12534,6371,12294,4032,8262,21805
23,452,District - Narsimhapur (35),Rural,Adolescent (10-19),181545,97100,84445,33056,29409,15223,9570,4402,5168,11955
23,452,District - Narsimhapur (35),Rural,Youth (15-24),167615,91568,76047,29928,26243,13664,18363,6774,11589,32614
23,452,District - Narsimhapur (35),Urban,All Ages,203540,106111,97429,30366,10823,5551,46842,20354,26488,5079
23,452,District - Narsimhapur (35),Urban,10-14,20071,10646,9425,3434,1298,701,614,335,279,24
23,452,District - Narsimhapur (35),Urban,15-19,19868,10668,9200,3225,1284,705,938,526,412,313
23,452,District - Narsimhapur (35),Urban,20-24,19754,10343,9411,3167,1022,541,1508,643,865,620
23,452,District - Narsimhapur (35),Urban,Adolescent (10-19),39939,21314,18625,6659,2582,1406,1552,861,691,337
23,452,District - Narsimhapur (35),Urban,Youth (15-24),39622,21011,18611,6392,2306,1246,2446,1169,1277,933
23,453,District - Dindori (36),Total,All Ages,704524,351913,352611,39782,455789,225699,325810,129154,196656,95422
23,453,District - Dindori (36),Total,10-14,76910,38286,38624,4386,50969,25079,4689,2187,2502,1264
23,453,District - Dindori (36),Total,15-19,65906,33541,32365,3794,43161,21750,7582,2786,4796,6692
23,453,District - Dindori (36),Total,20-24,62273,30428,31845,3799,39326,18851,14850,4239,10611,13207
23,453,District - Dindori (36),Total,Adolescent (10-19),142816,71827,70989,8180,94130,46829,12271,4973,7298,7956
23,453,District - Dindori (36),Total,Youth (15-24),128179,63969,64210,7593,82487,40601,22432,7025,15407,19899
23,453,District - Dindori (36),Rural,All Ages,672206,335393,336813,37813,448420,221979,317364,125861,191503,94650
23,453,District - Dindori (36),Rural,10-14,73663,36601,37062,4179,50097,24647,4550,2125,2425,1259
23,453,District - Dindori (36),Rural,15-19,62728,31894,30834,3604,42278,21246,7393,2693,4700,6626
23,453,District - Dindori (36),Rural,20-24,59051,28802,30249,3584,38574,18471,14524,4123,10401,13096
23,453,District - Dindori (36),Rural,Adolescent (10-19),136391,68495,67896,7783,92375,45893,11943,4818,7125,7885
23,453,District - Dindori (36),Rural,Youth (15-24),121779,60696,61083,7188,80852,39717,21917,6816,15101,19722
23,453,District - Dindori (36),Urban,All Ages,32318,16520,15798,1969,7369,3720,8446,3293,5153,772
23,453,District - Dindori (36),Urban,10-14,3247,1685,1562,207,872,432,139,62,77,5
23,453,District - Dindori (36),Urban,15-19,3178,1647,1531,190,883,504,189,93,96,66
23,453,District - Dindori (36),Urban,20-24,3222,1626,1596,215,752,380,326,116,210,111
23,453,District - Dindori (36),Urban,Adolescent (10-19),6425,3332,3093,397,1755,936,328,155,173,71
23,453,District - Dindori (36),Urban,Youth (15-24),6400,3273,3127,405,1635,884,515,209,306,177
23,454,District - Mandla (37),Total,All Ages,1054905,525272,529633,48425,610528,299918,449943,177239,272704,138833
23,454,District - Mandla (37),Total,10-14,113499,56720,56779,5014,68218,33654,5394,2494,2900,1259
23,454,District - Mandla (37),Total,15-19,104957,53435,51522,4911,61267,30780,9445,3418,6027,10089
23,454,District - Mandla (37),Total,20-24,96245,48205,48040,4839,54203,26618,18362,5355,13007,19085
23,454,District - Mandla (37),Total,Adolescent (10-19),218456,110155,108301,9925,129485,64434,14839,5912,8927,11348
23,454,District - Mandla (37),Total,Youth (15-24),201202,101640,99562,9750,115470,57398,27807,8773,19034,29174
23,454,District - Mandla (37),Rural,All Ages,924716,459151,465565,36205,590435,290016,420991,165398,255593,134526
23,454,District - Mandla (37),Rural,10-14,101191,50359,50832,3870,65881,32477,5141,2354,2787,1233
23,454,District - Mandla (37),Rural,15-19,91613,46563,45050,3668,58717,29483,9047,3239,5808,9831
23,454,District - Mandla (37),Rural,20-24,82785,41426,41359,3420,52096,25547,17647,5059,12588,18569
23,454,District - Mandla (37),Rural,Adolescent (10-19),192804,96922,95882,7538,124598,61960,14188,5593,8595,11064
23,454,District - Mandla (37),Rural,Youth (15-24),174398,87989,86409,7088,110813,55030,26694,8298,18396,28400
23,454,District - Mandla (37),Urban,All Ages,130189,66121,64068,12220,20093,9902,28952,11841,17111,4307
23,454,District - Mandla (37),Urban,10-14,12308,6361,5947,1144,2337,1177,253,140,113,26
23,454,District - Mandla (37),Urban,15-19,13344,6872,6472,1243,2550,1297,398,179,219,258
23,454,District - Mandla (37),Urban,20-24,13460,6779,6681,1419,2107,1071,715,296,419,516
23,454,District - Mandla (37),Urban,Adolescent (10-19),25652,13233,12419,2387,4887,2474,651,319,332,284
23,454,District - Mandla (37),Urban,Youth (15-24),26804,13651,13153,2662,4657,2368,1113,475,638,774
23,455,District - Chhindwara (38),Total,All Ages,2090922,1064468,1026454,232244,769778,385785,796724,333174,463550,233522
23,455,District - Chhindwara (38),Total,10-14,228118,115993,112125,23948,96041,48405,11386,5518,5868,2370
23,455,District - Chhindwara (38),Total,15-19,226915,117175,109740,25417,87188,44319,20340,8324,12016,20123
23,455,District - Chhindwara (38),Total,20-24,208854,108526,100328,25199,73735,37435,33649,12242,21407,34472
23,455,District - Chhindwara (38),Total,Adolescent (10-19),455033,233168,221865,49365,183229,92724,31726,13842,17884,22493
23,455,District - Chhindwara (38),Total,Youth (15-24),435769,225701,210068,50616,160923,81754,53989,20566,33423,54595
23,455,District - Chhindwara (38),Rural,All Ages,1585739,806199,779540,158112,713572,357724,677901,283766,394135,216122
23,455,District - Chhindwara (38),Rural,10-14,180032,91352,88680,16794,89246,45024,10229,4880,5349,2268
23,455,District - Chhindwara (38),Rural,15-19,176404,90963,85441,17813,80276,40781,18642,7409,11233,19131
23,455,District - Chhindwara (38),Rural,20-24,156159,81648,74511,16941,67490,34272,30827,10969,19858,32572
23,455,District - Chhindwara (38),Rural,Adolescent (10-19),356436,182315,174121,34607,169522,85805,28871,12289,16582,21399
23,455,District - Chhindwara (38),Rural,Youth (15-24),332563,172611,159952,34754,147766,75053,49469,18378,31091,51703
23,455,District - Chhindwara (38),Urban,All Ages,505183,258269,246914,74132,56206,28061,118823,49408,69415,17400
23,455,District - Chhindwara (38),Urban,10-14,48086,24641,23445,7154,6795,3381,1157,638,519,102
23,455,District - Chhindwara (38),Urban,15-19,50511,26212,24299,7604,6912,3538,1698,915,783,992
23,455,District - Chhindwara (38),Urban,20-24,52695,26878,25817,8258,6245,3163,2822,1273,1549,1900
23,455,District - Chhindwara (38),Urban,Adolescent (10-19),98597,50853,47744,14758,13707,6919,2855,1553,1302,1094
23,455,District - Chhindwara (38),Urban,Youth (15-24),103206,53090,50116,15862,13157,6701,4520,2188,2332,2892
23,456,District - Seoni (39),Total,All Ages,1379131,695879,683252,130797,519856,258121,514937,210538,304399,164802
23,456,District - Seoni (39),Total,10-14,155071,77545,77526,14032,63595,31299,4630,2395,2235,1218
23,456,District - Seoni (39),Total,15-19,148222,76145,72077,14035,56907,28852,8432,3765,4667,12272
23,456,District - Seoni (39),Total,20-24,130909,67733,63176,12689,47098,23969,16660,5745,10915,23174
23,456,District - Seoni (39),Total,Adolescent (10-19),303293,153690,149603,28067,120502,60151,13062,6160,6902,13490
23,456,District - Seoni (39),Total,Youth (15-24),279131,143878,135253,26724,104005,52821,25092,9510,15582,35446
23,456,District - Seoni (39),Rural,All Ages,1215241,612314,602927,112436,505730,251239,480873,196209,284664,162730
23,456,District - Seoni (39),Rural,10-14,139044,69289,69755,12156,61775,30525,4328,2230,2098,1210
23,456,District - Seoni (39),Rural,15-19,131416,67414,64002,12109,55141,27992,8029,3560,4469,12136
23,456,District - Seoni (39),Rural,20-24,114048,59313,54735,10699,45604,23261,16001,5444,10557,22914
23,456,District - Seoni (39),Rural,Adolescent (10-19),270460,136703,133757,24265,116916,58517,12357,5790,6567,13346
23,456,District - Seoni (39),Rural,Youth (15-24),245464,126727,118737,22808,100745,51253,24030,9004,15026,35050
23,456,District - Seoni (39),Urban,All Ages,163890,83565,80325,18361,14126,6882,34064,14329,19735,2072
23,456,District - Seoni (39),Urban,10-14,16027,8256,7771,1876,1820,774,302,165,137,8
23,456,District - Seoni (39),Urban,15-19,16806,8731,8075,1926,1766,860,403,205,198,136
23,456,District - Seoni (39),Urban,20-24,16861,8420,8441,1990,1494,708,659,301,358,260
23,456,District - Seoni (39),Urban,Adolescent (10-19),32833,16987,15846,3802,3586,1634,705,370,335,144
23,456,District - Seoni (39),Urban,Youth (15-24),33667,17151,16516,3916,3260,1568,1062,506,556,396
23,457,District - Balaghat (40),Total,All Ages,1701698,842178,859520,125426,383026,186979,554075,215710,338365,199662
23,457,District - Balaghat (40),Total,10-14,178928,90349,88579,12083,44528,22236,5872,2930,2942,1500
23,457,District - Balaghat (40),Total,15-19,178320,88334,89986,12432,40403,19702,9039,3783,5256,13376
23,457,District - Balaghat (40),Total,20-24,161929,79365,82564,12154,35694,17342,14750,5362,9388,26692
23,457,District - Balaghat (40),Total,Adolescent (10-19),357248,178683,178565,24515,84931,41938,14911,6713,8198,14876
23,457,District - Balaghat (40),Total,Youth (15-24),340249,167699,172550,24586,76097,37044,23789,9145,14644,40068
23,457,District - Balaghat (40),Rural,All Ages,1456882,719794,737088,99608,346461,169216,496664,192705,303959,192997
23,457,District - Balaghat (40),Rural,10-14,155314,78216,77098,9672,40314,20107,5143,2518,2625,1461
23,457,District - Balaghat (40),Rural,15-19,153275,75749,77526,9769,36061,17623,7985,3323,4662,12946
23,457,District - Balaghat (40),Rural,20-24,137324,67271,70053,9383,32025,15561,13237,4723,8514,25846
23,457,District - Balaghat (40),Rural,Adolescent (10-19),308589,153965,154624,19441,76375,37730,13128,5841,7287,14407
23,457,District - Balaghat (40),Rural,Youth (15-24),290599,143020,147579,19152,68086,33184,21222,8046,13176,38792
23,457,District - Balaghat (40),Urban,All Ages,244816,122384,122432,25818,36565,17763,57411,23005,34406,6665
23,457,District - Balaghat (40),Urban,10-14,23614,12133,11481,2411,4214,2129,729,412,317,39
23,457,District - Balaghat (40),Urban,15-19,25045,12585,12460,2663,4342,2079,1054,460,594,430
23,457,District - Balaghat (40),Urban,20-24,24605,12094,12511,2771,3669,1781,1513,639,874,846
23,457,District - Balaghat (40),Urban,Adolescent (10-19),48659,24718,23941,5074,8556,4208,1783,872,911,469
23,457,District - Balaghat (40),Urban,Youth (15-24),49650,24679,24971,5434,8011,3860,2567,1099,1468,1276
23,458,District - Guna (41),Total,All Ages,1241519,649362,592157,193115,190819,98206,587539,248825,338714,78934
23,458,District - Guna (41),Total,10-14,157522,82506,75016,26016,25985,13456,14374,6433,7941,1052
23,458,District - Guna (41),Total,15-19,124408,66466,57942,19645,17505,8884,21567,7533,14034,6838
23,458,District - Guna (41),Total,20-24,112185,58632,53553,17226,15483,7739,34104,9814,24290,12220
23,458,District - Guna (41),Total,Adolescent (10-19),281930,148972,132958,45661,43490,22340,35941,13966,21975,7890
23,458,District - Guna (41),Total,Youth (15-24),236593,125098,111495,36871,32988,16623,55671,17347,38324,19058
23,458,District - Guna (41),Rural,All Ages,928844,486127,442717,142818,181678,93432,481674,204634,277040,75317
23,458,District - Guna (41),Rural,10-14,121248,63361,57887,19593,24627,12729,11849,5204,6645,1017
23,458,District - Guna (41),Rural,15-19,91302,48766,42536,13873,16384,8280,18363,6122,12241,6576
23,458,District - Guna (41),Rural,20-24,81332,42813,38519,12097,14759,7370,29100,8228,20872,11749
23,458,District - Guna (41),Rural,Adolescent (10-19),212550,112127,100423,33466,41011,21009,30212,11326,18886,7593
23,458,District - Guna (41),Rural,Youth (15-24),172634,91579,81055,25970,31143,15650,47463,14350,33113,18325
23,458,District - Guna (41),Urban,All Ages,312675,163235,149440,50297,9141,4774,105865,44191,61674,3617
23,458,District - Guna (41),Urban,10-14,36274,19145,17129,6423,1358,727,2525,1229,1296,35
23,458,District - Guna (41),Urban,15-19,33106,17700,15406,5772,1121,604,3204,1411,1793,262
23,458,District - Guna (41),Urban,20-24,30853,15819,15034,5129,724,369,5004,1586,3418,471
23,458,District - Guna (41),Urban,Adolescent (10-19),69380,36845,32535,12195,2479,1331,5729,2640,3089,297
23,458,District - Guna (41),Urban,Youth (15-24),63959,33519,30440,10901,1845,973,8208,2997,5211,733
23,459,District - Ashoknagar (42),Total,All Ages,845071,443837,401234,175764,82072,42447,375962,153533,222429,72632
23,459,District - Ashoknagar (42),Total,10-14,105949,55486,50463,23342,10579,5664,7645,3626,4019,814
23,459,District - Ashoknagar (42),Total,15-19,81879,44978,36901,17174,6130,3394,10358,4201,6157,6057
23,459,District - Ashoknagar (42),Total,20-24,75819,39969,35850,15522,6385,3058,19948,5473,14475,11088
23,459,District - Ashoknagar (42),Total,Adolescent (10-19),187828,100464,87364,40516,16709,9058,18003,7827,10176,6871
23,459,District - Ashoknagar (42),Total,Youth (15-24),157698,84947,72751,32696,12515,6452,30306,9674,20632,17145
23,459,District - Ashoknagar (42),Rural,All Ages,691387,363411,327976,149988,77631,40140,325073,132685,192388,70944
23,459,District - Ashoknagar (42),Rural,10-14,87828,45836,41992,19863,9969,5319,6467,3060,3407,802
23,459,District - Ashoknagar (42),Rural,15-19,66067,36417,29650,14197,5681,3150,8967,3528,5439,5966
23,459,District - Ashoknagar (42),Rural,20-24,61008,32353,28655,13074,6032,2875,17759,4782,12977,10921
23,459,District - Ashoknagar (42),Rural,Adolescent (10-19),153895,82253,71642,34060,15650,8469,15434,6588,8846,6768
23,459,District - Ashoknagar (42),Rural,Youth (15-24),127075,68770,58305,27271,11713,6025,26726,8310,18416,16887
23,459,District - Ashoknagar (42),Urban,All Ages,153684,80426,73258,25776,4441,2307,50889,20848,30041,1688
23,459,District - Ashoknagar (42),Urban,10-14,18121,9650,8471,3479,610,345,1178,566,612,12
23,459,District - Ashoknagar (42),Urban,15-19,15812,8561,7251,2977,449,244,1391,673,718,91
23,459,District - Ashoknagar (42),Urban,20-24,14811,7616,7195,2448,353,183,2189,691,1498,167
23,459,District - Ashoknagar (42),Urban,Adolescent (10-19),33933,18211,15722,6456,1059,589,2569,1239,1330,103
23,459,District - Ashoknagar (42),Urban,Youth (15-24),30623,16177,14446,5425,802,427,3580,1364,2216,258
23,460,District - Shahdol (43),Total,All Ages,1066063,540021,526042,89733,476008,236947,461869,191260,270609,83059
23,460,District - Shahdol (43),Total,10-14,125014,62836,62178,11044,58521,28921,6783,3309,3474,822
23,460,District - Shahdol (43),Total,15-19,102983,52905,50078,9051,43358,21752,10493,3971,6522,5471
23,460,District - Shahdol (43),Total,20-24,102082,51554,50528,8860,43700,21260,21274,6377,14897,11908
23,460,District - Shahdol (43),Total,Adolescent (10-19),227997,115741,112256,20095,101879,50673,17276,7280,9996,6293
23,460,District - Shahdol (43),Total,Youth (15-24),205065,104459,100606,17911,87058,43012,31767,10348,21419,17379
23,460,District - Shahdol (43),Rural,All Ages,846463,426583,419880,69764,447402,222807,403762,167552,236210,80275
23,460,District - Shahdol (43),Rural,10-14,101776,50851,50925,8673,54855,27215,5882,2845,3037,803
23,460,District - Shahdol (43),Rural,15-19,79386,40670,38716,6700,39899,20027,9248,3401,5847,5324
23,460,District - Shahdol (43),Rural,20-24,78973,39580,39393,6644,40874,19837,19382,5649,13733,11547
23,460,District - Shahdol (43),Rural,Adolescent (10-19),181162,91521,89641,15373,94754,47242,15130,6246,8884,6127
23,460,District - Shahdol (43),Rural,Youth (15-24),158359,80250,78109,13344,80773,39864,28630,9050,19580,16871
23,460,District - Shahdol (43),Urban,All Ages,219600,113438,106162,19969,28606,14140,58107,23708,34399,2784
23,460,District - Shahdol (43),Urban,10-14,23238,11985,11253,2371,3666,1706,901,464,437,19
23,460,District - Shahdol (43),Urban,15-19,23597,12235,11362,2351,3459,1725,1245,570,675,147
23,460,District - Shahdol (43),Urban,20-24,23109,11974,11135,2216,2826,1423,1892,728,1164,361
23,460,District - Shahdol (43),Urban,Adolescent (10-19),46835,24220,22615,4722,7125,3431,2146,1034,1112,166
23,460,District - Shahdol (43),Urban,Youth (15-24),46706,24209,22497,4567,6285,3148,3137,1298,1839,508
23,461,District - Anuppur (44),Total,All Ages,749237,379114,370123,74385,358543,177977,312642,124994,187648,58550
23,461,District - Anuppur (44),Total,10-14,84885,42597,42288,9173,40794,20107,3806,1847,1959,768
23,461,District - Anuppur (44),Total,15-19,74057,38261,35796,7813,32985,16658,5986,2382,3604,4153
23,461,District - Anuppur (44),Total,20-24,72692,36654,36038,7582,32712,16036,11931,3584,8347,8783
23,461,District - Anuppur (44),Total,Adolescent (10-19),158942,80858,78084,16986,73779,36765,9792,4229,5563,4921
23,461,District - Anuppur (44),Total,Youth (15-24),146749,74915,71834,15395,65697,32694,17917,5966,11951,12936
23,461,District - Anuppur (44),Rural,All Ages,543996,272030,271966,49977,317627,157363,253103,101377,151726,56963
23,461,District - Anuppur (44),Rural,10-14,62094,30634,31460,6132,35756,17536,3054,1476,1578,751
23,461,District - Anuppur (44),Rural,15-19,49914,25593,24321,4817,28289,14220,4892,1908,2984,4050
23,461,District - Anuppur (44),Rural,20-24,50132,24822,25310,4800,28730,14038,10191,3016,7175,8572
23,461,District - Anuppur (44),Rural,Adolescent (10-19),112008,56227,55781,10949,64045,31756,7946,3384,4562,4801
23,461,District - Anuppur (44),Rural,Youth (15-24),100046,50415,49631,9617,57019,28258,15083,4924,10159,12622
23,461,District - Anuppur (44),Urban,All Ages,205241,107084,98157,24408,40916,20614,59539,23617,35922,1587
23,461,District - Anuppur (44),Urban,10-14,22791,11963,10828,3041,5038,2571,752,371,381,17
23,461,District - Anuppur (44),Urban,15-19,24143,12668,11475,2996,4696,2438,1094,474,620,103
23,461,District - Anuppur (44),Urban,20-24,22560,11832,10728,2782,3982,1998,1740,568,1172,211
23,461,District - Anuppur (44),Urban,Adolescent (10-19),46934,24631,22303,6037,9734,5009,1846,845,1001,120
23,461,District - Anuppur (44),Urban,Youth (15-24),46703,24500,22203,5778,8678,4436,2834,1042,1792,314
23,462,District - Sidhi (45),Total,All Ages,1127033,575912,551121,130202,313304,159192,526248,222882,303366,128978
23,462,District - Sidhi (45),Total,10-14,146436,74342,72094,18692,42127,21244,8740,4110,4630,1424
23,462,District - Sidhi (45),Total,15-19,115706,60567,55139,13664,30276,15821,11977,4440,7537,9095
23,462,District - Sidhi (45),Total,20-24,97863,50330,47533,10999,25480,12669,22671,6090,16581,18065
23,462,District - Sidhi (45),Total,Adolescent (10-19),262142,134909,127233,32356,72403,37065,20717,8550,12167,10519
23,462,District - Sidhi (45),Total,Youth (15-24),213569,110897,102672,24663,55756,28490,34648,10530,24118,27160
23,462,District - Sidhi (45),Rural,All Ages,1033912,527378,506534,120372,302717,153570,496157,210229,285928,123909
23,462,District - Sidhi (45),Rural,10-14,134834,68134,66700,17208,40615,20373,8178,3837,4341,1370
23,462,District - Sidhi (45),Rural,15-19,105143,54998,50145,12421,29143,15176,11330,4170,7160,8701
23,462,District - Sidhi (45),Rural,20-24,89093,45819,43274,10099,24658,12265,21709,5800,15909,17383
23,462,District - Sidhi (45),Rural,Adolescent (10-19),239977,123132,116845,29629,69758,35549,19508,8007,11501,10071
23,462,District - Sidhi (45),Rural,Youth (15-24),194236,100817,93419,22520,53801,27441,33039,9970,23069,26084
23,462,District - Sidhi (45),Urban,All Ages,93121,48534,44587,9830,10587,5622,30091,12653,17438,5069
23,462,District - Sidhi (45),Urban,10-14,11602,6208,5394,1484,1512,871,562,273,289,54
23,462,District - Sidhi (45),Urban,15-19,10563,5569,4994,1243,1133,645,647,270,377,394
23,462,District - Sidhi (45),Urban,20-24,8770,4511,4259,900,822,404,962,290,672,682
23,462,District - Sidhi (45),Urban,Adolescent (10-19),22165,11777,10388,2727,2645,1516,1209,543,666,448
23,462,District - Sidhi (45),Urban,Youth (15-24),19333,10080,9253,2143,1955,1049,1609,560,1049,1076
23,463,District - Singrauli (46),Total,All Ages,1178273,613637,564636,150664,383994,196133,593219,253714,339505,127134
23,463,District - Singrauli (46),Total,10-14,159862,81670,78192,21207,53578,27111,15334,6734,8600,1825
23,463,District - Singrauli (46),Total,15-19,119914,63731,56183,15517,35435,18367,20317,6815,13502,10243
23,463,District - Singrauli (46),Total,20-24,106329,56703,49626,13697,31890,16292,33430,9254,24176,19939
23,463,District - Singrauli (46),Total,Adolescent (10-19),279776,145401,134375,36724,89013,45478,35651,13549,22102,12068
23,463,District - Singrauli (46),Total,Youth (15-24),226243,120434,105809,29214,67325,34659,53747,16069,37678,30182
23,463,District - Singrauli (46),Rural,All Ages,951487,493324,458163,120460,361302,184364,514423,220809,293614,123687
23,463,District - Singrauli (46),Rural,10-14,131784,67001,64783,17158,50608,25569,12906,5637,7269,1773
23,463,District - Singrauli (46),Rural,15-19,93206,49223,43983,11724,33163,17123,17873,5807,12066,10019
23,463,District - Singrauli (46),Rural,20-24,84132,44937,39195,10708,29964,15327,30036,8198,21838,19525
23,463,District - Singrauli (46),Rural,Adolescent (10-19),224990,116224,108766,28882,83771,42692,30779,11444,19335,11792
23,463,District - Singrauli (46),Rural,Youth (15-24),177338,94160,83178,22432,63127,32450,47909,14005,33904,29544
23,463,District - Singrauli (46),Urban,All Ages,226786,120313,106473,30204,22692,11769,78796,32905,45891,3447
23,463,District - Singrauli (46),Urban,10-14,28078,14669,13409,4049,2970,1542,2428,1097,1331,52
23,463,District - Singrauli (46),Urban,15-19,26708,14508,12200,3793,2272,1244,2444,1008,1436,224
23,463,District - Singrauli (46),Urban,20-24,22197,11766,10431,2989,1926,965,3394,1056,2338,414
23,463,District - Singrauli (46),Urban,Adolescent (10-19),54786,29177,25609,7842,5242,2786,4872,2105,2767,276
23,463,District - Singrauli (46),Urban,Youth (15-24),48905,26274,22631,6782,4198,2209,5838,2064,3774,638
23,464,District - Jhabua (47),Total,All Ages,1025048,515023,510025,17427,891818,446359,672967,300441,372526,48469
23,464,District - Jhabua (47),Total,10-14,139037,71763,67274,2121,125316,64513,40957,17858,23099,2238
23,464,District - Jhabua (47),Total,15-19,93113,45640,47473,1736,80850,39174,40847,14183,26664,8015
23,464,District - Jhabua (47),Total,20-24,78040,37982,40058,1616,65952,31725,43779,15578,28201,9172
23,464,District - Jhabua (47),Total,Adolescent (10-19),232150,117403,114747,3857,206166,103687,81804,32041,49763,10253
23,464,District - Jhabua (47),Total,Youth (15-24),171153,83622,87531,3352,146802,70899,84626,29761,54865,17187
23,464,District - Jhabua (47),Rural,All Ages,933065,467468,465597,11397,861498,430617,646834,289487,357347,47581
23,464,District - Jhabua (47),Rural,10-14,128736,66093,62643,1400,121093,62124,40283,17536,22747,2218
23,464,District - Jhabua (47),Rural,15-19,83797,40686,43111,1083,77223,37225,40112,13908,26204,7930
23,464,District - Jhabua (47),Rural,20-24,69417,33606,35811,1019,63013,30254,42695,15207,27488,9053
23,464,District - Jhabua (47),Rural,Adolescent (10-19),212533,106779,105754,2483,198316,99349,80395,31444,48951,10148
23,464,District - Jhabua (47),Rural,Youth (15-24),153214,74292,78922,2102,140236,67479,82807,29115,53692,16983
23,464,District - Jhabua (47),Urban,All Ages,91983,47555,44428,6030,30320,15742,26133,10954,15179,888
23,464,District - Jhabua (47),Urban,10-14,10301,5670,4631,721,4223,2389,674,322,352,20
23,464,District - Jhabua (47),Urban,15-19,9316,4954,4362,653,3627,1949,735,275,460,85
23,464,District - Jhabua (47),Urban,20-24,8623,4376,4247,597,2939,1471,1084,371,713,119
23,464,District - Jhabua (47),Urban,Adolescent (10-19),19617,10624,8993,1374,7850,4338,1409,597,812,105
23,464,District - Jhabua (47),Urban,Youth (15-24),17939,9330,8609,1250,6566,3420,1819,646,1173,204
23,465,District - Alirajpur (48),Total,All Ages,728999,362542,366457,26877,648638,321842,519245,241637,277608,26185
23,465,District - Alirajpur (48),Total,10-14,102996,52357,50639,3803,93648,47529,37648,18326,19322,1470
23,465,District - Alirajpur (48),Total,15-19,72226,34626,37600,2550,64635,30834,38497,15479,23018,4797
23,465,District - Alirajpur (48),Total,20-24,52304,25106,27198,1951,45579,21756,34620,13995,20625,4489
23,465,District - Alirajpur (48),Total,Adolescent (10-19),175222,86983,88239,6353,158283,78363,76145,33805,42340,6267
23,465,District - Alirajpur (48),Total,Youth (15-24),124530,59732,64798,4501,110214,52590,73117,29474,43643,9286
23,465,District - Alirajpur (48),Rural,All Ages,671925,333593,338332,23503,627835,311307,501113,234019,267094,25866
23,465,District - Alirajpur (48),Rural,10-14,96316,48840,47476,3357,90657,45923,37018,18026,18992,1460
23,465,District - Alirajpur (48),Rural,15-19,66208,31522,34686,2173,62103,29493,37858,15228,22630,4754
23,465,District - Alirajpur (48),Rural,20-24,47106,22522,24584,1658,43739,20839,33827,13693,20134,4442
23,465,District - Alirajpur (48),Rural,Adolescent (10-19),162524,80362,82162,5530,152760,75416,74876,33254,41622,6214
23,465,District - Alirajpur (48),Rural,Youth (15-24),113314,54044,59270,3831,105842,50332,71685,28921,42764,9196
23,465,District - Alirajpur (48),Urban,All Ages,57074,28949,28125,3374,20803,10535,18132,7618,10514,319
23,465,District - Alirajpur (48),Urban,10-14,6680,3517,3163,446,2991,1606,630,300,330,10
23,465,District - Alirajpur (48),Urban,15-19,6018,3104,2914,377,2532,1341,639,251,388,43
23,465,District - Alirajpur (48),Urban,20-24,5198,2584,2614,293,1840,917,793,302,491,47
23,465,District - Alirajpur (48),Urban,Adolescent (10-19),12698,6621,6077,823,5523,2947,1269,551,718,53
23,465,District - Alirajpur (48),Urban,Youth (15-24),11216,5688,5528,670,4372,2258,1432,553,879,90
23,466,District - Khandwa (East Nimar) (49),Total,All Ages,1310061,674329,635732,156601,459122,234867,578446,242070,336376,221197
23,466,District - Khandwa (East Nimar) (49),Total,10-14,156794,80981,75813,18730,63068,32617,17921,8603,9318,4874
23,466,District - Khandwa (East Nimar) (49),Total,15-19,133301,71090,62211,16774,45486,24295,23511,9801,13710,24600
23,466,District - Khandwa (East Nimar) (49),Total,20-24,117160,62699,54461,14773,37189,19119,30567,10789,19778,32489
23,466,District - Khandwa (East Nimar) (49),Total,Adolescent (10-19),290095,152071,138024,35504,108554,56912,41432,18404,23028,29474
23,466,District - Khandwa (East Nimar) (49),Total,Youth (15-24),250461,133789,116672,31547,82675,43414,54078,20590,33488,57089
23,466,District - Khandwa (East Nimar) (49),Rural,All Ages,1050625,541183,509442,122463,440789,225411,509636,212280,297356,217359
23,466,District - Khandwa (East Nimar) (49),Rural,10-14,129275,66785,62490,14824,60420,31311,16462,7753,8709,4805
23,466,District - Khandwa (East Nimar) (49),Rural,15-19,106163,56950,49213,12731,43474,23222,21745,8872,12873,24306
23,466,District - Khandwa (East Nimar) (49),Rural,20-24,91377,49340,42037,11077,35482,18229,28149,9775,18374,32028
23,466,District - Khandwa (East Nimar) (49),Rural,Adolescent (10-19),235438,123735,111703,27555,103894,54533,38207,16625,21582,29111
23,466,District - Khandwa (East Nimar) (49),Rural,Youth (15-24),197540,106290,91250,23808,78956,41451,49894,18647,31247,56334
23,466,District - Khandwa (East Nimar) (49),Urban,All Ages,259436,133146,126290,34138,18333,9456,68810,29790,39020,3838
23,466,District - Khandwa (East Nimar) (49),Urban,10-14,27519,14196,13323,3906,2648,1306,1459,850,609,69
23,466,District - Khandwa (East Nimar) (49),Urban,15-19,27138,14140,12998,4043,2012,1073,1766,929,837,294
23,466,District - Khandwa (East Nimar) (49),Urban,20-24,25783,13359,12424,3696,1707,890,2418,1014,1404,461
23,466,District - Khandwa (East Nimar) (49),Urban,Adolescent (10-19),54657,28336,26321,7949,4660,2379,3225,1779,1446,363
23,466,District - Khandwa (East Nimar) (49),Urban,Youth (15-24),52921,27499,25422,7739,3719,1963,4184,1943,2241,755
23,467,District - Burhanpur (50),Total,All Ages,757847,388504,369343,64254,230095,116420,349168,155431,193737,117409
23,467,District - Burhanpur (50),Total,10-14,88948,45904,43044,7091,32379,16366,16389,8221,8168,3051
23,467,District - Burhanpur (50),Total,15-19,74818,39544,35274,6483,21442,10914,16660,7592,9068,12788
23,467,District - Burhanpur (50),Total,20-24,71763,37582,34181,6804,19237,9703,20850,8584,12266,17666
23,467,District - Burhanpur (50),Total,Adolescent (10-19),163766,85448,78318,13574,53821,27280,33049,15813,17236,15839
23,467,District - Burhanpur (50),Total,Youth (15-24),146581,77126,69455,13287,40679,20617,37510,16176,21334,30454
23,467,District - Burhanpur (50),Rural,All Ages,497560,254978,242582,41672,222132,112338,268376,119482,148894,110224
23,467,District - Burhanpur (50),Rural,10-14,61907,31856,30051,4767,31389,15876,14284,6944,7340,2936
23,467,District - Burhanpur (50),Rural,15-19,47983,25491,22492,4057,20658,10515,13916,6093,7823,12220
23,467,District - Burhanpur (50),Rural,20-24,45388,23790,21598,4303,18464,9303,17240,6856,10384,16731
23,467,District - Burhanpur (50),Rural,Adolescent (10-19),109890,57347,52543,8824,52047,26391,28200,13037,15163,15156
23,467,District - Burhanpur (50),Rural,Youth (15-24),93371,49281,44090,8360,39122,19818,31156,12949,18207,28951
23,467,District - Burhanpur (50),Urban,All Ages,260287,133526,126761,22582,7963,4082,80792,35949,44843,7185
23,467,District - Burhanpur (50),Urban,10-14,27041,14048,12993,2324,990,490,2105,1277,828,115
23,467,District - Burhanpur (50),Urban,15-19,26835,14053,12782,2426,784,399,2744,1499,1245,568
23,467,District - Burhanpur (50),Urban,20-24,26375,13792,12583,2501,773,400,3610,1728,1882,935
23,467,District - Burhanpur (50),Urban,Adolescent (10-19),53876,28101,25775,4750,1774,889,4849,2776,2073,683
23,467,District - Burhanpur (50),Urban,Youth (15-24),53210,27845,25365,4927,1557,799,6354,3227,3127,1503
24,0,State - GUJARAT (24),Total,All Ages,60439692,31491260,28948432,4074447,8917174,4501389,19346334,8016387,11329947,4491751
24,0,State - GUJARAT (24),Total,10-14,6149445,3283834,2865611,431106,1033963,529354,366560,160662,205898,77553
24,0,State - GUJARAT (24),Total,15-19,5865760,3146110,2719650,426916,847100,436232,498499,191797,306702,428239
24,0,State - GUJARAT (24),Total,20-24,5780722,3046127,2734595,404302,772302,389151,762896,251381,511515,604628
24,0,State - GUJARAT (24),Total,Adolescent (10-19),12015205,6429944,5585261,858022,1881063,965586,865059,352459,512600,505792
24,0,State - GUJARAT (24),Total,Youth (15-24),11646482,6192237,5454245,831218,1619402,825383,1261395,443178,818217,1032867
24,0,State - GUJARAT (24),Rural,All Ages,34694609,17799159,16895450,2281573,8021848,4042691,13273767,5331516,7942251,4207186
24,0,State - GUJARAT (24),Rural,10-14,3787881,1989379,1798502,254738,937600,478519,241959,101587,140372,73550
24,0,State - GUJARAT (24),Rural,15-19,3406534,1781574,1624960,241372,749644,385190,336932,117362,219570,404066
24,0,State - GUJARAT (24),Rural,20-24,3129114,1613761,1515353,212861,678469,340841,526949,158130,368819,568453
24,0,State - GUJARAT (24),Rural,Adolescent (10-19),7194415,3770953,3423462,496110,1687244,863709,578891,218949,359942,477616
24,0,State - GUJARAT (24),Rural,Youth (15-24),6535648,3395335,3140313,454233,1428113,726031,863881,275492,588389,972519
24,0,State - GUJARAT (24),Urban,All Ages,25745083,13692101,12052982,1792874,895326,458698,6072567,2684871,3387696,284565
24,0,State - GUJARAT (24),Urban,10-14,2361564,1294455,1067109,176368,96363,50835,124601,59075,65526,4003
24,0,State - GUJARAT (24),Urban,15-19,2459226,1364536,1094690,185544,97456,51042,161567,74435,87132,24173
24,0,State - GUJARAT (24),Urban,20-24,2651608,1432366,1219242,191441,93833,48310,235947,93251,142696,36175
24,0,State - GUJARAT (24),Urban,Adolescent (10-19),4820790,2658991,2161799,361912,193819,101877,286168,133510,152658,28176
24,0,State - GUJARAT (24),Urban,Youth (15-24),5110834,2796902,2313932,376985,191289,99352,397514,167686,229828,60348
24,468,District - Kachchh (01),Total,All Ages,2092371,1096737,995634,258859,24228,12825,840052,357498,482554,140410
24,468,District - Kachchh (01),Total,10-14,220259,115967,104292,30609,2686,1409,21707,8756,12951,2434
24,468,District - Kachchh (01),Total,15-19,199688,106124,93564,27985,2236,1200,28630,10872,17758,15503
24,468,District - Kachchh (01),Total,20-24,212109,114828,97281,26017,2424,1213,44329,15242,29087,20371
24,468,District - Kachchh (01),Total,Adolescent (10-19),419947,222091,197856,58594,4922,2609,50337,19628,30709,17937
24,468,District - Kachchh (01),Total,Youth (15-24),411797,220952,190845,54002,4660,2413,72959,26114,46845,35874
24,468,District - Kachchh (01),Rural,All Ages,1363836,713524,650312,170304,14287,7629,622914,264339,358575,134475
24,468,District - Kachchh (01),Rural,10-14,149428,78161,71267,20481,1525,805,15545,6080,9465,2339
24,468,District - Kachchh (01),Rural,15-19,131795,69331,62464,18254,1250,674,21355,7835,13520,15003
24,468,District - Kachchh (01),Rural,20-24,137723,75800,61923,16387,1460,740,33706,11396,22310,19590
24,468,District - Kachchh (01),Rural,Adolescent (10-19),281223,147492,133731,38735,2775,1479,36900,13915,22985,17342
24,468,District - Kachchh (01),Rural,Youth (15-24),269518,145131,124387,34641,2710,1414,55061,19231,35830,34593
24,468,District - Kachchh (01),Urban,All Ages,728535,383213,345322,88555,9941,5196,217138,93159,123979,5935
24,468,District - Kachchh (01),Urban,10-14,70831,37806,33025,10128,1161,604,6162,2676,3486,95
24,468,District - Kachchh (01),Urban,15-19,67893,36793,31100,9731,986,526,7275,3037,4238,500
24,468,District - Kachchh (01),Urban,20-24,74386,39028,35358,9630,964,473,10623,3846,6777,781
24,468,District - Kachchh (01),Urban,Adolescent (10-19),138724,74599,64125,19859,2147,1130,13437,5713,7724,595
24,468,District - Kachchh (01),Urban,Youth (15-24),142279,75821,66458,19361,1950,999,17898,6883,11015,1281
24,469,District - Banas Kantha (02),Total,All Ages,3120506,1610379,1510127,327460,284155,144355,1415583,561977,853606,239333
24,469,District - Banas Kantha (02),Total,10-14,377635,199162,178473,41107,39770,20303,28825,9830,18995,5519
24,469,District - Banas Kantha (02),Total,15-19,324653,172341,152312,37048,27562,14141,43989,12086,31903,29219
24,469,District - Banas Kantha (02),Total,20-24,287527,148851,138676,31200,21997,11001,69563,16664,52899,39173
24,469,District - Banas Kantha (02),Total,Adolescent (10-19),702288,371503,330785,78155,67332,34444,72814,21916,50898,34738
24,469,District - Banas Kantha (02),Total,Youth (15-24),612180,321192,290988,68248,49559,25142,113552,28750,84802,68392
24,469,District - Banas Kantha (02),Rural,All Ages,2705591,1393741,1311850,287937,271055,137672,1290027,512102,777925,234412
24,469,District - Banas Kantha (02),Rural,10-14,332258,174141,158117,36490,37922,19438,26176,8709,17467,5437
24,469,District - Banas Kantha (02),Rural,15-19,280904,148296,132608,32326,26109,13380,40400,10709,29691,28711
24,469,District - Banas Kantha (02),Rural,20-24,246084,127566,118518,26968,20758,10375,64335,15140,49195,38475
24,469,District - Banas Kantha (02),Rural,Adolescent (10-19),613162,322437,290725,68816,64031,32818,66576,19418,47158,34148
24,469,District - Banas Kantha (02),Rural,Youth (15-24),526988,275862,251126,59294,46867,23755,104735,25849,78886,67186
24,469,District - Banas Kantha (02),Urban,All Ages,414915,216638,198277,39523,13100,6683,125556,49875,75681,4921
24,469,District - Banas Kantha (02),Urban,10-14,45377,25021,20356,4617,1848,865,2649,1121,1528,82
24,469,District - Banas Kantha (02),Urban,15-19,43749,24045,19704,4722,1453,761,3589,1377,2212,508
24,469,District - Banas Kantha (02),Urban,20-24,41443,21285,20158,4232,1239,626,5228,1524,3704,698
24,469,District - Banas Kantha (02),Urban,Adolescent (10-19),89126,49066,40060,9339,3301,1626,6238,2498,3740,590
24,469,District - Banas Kantha (02),Urban,Youth (15-24),85192,45330,39862,8954,2692,1387,8817,2901,5916,1206
24,470,District - Patan (03),Total,All Ages,1343734,694397,649337,123408,13303,6835,505821,199766,306055,158550
24,470,District - Patan (03),Total,10-14,147316,79436,67880,14056,1600,876,8572,3294,5278,2757
24,470,District - Patan (03),Total,15-19,135360,72204,63156,13598,1512,792,13097,4038,9059,15968
24,470,District - Patan (03),Total,20-24,124031,63944,60087,11974,1212,628,21728,5783,15945,23146
24,470,District - Patan (03),Total,Adolescent (10-19),282676,151640,131036,27654,3112,1668,21669,7332,14337,18725
24,470,District - Patan (03),Total,Youth (15-24),259391,136148,123243,25572,2724,1420,34825,9821,25004,39114
24,470,District - Patan (03),Rural,All Ages,1062653,548324,514329,96923,6182,3189,432036,169754,262282,152484
24,470,District - Patan (03),Rural,10-14,120226,64368,55858,11410,838,440,7124,2673,4451,2672
24,470,District - Patan (03),Rural,15-19,107501,56996,50505,10728,658,343,11037,3230,7807,15404
24,470,District - Patan (03),Rural,20-24,96699,49807,46892,9108,523,262,18770,4779,13991,22359
24,470,District - Patan (03),Rural,Adolescent (10-19),227727,121364,106363,22138,1496,783,18161,5903,12258,18076
24,470,District - Patan (03),Rural,Youth (15-24),204200,106803,97397,19836,1181,605,29807,8009,21798,37763
24,470,District - Patan (03),Urban,All Ages,281081,146073,135008,26485,7121,3646,73785,30012,43773,6066
24,470,District - Patan (03),Urban,10-14,27090,15068,12022,2646,762,436,1448,621,827,85
24,470,District - Patan (03),Urban,15-19,27859,15208,12651,2870,854,449,2060,808,1252,564
24,470,District - Patan (03),Urban,20-24,27332,14137,13195,2866,689,366,2958,1004,1954,787
24,470,District - Patan (03),Urban,Adolescent (10-19),54949,30276,24673,5516,1616,885,3508,1429,2079,649
24,470,District - Patan (03),Urban,Youth (15-24),55191,29345,25846,5736,1543,815,5018,1812,3206,1351
24,471,District - Mahesana (04),Total,All Ages,2035064,1056520,978544,162288,9392,4879,532419,209021,323398,192521
24,471,District - Mahesana (04),Total,10-14,200146,111239,88907,16844,970,519,5676,2427,3249,2578
24,471,District - Mahesana (04),Total,15-19,202417,109784,92633,17590,1058,528,8766,2895,5871,16727
24,471,District - Mahesana (04),Total,20-24,196144,100379,95765,16335,1054,506,15176,3711,11465,25802
24,471,District - Mahesana (04),Total,Adolescent (10-19),402563,221023,181540,34434,2028,1047,14442,5322,9120,19305
24,471,District - Mahesana (04),Total,Youth (15-24),398561,210163,188398,33925,2112,1034,23942,6606,17336,42529
24,471,District - Mahesana (04),Rural,All Ages,1520734,787175,733559,118710,3144,1634,424925,163410,261515,184992
24,471,District - Mahesana (04),Rural,10-14,152854,84249,68605,12616,331,176,3987,1648,2339,2484
24,471,District - Mahesana (04),Rural,15-19,152178,82016,70162,13011,341,167,6436,1975,4461,16147
24,471,District - Mahesana (04),Rural,20-24,145249,74295,70954,11648,366,168,11725,2604,9121,24865
24,471,District - Mahesana (04),Rural,Adolescent (10-19),305032,166265,138767,25627,672,343,10423,3623,6800,18631
24,471,District - Mahesana (04),Rural,Youth (15-24),297427,156311,141116,24659,707,335,18161,4579,13582,41012
24,471,District - Mahesana (04),Urban,All Ages,514330,269345,244985,43578,6248,3245,107494,45611,61883,7529
24,471,District - Mahesana (04),Urban,10-14,47292,26990,20302,4228,639,343,1689,779,910,94
24,471,District - Mahesana (04),Urban,15-19,50239,27768,22471,4579,717,361,2330,920,1410,580
24,471,District - Mahesana (04),Urban,20-24,50895,26084,24811,4687,688,338,3451,1107,2344,937
24,471,District - Mahesana (04),Urban,Adolescent (10-19),97531,54758,42773,8807,1356,704,4019,1699,2320,674
24,471,District - Mahesana (04),Urban,Youth (15-24),101134,53852,47282,9266,1405,699,5781,2027,3754,1517
24,472,District - Sabar Kantha (05),Total,All Ages,2428589,1244231,1184358,187685,542156,272531,849855,325606,524249,188289
24,472,District - Sabar Kantha (05),Total,10-14,259112,137995,121117,19412,68475,34905,12877,5765,7112,3196
24,472,District - Sabar Kantha (05),Total,15-19,233975,124020,109955,19639,53831,27417,17233,5772,11461,18071
24,472,District - Sabar Kantha (05),Total,20-24,213627,109036,104591,17179,45907,22549,28397,7656,20741,27685
24,472,District - Sabar Kantha (05),Total,Adolescent (10-19),493087,262015,231072,39051,122306,62322,30110,11537,18573,21267
24,472,District - Sabar Kantha (05),Total,Youth (15-24),447602,233056,214546,36818,99738,49966,45630,13428,32202,45756
24,472,District - Sabar Kantha (05),Rural,All Ages,2064869,1056141,1008728,159214,520203,261131,756880,287636,469244,181930
24,472,District - Sabar Kantha (05),Rural,10-14,222472,117867,104605,16512,65437,33339,10922,4851,6071,3107
24,472,District - Sabar Kantha (05),Rural,15-19,197415,104226,93189,16450,51118,25958,14881,4798,10083,17619
24,472,District - Sabar Kantha (05),Rural,20-24,179064,91342,87722,14248,43781,21416,25175,6565,18610,26848
24,472,District - Sabar Kantha (05),Rural,Adolescent (10-19),419887,222093,197794,32962,116555,59297,25803,9649,16154,20726
24,472,District - Sabar Kantha (05),Rural,Youth (15-24),376479,195568,180911,30698,94899,47374,40056,11363,28693,44467
24,472,District - Sabar Kantha (05),Urban,All Ages,363720,188090,175630,28471,21953,11400,92975,37970,55005,6359
24,472,District - Sabar Kantha (05),Urban,10-14,36640,20128,16512,2900,3038,1566,1955,914,1041,89
24,472,District - Sabar Kantha (05),Urban,15-19,36560,19794,16766,3189,2713,1459,2352,974,1378,452
24,472,District - Sabar Kantha (05),Urban,20-24,34563,17694,16869,2931,2126,1133,3222,1091,2131,837
24,472,District - Sabar Kantha (05),Urban,Adolescent (10-19),73200,39922,33278,6089,5751,3025,4307,1888,2419,541
24,472,District - Sabar Kantha (05),Urban,Youth (15-24),71123,37488,33635,6120,4839,2592,5574,2065,3509,1289
24,473,District - Gandhinagar (06),Total,All Ages,1391753,723864,667889,108608,18204,9711,361259,141178,220081,97287
24,473,District - Gandhinagar (06),Total,10-14,132993,73558,59435,9908,1932,1060,4490,1870,2620,1376
24,473,District - Gandhinagar (06),Total,15-19,133572,71507,62065,10377,2163,1158,6659,2317,4342,8306
24,473,District - Gandhinagar (06),Total,20-24,136032,70022,66010,10935,2035,1055,11097,3057,8040,13190
24,473,District - Gandhinagar (06),Total,Adolescent (10-19),266565,145065,121500,20285,4095,2218,11149,4187,6962,9682
24,473,District - Gandhinagar (06),Total,Youth (15-24),269604,141529,128075,21312,4198,2213,17756,5374,12382,21496
24,473,District - Gandhinagar (06),Rural,All Ages,791126,408436,382690,40454,2583,1363,227153,85131,142022,83452
24,473,District - Gandhinagar (06),Rural,10-14,79046,43045,36001,3999,322,188,2193,891,1302,1186
24,473,District - Gandhinagar (06),Rural,15-19,77513,40818,36695,4103,309,167,3577,1111,2466,7105
24,473,District - Gandhinagar (06),Rural,20-24,75617,38712,36905,3857,246,125,6375,1577,4798,11273
24,473,District - Gandhinagar (06),Rural,Adolescent (10-19),156559,83863,72696,8102,631,355,5770,2002,3768,8291
24,473,District - Gandhinagar (06),Rural,Youth (15-24),153130,79530,73600,7960,555,292,9952,2688,7264,18378
24,473,District - Gandhinagar (06),Urban,All Ages,600627,315428,285199,68154,15621,8348,134106,56047,78059,13835
24,473,District - Gandhinagar (06),Urban,10-14,53947,30513,23434,5909,1610,872,2297,979,1318,190
24,473,District - Gandhinagar (06),Urban,15-19,56059,30689,25370,6274,1854,991,3082,1206,1876,1201
24,473,District - Gandhinagar (06),Urban,20-24,60415,31310,29105,7078,1789,930,4722,1480,3242,1917
24,473,District - Gandhinagar (06),Urban,Adolescent (10-19),110006,61202,48804,12183,3464,1863,5379,2185,3194,1391
24,473,District - Gandhinagar (06),Urban,Youth (15-24),116474,61999,54475,13352,3643,1921,7804,2686,5118,3118
24,474,District - Ahmadabad (07),Total,All Ages,7214225,3788051,3426174,759483,89138,47106,1778465,762588,1015877,191480
24,474,District - Ahmadabad (07),Total,10-14,669168,366969,302199,72591,9066,4885,36246,16576,19670,3590
24,474,District - Ahmadabad (07),Total,15-19,679291,369754,309537,76699,9790,5113,48623,19568,29055,17761
24,474,District - Ahmadabad (07),Total,20-24,710749,369470,341279,80525,9926,5229,71176,23909,47267,25097
24,474,District - Ahmadabad (07),Total,Adolescent (10-19),1348459,736723,611736,149290,18856,9998,84869,36144,48725,21351
24,474,District - Ahmadabad (07),Total,Youth (15-24),1390040,739224,650816,157224,19716,10342,119799,43477,76322,42858
24,474,District - Ahmadabad (07),Rural,All Ages,1151178,595583,555595,118502,16749,8656,448100,172605,275495,164966
24,474,District - Ahmadabad (07),Rural,10-14,126352,67526,58826,12241,1918,1011,8642,3401,5241,3180
24,474,District - Ahmadabad (07),Rural,15-19,116738,61234,55504,12178,1618,764,12781,3951,8830,15569
24,474,District - Ahmadabad (07),Rural,20-24,104183,53959,50224,10972,1528,753,19406,5038,14368,21798
24,474,District - Ahmadabad (07),Rural,Adolescent (10-19),243090,128760,114330,24419,3536,1775,21423,7352,14071,18749
24,474,District - Ahmadabad (07),Rural,Youth (15-24),220921,115193,105728,23150,3146,1517,32187,8989,23198,37367
24,474,District - Ahmadabad (07),Urban,All Ages,6063047,3192468,2870579,640981,72389,38450,1330365,589983,740382,26514
24,474,District - Ahmadabad (07),Urban,10-14,542816,299443,243373,60350,7148,3874,27604,13175,14429,410
24,474,District - Ahmadabad (07),Urban,15-19,562553,308520,254033,64521,8172,4349,35842,15617,20225,2192
24,474,District - Ahmadabad (07),Urban,20-24,606566,315511,291055,69553,8398,4476,51770,18871,32899,3299
24,474,District - Ahmadabad (07),Urban,Adolescent (10-19),1105369,607963,497406,124871,15320,8223,63446,28792,34654,2602
24,474,District - Ahmadabad (07),Urban,Youth (15-24),1169119,624031,545088,134074,16570,8825,87612,34488,53124,5491
24,475,District - Surendranagar (08),Total,All Ages,1756268,909917,846351,179461,21453,11068,662642,266696,395946,180888
24,475,District - Surendranagar (08),Total,10-14,195488,104464,91024,20085,2759,1492,11458,4570,6888,3686
24,475,District - Surendranagar (08),Total,15-19,182811,96066,86745,19912,2440,1206,18504,6098,12406,22035
24,475,District - Surendranagar (08),Total,20-24,159763,82649,77114,17010,1897,945,28599,8315,20284,26829
24,475,District - Surendranagar (08),Total,Adolescent (10-19),378299,200530,177769,39997,5199,2698,29962,10668,19294,25721
24,475,District - Surendranagar (08),Total,Youth (15-24),342574,178715,163859,36922,4337,2151,47103,14413,32690,48864
24,475,District - Surendranagar (08),Rural,All Ages,1259352,649475,609877,128019,19313,9915,528649,211818,316831,173687
24,475,District - Surendranagar (08),Rural,10-14,146195,77166,69029,14647,2528,1366,9069,3504,5565,3583
24,475,District - Surendranagar (08),Rural,15-19,132053,68495,63558,14218,2164,1050,14789,4550,10239,21283
24,475,District - Surendranagar (08),Rural,20-24,112052,57785,54267,11656,1659,807,23379,6446,16933,25852
24,475,District - Surendranagar (08),Rural,Adolescent (10-19),278248,145661,132587,28865,4692,2416,23858,8054,15804,24866
24,475,District - Surendranagar (08),Rural,Youth (15-24),244105,126280,117825,25874,3823,1857,38168,10996,27172,47135
24,475,District - Surendranagar (08),Urban,All Ages,496916,260442,236474,51442,2140,1153,133993,54878,79115,7201
24,475,District - Surendranagar (08),Urban,10-14,49293,27298,21995,5438,231,126,2389,1066,1323,103
24,475,District - Surendranagar (08),Urban,15-19,50758,27571,23187,5694,276,156,3715,1548,2167,752
24,475,District - Surendranagar (08),Urban,20-24,47711,24864,22847,5354,238,138,5220,1869,3351,977
24,475,District - Surendranagar (08),Urban,Adolescent (10-19),100051,54869,45182,11132,507,282,6104,2614,3490,855
24,475,District - Surendranagar (08),Urban,Youth (15-24),98469,52435,46034,11048,514,294,8935,3417,5518,1729
24,476,District - Rajkot (09),Total,All Ages,3804558,1974445,1830113,290169,24017,12504,1079502,460370,619132,171235
24,476,District - Rajkot (09),Total,10-14,361053,194056,166997,31264,2475,1283,18877,8914,9963,3844
24,476,District - Rajkot (09),Total,15-19,364446,194521,169925,31552,2374,1238,23995,10631,13364,20583
24,476,District - Rajkot (09),Total,20-24,369044,187555,181489,30529,2570,1308,36552,13630,22922,24191
24,476,District - Rajkot (09),Total,Adolescent (10-19),725499,388577,336922,62816,4849,2521,42872,19545,23327,24427
24,476,District - Rajkot (09),Total,Youth (15-24),733490,382076,351414,62081,4944,2546,60547,24261,36286,44774
24,476,District - Rajkot (09),Rural,All Ages,1590508,816264,774244,147979,8407,4389,546573,223509,323064,152794
24,476,District - Rajkot (09),Rural,10-14,162189,85191,76998,16418,962,506,7622,3409,4213,3557
24,476,District - Rajkot (09),Rural,15-19,158782,82287,76495,16062,712,344,10338,4134,6204,18825
24,476,District - Rajkot (09),Rural,20-24,151231,75155,76076,14936,861,417,17450,5784,11666,21843
24,476,District - Rajkot (09),Rural,Adolescent (10-19),320971,167478,153493,32480,1674,850,17960,7543,10417,22382
24,476,District - Rajkot (09),Rural,Youth (15-24),310013,157442,152571,30998,1573,761,27788,9918,17870,40668
24,476,District - Rajkot (09),Urban,All Ages,2214050,1158181,1055869,142190,15610,8115,532929,236861,296068,18441
24,476,District - Rajkot (09),Urban,10-14,198864,108865,89999,14846,1513,777,11255,5505,5750,287
24,476,District - Rajkot (09),Urban,15-19,205664,112234,93430,15490,1662,894,13657,6497,7160,1758
24,476,District - Rajkot (09),Urban,20-24,217813,112400,105413,15593,1709,891,19102,7846,11256,2348
24,476,District - Rajkot (09),Urban,Adolescent (10-19),404528,221099,183429,30336,3175,1671,24912,12002,12910,2045
24,476,District - Rajkot (09),Urban,Youth (15-24),423477,224634,198843,31083,3371,1785,32759,14343,18416,4106
24,477,District - Jamnagar (10),Total,All Ages,2160119,1114192,1045927,173895,24187,12415,763585,319052,444533,106658
24,477,District - Jamnagar (10),Total,10-14,222564,117573,104991,19241,2792,1463,17063,7580,9483,2157
24,477,District - Jamnagar (10),Total,15-19,214086,111616,102470,19617,2486,1264,22907,9628,13279,13435
24,477,District - Jamnagar (10),Total,20-24,208365,107510,100855,17949,2304,1147,31623,11780,19843,15794
24,477,District - Jamnagar (10),Total,Adolescent (10-19),436650,229189,207461,38858,5278,2727,39970,17208,22762,15592
24,477,District - Jamnagar (10),Total,Youth (15-24),422451,219126,203325,37566,4790,2411,54530,21408,33122,29229
24,477,District - Jamnagar (10),Rural,All Ages,1189054,610088,578966,99378,16492,8457,473319,195090,278229,94848
24,477,District - Jamnagar (10),Rural,10-14,127611,66895,60716,11360,2004,1053,7820,3451,4369,1981
24,477,District - Jamnagar (10),Rural,15-19,118617,60877,57740,11154,1623,812,11163,4598,6565,12235
24,477,District - Jamnagar (10),Rural,20-24,113428,58138,55290,9836,1479,726,17479,6408,11071,14212
24,477,District - Jamnagar (10),Rural,Adolescent (10-19),246228,127772,118456,22514,3627,1865,18983,8049,10934,14216
24,477,District - Jamnagar (10),Rural,Youth (15-24),232045,119015,113030,20990,3102,1538,28642,11006,17636,26447
24,477,District - Jamnagar (10),Urban,All Ages,971065,504104,466961,74517,7695,3958,290266,123962,166304,11810
24,477,District - Jamnagar (10),Urban,10-14,94953,50678,44275,7881,788,410,9243,4129,5114,176
24,477,District - Jamnagar (10),Urban,15-19,95469,50739,44730,8463,863,452,11744,5030,6714,1200
24,477,District - Jamnagar (10),Urban,20-24,94937,49372,45565,8113,825,421,14144,5372,8772,1582
24,477,District - Jamnagar (10),Urban,Adolescent (10-19),190422,101417,89005,16344,1651,862,20987,9159,11828,1376
24,477,District - Jamnagar (10),Urban,Youth (15-24),190406,100111,90295,16576,1688,873,25888,10402,15486,2782
24,478,District - Porbandar (11),Total,All Ages,585449,300209,285240,51830,13039,6730,191771,78588,113183,36278
24,478,District - Porbandar (11),Total,10-14,59674,31090,28584,5888,1598,818,3431,1583,1848,713
24,478,District - Porbandar (11),Total,15-19,55858,29284,26574,5481,1497,784,4305,1897,2408,3942
24,478,District - Porbandar (11),Total,20-24,51961,27430,24531,4892,1282,646,5990,2431,3559,4853
24,478,District - Porbandar (11),Total,Adolescent (10-19),115532,60374,55158,11369,3095,1602,7736,3480,4256,4655
24,478,District - Porbandar (11),Total,Youth (15-24),107819,56714,51105,10373,2779,1430,10295,4328,5967,8795
24,478,District - Porbandar (11),Rural,All Ages,299775,153260,146515,29068,9945,5146,116582,47522,69060,30716
24,478,District - Porbandar (11),Rural,10-14,31969,16591,15378,3385,1203,608,2061,957,1104,614
24,478,District - Porbandar (11),Rural,15-19,28390,14816,13574,3136,1123,576,2557,1147,1410,3323
24,478,District - Porbandar (11),Rural,20-24,25658,13690,11968,2703,974,497,3601,1421,2180,4127
24,478,District - Porbandar (11),Rural,Adolescent (10-19),60359,31407,28952,6521,2326,1184,4618,2104,2514,3937
24,478,District - Porbandar (11),Rural,Youth (15-24),54048,28506,25542,5839,2097,1073,6158,2568,3590,7450
24,478,District - Porbandar (11),Urban,All Ages,285674,146949,138725,22762,3094,1584,75189,31066,44123,5562
24,478,District - Porbandar (11),Urban,10-14,27705,14499,13206,2503,395,210,1370,626,744,99
24,478,District - Porbandar (11),Urban,15-19,27468,14468,13000,2345,374,208,1748,750,998,619
24,478,District - Porbandar (11),Urban,20-24,26303,13740,12563,2189,308,149,2389,1010,1379,726
24,478,District - Porbandar (11),Urban,Adolescent (10-19),55173,28967,26206,4848,769,418,3118,1376,1742,718
24,478,District - Porbandar (11),Urban,Youth (15-24),53771,28208,25563,4534,682,357,4137,1760,2377,1345
24,479,District - Junagadh (12),Total,All Ages,2743082,1404356,1338726,265793,55571,28463,900264,357375,542889,258569
24,479,District - Junagadh (12),Total,10-14,297779,156224,141555,32176,6516,3336,12865,5624,7241,4060
24,479,District - Junagadh (12),Total,15-19,283471,146390,137081,29467,6234,3254,18377,7310,11067,26391
24,479,District - Junagadh (12),Total,20-24,253686,130342,123344,25071,5335,2727,28288,9615,18673,34170
24,479,District - Junagadh (12),Total,Adolescent (10-19),581250,302614,278636,61643,12750,6590,31242,12934,18308,30451
24,479,District - Junagadh (12),Total,Youth (15-24),537157,276732,260425,54538,11569,5981,46665,16925,29740,60561
24,479,District - Junagadh (12),Rural,All Ages,1836670,940271,896399,204153,37633,19376,658510,259062,399448,233739
24,479,District - Junagadh (12),Rural,10-14,201675,105644,96031,24876,4425,2271,8198,3494,4704,3785
24,479,District - Junagadh (12),Rural,15-19,187811,97325,90486,22362,4131,2132,12104,4634,7470,24274
24,479,District - Junagadh (12),Rural,20-24,166944,85671,81273,18768,3486,1816,19331,6351,12980,30839
24,479,District - Junagadh (12),Rural,Adolescent (10-19),389486,202969,186517,47238,8556,4403,20302,8128,12174,28059
24,479,District - Junagadh (12),Rural,Youth (15-24),354755,182996,171759,41130,7617,3948,31435,10985,20450,55113
24,479,District - Junagadh (12),Urban,All Ages,906412,464085,442327,61640,17938,9087,241754,98313,143441,24830
24,479,District - Junagadh (12),Urban,10-14,96104,50580,45524,7300,2091,1065,4667,2130,2537,275
24,479,District - Junagadh (12),Urban,15-19,95660,49065,46595,7105,2103,1122,6273,2676,3597,2117
24,479,District - Junagadh (12),Urban,20-24,86742,44671,42071,6303,1849,911,8957,3264,5693,3331
24,479,District - Junagadh (12),Urban,Adolescent (10-19),191764,99645,92119,14405,4194,2187,10940,4806,6134,2392
24,479,District - Junagadh (12),Urban,Youth (15-24),182402,93736,88666,13408,3952,2033,15230,5940,9290,5448
24,480,District - Amreli (13),Total,All Ages,1514190,771049,743141,132915,7322,3856,518731,212869,305862,149563
24,480,District - Amreli (13),Total,10-14,158957,83493,75464,15772,749,403,9025,3865,5160,3234
24,480,District - Amreli (13),Total,15-19,164637,83394,81243,15461,801,393,13341,5292,8049,17379
24,480,District - Amreli (13),Total,20-24,141186,69727,71459,12783,829,403,19100,6754,12346,19295
24,480,District - Amreli (13),Total,Adolescent (10-19),323594,166887,156707,31233,1550,796,22366,9157,13209,20613
24,480,District - Amreli (13),Total,Youth (15-24),305823,153121,152702,28244,1630,796,32441,12046,20395,36674
24,480,District - Amreli (13),Rural,All Ages,1127555,572554,555001,109351,4140,2210,412512,167616,244896,136632
24,480,District - Amreli (13),Rural,10-14,118838,62075,56763,13214,417,243,6518,2746,3772,3035
24,480,District - Amreli (13),Rural,15-19,120765,61284,59481,12617,410,204,9954,3802,6152,15995
24,480,District - Amreli (13),Rural,20-24,103734,50788,52946,10287,477,233,15145,5258,9887,17625
24,480,District - Amreli (13),Rural,Adolescent (10-19),239603,123359,116244,25831,827,447,16472,6548,9924,19030
24,480,District - Amreli (13),Rural,Youth (15-24),224499,112072,112427,22904,887,437,25099,9060,16039,33620
24,480,District - Amreli (13),Urban,All Ages,386635,198495,188140,23564,3182,1646,106219,45253,60966,12931
24,480,District - Amreli (13),Urban,10-14,40119,21418,18701,2558,332,160,2507,1119,1388,199
24,480,District - Amreli (13),Urban,15-19,43872,22110,21762,2844,391,189,3387,1490,1897,1384
24,480,District - Amreli (13),Urban,20-24,37452,18939,18513,2496,352,170,3955,1496,2459,1670
24,480,District - Amreli (13),Urban,Adolescent (10-19),83991,43528,40463,5402,723,349,5894,2609,3285,1583
24,480,District - Amreli (13),Urban,Youth (15-24),81324,41049,40275,5340,743,359,7342,2986,4356,3054
24,481,District - Bhavnagar (14),Total,All Ages,2880365,1490201,1390164,157034,9110,4751,993110,402830,590280,252904
24,481,District - Bhavnagar (14),Total,10-14,320936,170105,150831,17591,1006,557,17283,7018,10265,6898
24,481,District - Bhavnagar (14),Total,15-19,319505,166304,153201,17877,1050,512,26457,9337,17120,32658
24,481,District - Bhavnagar (14),Total,20-24,273001,140656,132345,15638,923,454,39019,11975,27044,32072
24,481,District - Bhavnagar (14),Total,Adolescent (10-19),640441,336409,304032,35468,2056,1069,43740,16355,27385,39556
24,481,District - Bhavnagar (14),Total,Youth (15-24),592506,306960,285546,33515,1973,966,65476,21312,44164,64730
24,481,District - Bhavnagar (14),Rural,All Ages,1697964,868833,829131,88671,3408,1817,668028,263807,404221,234264
24,481,District - Bhavnagar (14),Rural,10-14,202103,105789,96314,10400,365,210,10639,3947,6692,6496
24,481,District - Bhavnagar (14),Rural,15-19,196166,100095,96071,10239,329,170,17067,5265,11802,30610
24,481,District - Bhavnagar (14),Rural,20-24,155071,78483,76588,8484,333,162,25836,6925,18911,29931
24,481,District - Bhavnagar (14),Rural,Adolescent (10-19),398269,205884,192385,20639,694,380,27706,9212,18494,37106
24,481,District - Bhavnagar (14),Rural,Youth (15-24),351237,178578,172659,18723,662,332,42903,12190,30713,60541
24,481,District - Bhavnagar (14),Urban,All Ages,1182401,621368,561033,68363,5702,2934,325082,139023,186059,18640
24,481,District - Bhavnagar (14),Urban,10-14,118833,64316,54517,7191,641,347,6644,3071,3573,402
24,481,District - Bhavnagar (14),Urban,15-19,123339,66209,57130,7638,721,342,9390,4072,5318,2048
24,481,District - Bhavnagar (14),Urban,20-24,117930,62173,55757,7154,590,292,13183,5050,8133,2141
24,481,District - Bhavnagar (14),Urban,Adolescent (10-19),242172,130525,111647,14829,1362,689,16034,7143,8891,2450
24,481,District - Bhavnagar (14),Urban,Youth (15-24),241269,128382,112887,14792,1311,634,22573,9122,13451,4189
24,482,District - Anand (15),Total,All Ages,2092745,1087224,1005521,104465,24824,12761,541492,212743,328749,263622
24,482,District - Anand (15),Total,10-14,202421,109720,92701,9471,2732,1416,6970,3002,3968,2531
24,482,District - Anand (15),Total,15-19,193477,104508,88969,9651,2637,1398,8977,3319,5658,19168
24,482,District - Anand (15),Total,20-24,194227,101765,92462,10209,2610,1328,14262,4268,9994,35208
24,482,District - Anand (15),Total,Adolescent (10-19),395898,214228,181670,19122,5369,2814,15947,6321,9626,21699
24,482,District - Anand (15),Total,Youth (15-24),387704,206273,181431,19860,5247,2726,23239,7587,15652,54376
24,482,District - Anand (15),Rural,All Ages,1457758,758499,699259,74755,9884,5129,404648,155528,249120,238581
24,482,District - Anand (15),Rural,10-14,145684,78874,66810,6956,1140,573,4820,2098,2722,2307
24,482,District - Anand (15),Rural,15-19,135369,72982,62387,6839,963,517,6130,2147,3983,17357
24,482,District - Anand (15),Rural,20-24,132545,69952,62593,6980,959,515,10286,2959,7327,31889
24,482,District - Anand (15),Rural,Adolescent (10-19),281053,151856,129197,13795,2103,1090,10950,4245,6705,19664
24,482,District - Anand (15),Rural,Youth (15-24),267914,142934,124980,13819,1922,1032,16416,5106,11310,49246
24,482,District - Anand (15),Urban,All Ages,634987,328725,306262,29710,14940,7632,136844,57215,79629,25041
24,482,District - Anand (15),Urban,10-14,56737,30846,25891,2515,1592,843,2150,904,1246,224
24,482,District - Anand (15),Urban,15-19,58108,31526,26582,2812,1674,881,2847,1172,1675,1811
24,482,District - Anand (15),Urban,20-24,61682,31813,29869,3229,1651,813,3976,1309,2667,3319
24,482,District - Anand (15),Urban,Adolescent (10-19),114845,62372,52473,5327,3266,1724,4997,2076,2921,2035
24,482,District - Anand (15),Urban,Youth (15-24),119790,63339,56451,6041,3325,1694,6823,2481,4342,5130
24,483,District - Kheda (16),Total,All Ages,2299885,1185727,1114158,115631,40336,21057,639642,243247,396395,239743
24,483,District - Kheda (16),Total,10-14,234864,126156,108708,11264,4536,2463,8646,3686,4960,2537
24,483,District - Kheda (16),Total,15-19,212204,112228,99976,10583,3787,2062,10806,3751,7055,18469
24,483,District - Kheda (16),Total,20-24,205025,106165,98860,10847,3549,1905,16619,4636,11983,33606
24,483,District - Kheda (16),Total,Adolescent (10-19),447068,238384,208684,21847,8323,4525,19452,7437,12015,21006
24,483,District - Kheda (16),Total,Youth (15-24),417229,218393,198836,21430,7336,3967,27425,8387,19038,52075
24,483,District - Kheda (16),Rural,All Ages,1776276,915197,861079,86794,27275,14255,519035,192752,326283,222165
24,483,District - Kheda (16),Rural,10-14,185640,99476,86164,8608,3081,1704,5908,2493,3415,2394
24,483,District - Kheda (16),Rural,15-19,164181,86770,77411,7810,2348,1292,7367,2419,4948,17287
24,483,District - Kheda (16),Rural,20-24,156370,81003,75367,7844,2208,1175,12333,3119,9214,31294
24,483,District - Kheda (16),Rural,Adolescent (10-19),349821,186246,163575,16418,5429,2996,13275,4912,8363,19681
24,483,District - Kheda (16),Rural,Youth (15-24),320551,167773,152778,15654,4556,2467,19700,5538,14162,48581
24,483,District - Kheda (16),Urban,All Ages,523609,270530,253079,28837,13061,6802,120607,50495,70112,17578
24,483,District - Kheda (16),Urban,10-14,49224,26680,22544,2656,1455,759,2738,1193,1545,143
24,483,District - Kheda (16),Urban,15-19,48023,25458,22565,2773,1439,770,3439,1332,2107,1182
24,483,District - Kheda (16),Urban,20-24,48655,25162,23493,3003,1341,730,4286,1517,2769,2312
24,483,District - Kheda (16),Urban,Adolescent (10-19),97247,52138,45109,5429,2894,1529,6177,2525,3652,1325
24,483,District - Kheda (16),Urban,Youth (15-24),96678,50620,46058,5776,2780,1500,7725,2849,4876,3494
24,484,District - Panch Mahals (17),Total,All Ages,2390776,1226961,1163815,100446,721604,368348,949971,368907,581064,131350
24,484,District - Panch Mahals (17),Total,10-14,270176,140066,130110,10482,90302,45932,15544,6705,8839,2237
24,484,District - Panch Mahals (17),Total,15-19,233653,123538,110115,10135,70363,36452,21315,7333,13982,13069
24,484,District - Panch Mahals (17),Total,20-24,210391,109855,100536,9470,60114,31075,35859,9763,26096,21023
24,484,District - Panch Mahals (17),Total,Adolescent (10-19),503829,263604,240225,20617,160665,82384,36859,14038,22821,15306
24,484,District - Panch Mahals (17),Total,Youth (15-24),444044,233393,210651,19605,130477,67527,57174,17096,40078,34092
24,484,District - Panch Mahals (17),Rural,All Ages,2055949,1053376,1002573,83082,697576,356032,868115,334248,533867,127434
24,484,District - Panch Mahals (17),Rural,10-14,235424,121384,114040,8801,87408,44393,13974,5966,8008,2158
24,484,District - Panch Mahals (17),Rural,15-19,199928,105434,94494,8224,67896,35139,19436,6528,12908,12701
24,484,District - Panch Mahals (17),Rural,20-24,177422,92818,84604,7604,57857,29909,33241,8857,24384,20453
24,484,District - Panch Mahals (17),Rural,Adolescent (10-19),435352,226818,208534,17025,155304,79532,33410,12494,20916,14859
24,484,District - Panch Mahals (17),Rural,Youth (15-24),377350,198252,179098,15828,125753,65048,52677,15385,37292,33154
24,484,District - Panch Mahals (17),Urban,All Ages,334827,173585,161242,17364,24028,12316,81856,34659,47197,3916
24,484,District - Panch Mahals (17),Urban,10-14,34752,18682,16070,1681,2894,1539,1570,739,831,79
24,484,District - Panch Mahals (17),Urban,15-19,33725,18104,15621,1911,2467,1313,1879,805,1074,368
24,484,District - Panch Mahals (17),Urban,20-24,32969,17037,15932,1866,2257,1166,2618,906,1712,570
24,484,District - Panch Mahals (17),Urban,Adolescent (10-19),68477,36786,31691,3592,5361,2852,3449,1544,1905,447
24,484,District - Panch Mahals (17),Urban,Youth (15-24),66694,35141,31553,3777,4724,2479,4497,1711,2786,938
24,485,District - Dohad (18),Total,All Ages,2127086,1068651,1058435,41444,1580850,793305,1119915,469616,650299,128264
24,485,District - Dohad (18),Total,10-14,273568,138395,135173,5018,211128,106688,35679,15244,20435,3079
24,485,District - Dohad (18),Total,15-19,205903,101596,104307,4284,147999,73218,44933,14937,29996,13584
24,485,District - Dohad (18),Total,20-24,178324,87332,90992,3706,128449,62514,64473,18898,45575,22447
24,485,District - Dohad (18),Total,Adolescent (10-19),479471,239991,239480,9302,359127,179906,80612,30181,50431,16663
24,485,District - Dohad (18),Total,Youth (15-24),384227,188928,195299,7990,276448,135732,109406,33835,75571,36031
24,485,District - Dohad (18),Rural,All Ages,1935461,970963,964498,31647,1522008,763671,1062909,445823,617086,125579
24,485,District - Dohad (18),Rural,10-14,253377,127729,125648,4005,203572,102722,34395,14654,19741,3014
24,485,District - Dohad (18),Rural,15-19,186908,91512,95396,3315,141823,70072,43199,14249,28950,13352
24,485,District - Dohad (18),Rural,20-24,160337,78254,82083,2709,122919,59807,61866,18073,43793,22093
24,485,District - Dohad (18),Rural,Adolescent (10-19),440285,219241,221044,7320,345395,172794,77594,28903,48691,16366
24,485,District - Dohad (18),Rural,Youth (15-24),347245,169766,177479,6024,264742,129879,105065,32322,72743,35445
24,485,District - Dohad (18),Urban,All Ages,191625,97688,93937,9797,58842,29634,57006,23793,33213,2685
24,485,District - Dohad (18),Urban,10-14,20191,10666,9525,1013,7556,3966,1284,590,694,65
24,485,District - Dohad (18),Urban,15-19,18995,10084,8911,969,6176,3146,1734,688,1046,232
24,485,District - Dohad (18),Urban,20-24,17987,9078,8909,997,5530,2707,2607,825,1782,354
24,485,District - Dohad (18),Urban,Adolescent (10-19),39186,20750,18436,1982,13732,7112,3018,1278,1740,297
24,485,District - Dohad (18),Urban,Youth (15-24),36982,19162,17820,1966,11706,5853,4341,1513,2828,586
24,486,District - Vadodara (19),Total,All Ages,4165626,2153736,2011890,221629,1149901,586665,1272546,539649,732897,343509
24,486,District - Vadodara (19),Total,10-14,395586,212089,183497,20300,130330,67452,31736,14654,17082,5369
24,486,District - Vadodara (19),Total,15-19,365284,195625,169659,20418,103843,54135,37570,14896,22674,26133
24,486,District - Vadodara (19),Total,20-24,370405,191631,178774,21151,97065,49354,52573,18506,34067,41716
24,486,District - Vadodara (19),Total,Adolescent (10-19),760870,407714,353156,40718,234173,121587,69306,29550,39756,31502
24,486,District - Vadodara (19),Total,Youth (15-24),735689,387256,348433,41569,200908,103489,90143,33402,56741,67849
24,486,District - Vadodara (19),Rural,All Ages,2099855,1077943,1021912,83102,1040599,529305,871247,362083,509164,324603
24,486,District - Vadodara (19),Rural,10-14,218736,114885,103851,7641,118588,61073,24258,11062,13196,5177
24,486,District - Vadodara (19),Rural,15-19,184919,97871,87048,7399,91876,47773,28560,10918,17642,24946
24,486,District - Vadodara (19),Rural,20-24,176398,91324,85074,6896,85642,43390,39845,13571,26274,39488
24,486,District - Vadodara (19),Rural,Adolescent (10-19),403655,212756,190899,15040,210464,108846,52818,21980,30838,30123
24,486,District - Vadodara (19),Rural,Youth (15-24),361317,189195,172122,14295,177518,91163,68405,24489,43916,64434
24,486,District - Vadodara (19),Urban,All Ages,2065771,1075793,989978,138527,109302,57360,401299,177566,223733,18906
24,486,District - Vadodara (19),Urban,10-14,176850,97204,79646,12659,11742,6379,7478,3592,3886,192
24,486,District - Vadodara (19),Urban,15-19,180365,97754,82611,13019,11967,6362,9010,3978,5032,1187
24,486,District - Vadodara (19),Urban,20-24,194007,100307,93700,14255,11423,5964,12728,4935,7793,2228
24,486,District - Vadodara (19),Urban,Adolescent (10-19),357215,194958,162257,25678,23709,12741,16488,7570,8918,1379
24,486,District - Vadodara (19),Urban,Youth (15-24),374372,198061,176311,27274,23390,12326,21738,8913,12825,3415
24,487,District - Narmada (20),Total,All Ages,590297,301086,289211,8733,481392,244524,219961,89319,130642,103360
24,487,District - Narmada (20),Total,10-14,68171,35393,32778,759,58303,30045,4107,1916,2191,1443
24,487,District - Narmada (20),Total,15-19,58948,30731,28217,849,48980,25476,5396,2040,3356,7375
24,487,District - Narmada (20),Total,20-24,50754,26035,24719,758,41262,21066,7852,2496,5356,12097
24,487,District - Narmada (20),Total,Adolescent (10-19),127119,66124,60995,1608,107283,55521,9503,3956,5547,8818
24,487,District - Narmada (20),Total,Youth (15-24),109702,56766,52936,1607,90242,46542,13248,4536,8712,19472
24,487,District - Narmada (20),Rural,All Ages,528425,269408,259017,5954,461391,234288,206748,83842,122906,101042
24,487,District - Narmada (20),Rural,10-14,61397,31761,29636,481,55367,28500,3891,1802,2089,1419
24,487,District - Narmada (20),Rural,15-19,52140,27165,24975,534,46222,23975,5105,1896,3209,7229
24,487,District - Narmada (20),Rural,20-24,44723,23005,21718,469,39284,20062,7497,2364,5133,11812
24,487,District - Narmada (20),Rural,Adolescent (10-19),113537,58926,54611,1015,101589,52475,8996,3698,5298,8648
24,487,District - Narmada (20),Rural,Youth (15-24),96863,50170,46693,1003,85506,44037,12602,4260,8342,19041
24,487,District - Narmada (20),Urban,All Ages,61872,31678,30194,2779,20001,10236,13213,5477,7736,2318
24,487,District - Narmada (20),Urban,10-14,6774,3632,3142,278,2936,1545,216,114,102,24
24,487,District - Narmada (20),Urban,15-19,6808,3566,3242,315,2758,1501,291,144,147,146
24,487,District - Narmada (20),Urban,20-24,6031,3030,3001,289,1978,1004,355,132,223,285
24,487,District - Narmada (20),Urban,Adolescent (10-19),13582,7198,6384,593,5694,3046,507,258,249,170
24,487,District - Narmada (20),Urban,Youth (15-24),12839,6596,6243,604,4736,2505,646,276,370,431
24,488,District - Bharuch (21),Total,All Ages,1551019,805707,745312,62235,488194,250398,432743,182660,250083,194819
24,488,District - Bharuch (21),Total,10-14,155698,81652,74046,5744,54015,27788,7487,3460,4027,2980
24,488,District - Bharuch (21),Total,15-19,148150,79484,68666,5761,48497,26092,10016,4548,5468,15458
24,488,District - Bharuch (21),Total,20-24,144474,78055,66419,5713,44932,24208,15155,6169,8986,22750
24,488,District - Bharuch (21),Total,Adolescent (10-19),303848,161136,142712,11505,102512,53880,17503,8008,9495,18438
24,488,District - Bharuch (21),Total,Youth (15-24),292624,157539,135085,11474,93429,50300,25171,10717,14454,38208
24,488,District - Bharuch (21),Rural,All Ages,1026060,529393,496667,35364,431980,221464,320602,132509,188093,187103
24,488,District - Bharuch (21),Rural,10-14,105970,54808,51162,3310,47813,24533,5074,2340,2734,2881
24,488,District - Bharuch (21),Rural,15-19,98117,52136,45981,3175,42545,22883,7224,3255,3969,14928
24,488,District - Bharuch (21),Rural,20-24,92930,50488,42442,2972,38845,20988,11169,4464,6705,21829
24,488,District - Bharuch (21),Rural,Adolescent (10-19),204087,106944,97143,6485,90358,47416,12298,5595,6703,17809
24,488,District - Bharuch (21),Rural,Youth (15-24),191047,102624,88423,6147,81390,43871,18393,7719,10674,36757
24,488,District - Bharuch (21),Urban,All Ages,524959,276314,248645,26871,56214,28934,112141,50151,61990,7716
24,488,District - Bharuch (21),Urban,10-14,49728,26844,22884,2434,6202,3255,2413,1120,1293,99
24,488,District - Bharuch (21),Urban,15-19,50033,27348,22685,2586,5952,3209,2792,1293,1499,530
24,488,District - Bharuch (21),Urban,20-24,51544,27567,23977,2741,6087,3220,3986,1705,2281,921
24,488,District - Bharuch (21),Urban,Adolescent (10-19),99761,54192,45569,5020,12154,6464,5205,2413,2792,629
24,488,District - Bharuch (21),Urban,Youth (15-24),101577,54915,46662,5327,12039,6429,6778,2998,3780,1451
24,489,District - The Dangs (22),Total,All Ages,228291,113821,114470,992,216073,107539,87323,36507,50816,22131
24,489,District - The Dangs (22),Total,10-14,28999,14855,14144,95,27748,14208,1356,679,677,602
24,489,District - The Dangs (22),Total,15-19,20443,10292,10151,86,19268,9699,1449,532,917,2171
24,489,District - The Dangs (22),Total,20-24,19599,9270,10329,91,18346,8629,2565,734,1831,3338
24,489,District - The Dangs (22),Total,Adolescent (10-19),49442,25147,24295,181,47016,23907,2805,1211,1594,2773
24,489,District - The Dangs (22),Total,Youth (15-24),40042,19562,20480,177,37614,18328,4014,1266,2748,5509
24,489,District - The Dangs (22),Rural,All Ages,203604,101710,101894,151,200138,99888,82007,34310,47697,21225
24,489,District - The Dangs (22),Rural,10-14,24977,12836,12141,20,24615,12641,1282,648,634,594
24,489,District - The Dangs (22),Rural,15-19,16787,8775,8012,8,16494,8634,1330,493,837,2110
24,489,District - The Dangs (22),Rural,20-24,17380,8133,9247,10,17040,7964,2414,684,1730,3209
24,489,District - The Dangs (22),Rural,Adolescent (10-19),41764,21611,20153,28,41109,21275,2612,1141,1471,2704
24,489,District - The Dangs (22),Rural,Youth (15-24),34167,16908,17259,18,33534,16598,3744,1177,2567,5319
24,489,District - The Dangs (22),Urban,All Ages,24687,12111,12576,841,15935,7651,5316,2197,3119,906
24,489,District - The Dangs (22),Urban,10-14,4022,2019,2003,75,3133,1567,74,31,43,8
24,489,District - The Dangs (22),Urban,15-19,3656,1517,2139,78,2774,1065,119,39,80,61
24,489,District - The Dangs (22),Urban,20-24,2219,1137,1082,81,1306,665,151,50,101,129
24,489,District - The Dangs (22),Urban,Adolescent (10-19),7678,3536,4142,153,5907,2632,193,70,123,69
24,489,District - The Dangs (22),Urban,Youth (15-24),5875,2654,3221,159,4080,1730,270,89,181,190
24,490,District - Navsari (23),Total,All Ages,1329672,678165,651507,35464,639659,319740,327763,138694,189069,162145
24,490,District - Navsari (23),Total,10-14,117314,61489,55825,2859,61013,31097,3782,1883,1899,1981
24,490,District - Navsari (23),Total,15-19,121560,64282,57278,2952,61004,31780,5045,2434,2611,12216
24,490,District - Navsari (23),Total,20-24,122364,63725,58639,3379,57282,29346,7772,3136,4636,17838
24,490,District - Navsari (23),Total,Adolescent (10-19),238874,125771,113103,5811,122017,62877,8827,4317,4510,14197
24,490,District - Navsari (23),Total,Youth (15-24),243924,128007,115917,6331,118286,61126,12817,5570,7247,30054
24,490,District - Navsari (23),Rural,All Ages,920535,464749,455786,17348,571812,285999,244452,101826,142626,156831
24,490,District - Navsari (23),Rural,10-14,83577,43232,40345,1275,54801,27822,2639,1301,1338,1905
24,490,District - Navsari (23),Rural,15-19,84894,44435,40459,1382,54219,28170,3459,1669,1790,11797
24,490,District - Navsari (23),Rural,20-24,81132,42059,39073,1497,50314,25886,5195,2135,3060,17236
24,490,District - Navsari (23),Rural,Adolescent (10-19),168471,87667,80804,2657,109020,55992,6098,2970,3128,13702
24,490,District - Navsari (23),Rural,Youth (15-24),166026,86494,79532,2879,104533,54056,8654,3804,4850,29033
24,490,District - Navsari (23),Urban,All Ages,409137,213416,195721,18116,67847,33741,83311,36868,46443,5314
24,490,District - Navsari (23),Urban,10-14,33737,18257,15480,1584,6212,3275,1143,582,561,76
24,490,District - Navsari (23),Urban,15-19,36666,19847,16819,1570,6785,3610,1586,765,821,419
24,490,District - Navsari (23),Urban,20-24,41232,21666,19566,1882,6968,3460,2577,1001,1576,602
24,490,District - Navsari (23),Urban,Adolescent (10-19),70403,38104,32299,3154,12997,6885,2729,1347,1382,495
24,490,District - Navsari (23),Urban,Youth (15-24),77898,41513,36385,3452,13753,7070,4163,1766,2397,1021
24,491,District - Valsad (24),Total,All Ages,1705678,887222,818456,38237,902794,450976,535021,231694,303327,89867
24,491,District - Valsad (24),Total,10-14,166818,87496,79322,3276,96279,49180,10406,4749,5657,1088
24,491,District - Valsad (24),Total,15-19,152922,82040,70882,3406,81435,41690,14304,5908,8396,5535
24,491,District - Valsad (24),Total,20-24,160029,85533,74496,3646,78102,38746,21626,7987,13639,9962
24,491,District - Valsad (24),Total,Adolescent (10-19),319740,169536,150204,6682,177714,90870,24710,10657,14053,6623
24,491,District - Valsad (24),Total,Youth (15-24),312951,167573,145378,7052,159537,80436,35930,13895,22035,15497
24,491,District - Valsad (24),Rural,All Ages,1070177,542644,527533,20777,785002,392473,398972,170335,228637,83891
24,491,District - Valsad (24),Rural,10-14,110038,56853,53185,1682,85085,43365,8307,3687,4620,1031
24,491,District - Valsad (24),Rural,15-19,94996,49398,45598,1781,69287,35458,11657,4540,7117,5205
24,491,District - Valsad (24),Rural,20-24,93093,47684,45409,1861,66077,32653,17068,5978,11090,9287
24,491,District - Valsad (24),Rural,Adolescent (10-19),205034,106251,98783,3463,154372,78823,19964,8227,11737,6236
24,491,District - Valsad (24),Rural,Youth (15-24),188089,97082,91007,3642,135364,68111,28725,10518,18207,14492
24,491,District - Valsad (24),Urban,All Ages,635501,344578,290923,17460,117792,58503,136049,61359,74690,5976
24,491,District - Valsad (24),Urban,10-14,56780,30643,26137,1594,11194,5815,2099,1062,1037,57
24,491,District - Valsad (24),Urban,15-19,57926,32642,25284,1625,12148,6232,2647,1368,1279,330
24,491,District - Valsad (24),Urban,20-24,66936,37849,29087,1785,12025,6093,4558,2009,2549,675
24,491,District - Valsad (24),Urban,Adolescent (10-19),114706,63285,51421,3219,23342,12047,4746,2430,2316,387
24,491,District - Valsad (24),Urban,Youth (15-24),124862,70491,54371,3410,24173,12325,7205,3377,3828,1005
24,492,District - Surat (25),Total,All Ages,6081322,3402224,2679098,158115,856952,432089,1509912,714756,795156,274736
24,492,District - Surat (25),Total,10-14,534689,295107,239582,14500,88769,45895,27623,14506,13117,5094
24,492,District - Surat (25),Total,15-19,586006,350310,235696,15745,82497,43312,37186,21185,16001,24245
24,492,District - Surat (25),Total,20-24,715502,428635,286867,16498,80762,41759,62642,30030,32612,33073
24,492,District - Surat (25),Total,Adolescent (10-19),1120695,645417,475278,30245,171266,89207,64809,35691,29118,29339
24,492,District - Surat (25),Total,Youth (15-24),1301508,778945,522563,32243,163259,85071,99828,51215,48613,57318
24,492,District - Surat (25),Rural,All Ages,1232109,640060,592049,38640,683413,342580,391665,170045,221620,252515
24,492,District - Surat (25),Rural,10-14,119109,62684,56425,3385,71613,36796,6420,3451,2969,4652
24,492,District - Surat (25),Rural,15-19,115462,62704,52758,3565,64399,33700,8829,4519,4310,22287
24,492,District - Surat (25),Rural,20-24,119461,66046,53415,3679,61369,31623,14114,6259,7855,30462
24,492,District - Surat (25),Rural,Adolescent (10-19),234571,125388,109183,6950,136012,70496,15249,7970,7279,26939
24,492,District - Surat (25),Rural,Youth (15-24),234923,128750,106173,7244,125768,65323,22943,10778,12165,52749
24,492,District - Surat (25),Urban,All Ages,4849213,2762164,2087049,119475,173539,89509,1118247,544711,573536,22221
24,492,District - Surat (25),Urban,10-14,415580,232423,183157,11115,17156,9099,21203,11055,10148,442
24,492,District - Surat (25),Urban,15-19,470544,287606,182938,12180,18098,9612,28357,16666,11691,1958
24,492,District - Surat (25),Urban,20-24,596041,362589,233452,12819,19393,10136,48528,23771,24757,2611
24,492,District - Surat (25),Urban,Adolescent (10-19),886124,520029,366095,23295,35254,18711,49560,27721,21839,2400
24,492,District - Surat (25),Urban,Youth (15-24),1066585,650195,416390,24999,37491,19748,76885,40437,36448,4569
24,493,District - Tapi (26),Total,All Ages,807022,402188,404834,8168,679320,335958,316986,133181,183805,174240
24,493,District - Tapi (26),Total,10-14,78061,40085,37976,794,66414,33881,4829,2506,2323,2570
24,493,District - Tapi (26),Total,15-19,73440,38167,35273,743,61756,31918,6619,3173,3446,12838
24,493,District - Tapi (26),Total,20-24,72403,35727,36676,797,60134,29410,10861,4236,6625,19902
24,493,District - Tapi (26),Total,Adolescent (10-19),151501,78252,73249,1537,128170,65799,11448,5679,5769,15408
24,493,District - Tapi (26),Total,Youth (15-24),145843,73894,71949,1540,121890,61328,17480,7409,10071,32740
24,493,District - Tapi (26),Rural,All Ages,727535,361548,365987,5296,657229,325023,297159,124814,172345,172826
24,493,District - Tapi (26),Rural,10-14,70736,36149,34587,525,64320,32743,4475,2324,2151,2562
24,493,District - Tapi (26),Rural,15-19,66205,34296,31909,502,59677,30836,6197,2990,3207,12764
24,493,District - Tapi (26),Rural,20-24,64586,31804,32782,482,58024,28372,10208,3975,6233,19764
24,493,District - Tapi (26),Rural,Adolescent (10-19),136941,70445,66496,1027,123997,63579,10672,5314,5358,15326
24,493,District - Tapi (26),Rural,Youth (15-24),130791,66100,64691,984,117701,59208,16405,6965,9440,32528
24,493,District - Tapi (26),Urban,All Ages,79487,40640,38847,2872,22091,10935,19827,8367,11460,1414
24,493,District - Tapi (26),Urban,10-14,7325,3936,3389,269,2094,1138,354,182,172,8
24,493,District - Tapi (26),Urban,15-19,7235,3871,3364,241,2079,1082,422,183,239,74
24,493,District - Tapi (26),Urban,20-24,7817,3923,3894,315,2110,1038,653,261,392,138
24,493,District - Tapi (26),Urban,Adolescent (10-19),14560,7807,6753,510,4173,2220,776,365,411,82
24,493,District - Tapi (26),Urban,Youth (15-24),15052,7794,7258,556,4189,2120,1075,444,631,212
25,0,State - DAMAN & DIU (25),Total,All Ages,243247,150301,92946,6124,15363,7771,54841,25658,29183,491
25,0,State - DAMAN & DIU (25),Total,10-14,17321,9300,8021,582,1504,764,579,287,292,3
25,0,State - DAMAN & DIU (25),Total,15-19,26314,18239,8075,629,1673,891,1728,1278,450,19
25,0,State - DAMAN & DIU (25),Total,20-24,38584,27925,10659,640,1722,847,3138,1909,1229,37
25,0,State - DAMAN & DIU (25),Total,Adolescent (10-19),43635,27539,16096,1211,3177,1655,2307,1565,742,22
25,0,State - DAMAN & DIU (25),Total,Youth (15-24),64898,46164,18734,1269,3395,1738,4866,3187,1679,56
25,0,State - DAMAN & DIU (25),Rural,All Ages,60396,32395,28001,2167,7617,3843,17307,6866,10441,321
25,0,State - DAMAN & DIU (25),Rural,10-14,6335,3302,3033,214,776,392,107,57,50,1
25,0,State - DAMAN & DIU (25),Rural,15-19,6655,3766,2889,218,818,432,194,123,71,9
25,0,State - DAMAN & DIU (25),Rural,20-24,7024,4117,2907,213,834,398,442,177,265,20
25,0,State - DAMAN & DIU (25),Rural,Adolescent (10-19),12990,7068,5922,432,1594,824,301,180,121,10
25,0,State - DAMAN & DIU (25),Rural,Youth (15-24),13679,7883,5796,431,1652,830,636,300,336,29
25,0,State - DAMAN & DIU (25),Urban,All Ages,182851,117906,64945,3957,7746,3928,37534,18792,18742,170
25,0,State - DAMAN & DIU (25),Urban,10-14,10986,5998,4988,368,728,372,472,230,242,2
25,0,State - DAMAN & DIU (25),Urban,15-19,19659,14473,5186,411,855,459,1534,1155,379,10
25,0,State - DAMAN & DIU (25),Urban,20-24,31560,23808,7752,427,888,449,2696,1732,964,17
25,0,State - DAMAN & DIU (25),Urban,Adolescent (10-19),30645,20471,10174,779,1583,831,2006,1385,621,12
25,0,State - DAMAN & DIU (25),Urban,Youth (15-24),51219,38281,12938,838,1743,908,4230,2887,1343,27
25,494,District - Diu (01),Total,All Ages,52074,25642,26432,1862,123,69,14016,5315,8701,189
25,494,District - Diu (01),Total,10-14,5793,2958,2835,181,10,7,63,32,31,1
25,494,District - Diu (01),Total,15-19,5467,2721,2746,207,20,15,79,36,43,6
25,494,District - Diu (01),Total,20-24,4892,2520,2372,201,16,8,214,74,140,12
25,494,District - Diu (01),Total,Adolescent (10-19),11260,5679,5581,388,30,22,142,68,74,7
25,494,District - Diu (01),Total,Youth (15-24),10359,5241,5118,408,36,23,293,110,183,18
25,494,District - Diu (01),Rural,All Ages,28083,14028,14055,493,2,1,9887,3765,6122,182
25,494,District - Diu (01),Rural,10-14,3632,1867,1765,53,0,0,44,22,22,1
25,494,District - Diu (01),Rural,15-19,3225,1620,1605,55,0,0,50,21,29,6
25,494,District - Diu (01),Rural,20-24,2784,1491,1293,53,2,1,184,61,123,12
25,494,District - Diu (01),Rural,Adolescent (10-19),6857,3487,3370,108,0,0,94,43,51,7
25,494,District - Diu (01),Rural,Youth (15-24),6009,3111,2898,108,2,1,234,82,152,18
25,494,District - Diu (01),Urban,All Ages,23991,11614,12377,1369,121,68,4129,1550,2579,7
25,494,District - Diu (01),Urban,10-14,2161,1091,1070,128,10,7,19,10,9,0
25,494,District - Diu (01),Urban,15-19,2242,1101,1141,152,20,15,29,15,14,0
25,494,District - Diu (01),Urban,20-24,2108,1029,1079,148,14,7,30,13,17,0
25,494,District - Diu (01),Urban,Adolescent (10-19),4403,2192,2211,280,30,22,48,25,23,0
25,494,District - Diu (01),Urban,Youth (15-24),4350,2130,2220,300,34,22,59,28,31,0
25,495,District - Daman (02),Total,All Ages,191173,124659,66514,4262,15240,7702,40825,20343,20482,302
25,495,District - Daman (02),Total,10-14,11528,6342,5186,401,1494,757,516,255,261,2
25,495,District - Daman (02),Total,15-19,20847,15518,5329,422,1653,876,1649,1242,407,13
25,495,District - Daman (02),Total,20-24,33692,25405,8287,439,1706,839,2924,1835,1089,25
25,495,District - Daman (02),Total,Adolescent (10-19),32375,21860,10515,823,3147,1633,2165,1497,668,15
25,495,District - Daman (02),Total,Youth (15-24),54539,40923,13616,861,3359,1715,4573,3077,1496,38
25,495,District - Daman (02),Rural,All Ages,32313,18367,13946,1674,7615,3842,7420,3101,4319,139
25,495,District - Daman (02),Rural,10-14,2703,1435,1268,161,776,392,63,35,28,0
25,495,District - Daman (02),Rural,15-19,3430,2146,1284,163,818,432,144,102,42,3
25,495,District - Daman (02),Rural,20-24,4240,2626,1614,160,832,397,258,116,142,8
25,495,District - Daman (02),Rural,Adolescent (10-19),6133,3581,2552,324,1594,824,207,137,70,3
25,495,District - Daman (02),Rural,Youth (15-24),7670,4772,2898,323,1650,829,402,218,184,11
25,495,District - Daman (02),Urban,All Ages,158860,106292,52568,2588,7625,3860,33405,17242,16163,163
25,495,District - Daman (02),Urban,10-14,8825,4907,3918,240,718,365,453,220,233,2
25,495,District - Daman (02),Urban,15-19,17417,13372,4045,259,835,444,1505,1140,365,10
25,495,District - Daman (02),Urban,20-24,29452,22779,6673,279,874,442,2666,1719,947,17
25,495,District - Daman (02),Urban,Adolescent (10-19),26242,18279,7963,499,1553,809,1958,1360,598,12
25,495,District - Daman (02),Urban,Youth (15-24),46869,36151,10718,538,1709,886,4171,2859,1312,27
26,0,State - DADRA & NAGAR HAVELI (26),Total,All Ages,343709,193760,149949,6186,178564,88844,120479,51239,69240,6184
26,0,State - DADRA & NAGAR HAVELI (26),Total,10-14,35003,18385,16618,605,23684,12164,1628,561,1067,113
26,0,State - DADRA & NAGAR HAVELI (26),Total,15-19,33104,19979,13125,592,18289,9373,3539,1187,2352,557
26,0,State - DADRA & NAGAR HAVELI (26),Total,20-24,44301,27595,16706,725,17588,8447,6695,1993,4702,954
26,0,State - DADRA & NAGAR HAVELI (26),Total,Adolescent (10-19),68107,38364,29743,1197,41973,21537,5167,1748,3419,670
26,0,State - DADRA & NAGAR HAVELI (26),Total,Youth (15-24),77405,47574,29831,1317,35877,17820,10234,3180,7054,1511
26,0,State - DADRA & NAGAR HAVELI (26),Rural,All Ages,183114,98305,84809,1296,150944,75049,83972,34255,49717,5456
26,0,State - DADRA & NAGAR HAVELI (26),Rural,10-14,22352,11564,10788,114,20641,10632,1231,370,861,105
26,0,State - DADRA & NAGAR HAVELI (26),Rural,15-19,19013,10775,8238,122,15457,7893,2863,781,2082,502
26,0,State - DADRA & NAGAR HAVELI (26),Rural,20-24,21932,13066,8866,192,14666,7056,5330,1388,3942,867
26,0,State - DADRA & NAGAR HAVELI (26),Rural,Adolescent (10-19),41365,22339,19026,236,36098,18525,4094,1151,2943,607
26,0,State - DADRA & NAGAR HAVELI (26),Rural,Youth (15-24),40945,23841,17104,314,30123,14949,8193,2169,6024,1369
26,0,State - DADRA & NAGAR HAVELI (26),Urban,All Ages,160595,95455,65140,4890,27620,13795,36507,16984,19523,728
26,0,State - DADRA & NAGAR HAVELI (26),Urban,10-14,12651,6821,5830,491,3043,1532,397,191,206,8
26,0,State - DADRA & NAGAR HAVELI (26),Urban,15-19,14091,9204,4887,470,2832,1480,676,406,270,55
26,0,State - DADRA & NAGAR HAVELI (26),Urban,20-24,22369,14529,7840,533,2922,1391,1365,605,760,87
26,0,State - DADRA & NAGAR HAVELI (26),Urban,Adolescent (10-19),26742,16025,10717,961,5875,3012,1073,597,476,63
26,0,State - DADRA & NAGAR HAVELI (26),Urban,Youth (15-24),36460,23733,12727,1003,5754,2871,2041,1011,1030,142
26,496,District - Dadra & Nagar Haveli (01),Total,All Ages,343709,193760,149949,6186,178564,88844,120479,51239,69240,6184
26,496,District - Dadra & Nagar Haveli (01),Total,10-14,35003,18385,16618,605,23684,12164,1628,561,1067,113
26,496,District - Dadra & Nagar Haveli (01),Total,15-19,33104,19979,13125,592,18289,9373,3539,1187,2352,557
26,496,District - Dadra & Nagar Haveli (01),Total,20-24,44301,27595,16706,725,17588,8447,6695,1993,4702,954
26,496,District - Dadra & Nagar Haveli (01),Total,Adolescent (10-19),68107,38364,29743,1197,41973,21537,5167,1748,3419,670
26,496,District - Dadra & Nagar Haveli (01),Total,Youth (15-24),77405,47574,29831,1317,35877,17820,10234,3180,7054,1511
26,496,District - Dadra & Nagar Haveli (01),Rural,All Ages,183114,98305,84809,1296,150944,75049,83972,34255,49717,5456
26,496,District - Dadra & Nagar Haveli (01),Rural,10-14,22352,11564,10788,114,20641,10632,1231,370,861,105
26,496,District - Dadra & Nagar Haveli (01),Rural,15-19,19013,10775,8238,122,15457,7893,2863,781,2082,502
26,496,District - Dadra & Nagar Haveli (01),Rural,20-24,21932,13066,8866,192,14666,7056,5330,1388,3942,867
26,496,District - Dadra & Nagar Haveli (01),Rural,Adolescent (10-19),41365,22339,19026,236,36098,18525,4094,1151,2943,607
26,496,District - Dadra & Nagar Haveli (01),Rural,Youth (15-24),40945,23841,17104,314,30123,14949,8193,2169,6024,1369
26,496,District - Dadra & Nagar Haveli (01),Urban,All Ages,160595,95455,65140,4890,27620,13795,36507,16984,19523,728
26,496,District - Dadra & Nagar Haveli (01),Urban,10-14,12651,6821,5830,491,3043,1532,397,191,206,8
26,496,District - Dadra & Nagar Haveli (01),Urban,15-19,14091,9204,4887,470,2832,1480,676,406,270,55
26,496,District - Dadra & Nagar Haveli (01),Urban,20-24,22369,14529,7840,533,2922,1391,1365,605,760,87
26,496,District - Dadra & Nagar Haveli (01),Urban,Adolescent (10-19),26742,16025,10717,961,5875,3012,1073,597,476,63
26,496,District - Dadra & Nagar Haveli (01),Urban,Youth (15-24),36460,23733,12727,1003,5754,2871,2041,1011,1030,142
27,0,State - MAHARASHTRA (27),Total,All Ages,112374333,58243056,54131277,13275898,10510213,5315025,30820043,12985472,17834571,11068928
27,0,State - MAHARASHTRA (27),Total,10-14,10734535,5662261,5072274,1331930,1257630,652732,477136,230640,246496,132137
27,0,State - MAHARASHTRA (27),Total,15-19,10627267,5710400,4916867,1317278,1077367,562944,543405,251335,292070,760741
27,0,State - MAHARASHTRA (27),Total,20-24,11090966,5845114,5245852,1363131,994716,497463,832751,325290,507461,1421928
27,0,State - MAHARASHTRA (27),Total,Adolescent (10-19),21361802,11372661,9989141,2649208,2334997,1215676,1020541,481975,538566,892878
27,0,State - MAHARASHTRA (27),Total,Youth (15-24),21718233,11555514,10162719,2680409,2072083,1060407,1376156,576625,799531,2182669
27,0,State - MAHARASHTRA (27),Rural,All Ages,61556074,31539034,30017040,7494819,9006077,4540456,20073313,8147559,11925754,10449281
27,0,State - MAHARASHTRA (27),Rural,10-14,6256057,3288156,2967901,779150,1097937,568373,293291,136100,157191,127212
27,0,State - MAHARASHTRA (27),Rural,15-19,5979665,3209224,2770441,742196,921289,480800,339236,143706,195530,727775
27,0,State - MAHARASHTRA (27),Rural,20-24,5764844,3018199,2746645,720109,832218,414510,512910,177013,335897,1354955
27,0,State - MAHARASHTRA (27),Rural,Adolescent (10-19),12235722,6497380,5738342,1521346,2019226,1049173,632527,279806,352721,854987
27,0,State - MAHARASHTRA (27),Rural,Youth (15-24),11744509,6227423,5517086,1462305,1753507,895310,852146,320719,531427,2082730
27,0,State - MAHARASHTRA (27),Urban,All Ages,50818259,26704022,24114237,5781079,1504136,774569,10746730,4837913,5908817,619647
27,0,State - MAHARASHTRA (27),Urban,10-14,4478478,2374105,2104373,552780,159693,84359,183845,94540,89305,4925
27,0,State - MAHARASHTRA (27),Urban,15-19,4647602,2501176,2146426,575082,156078,82144,204169,107629,96540,32966
27,0,State - MAHARASHTRA (27),Urban,20-24,5326122,2826915,2499207,643022,162498,82953,319841,148277,171564,66973
27,0,State - MAHARASHTRA (27),Urban,Adolescent (10-19),9126080,4875281,4250799,1127862,315771,166503,388014,202169,185845,37891
27,0,State - MAHARASHTRA (27),Urban,Youth (15-24),9973724,5328091,4645633,1218104,318576,165097,524010,255906,268104,99939
27,497,District - Nandurbar (01),Total,All Ages,1648295,833170,815125,47985,1141933,568026,741786,321071,420715,350630
27,497,District - Nandurbar (01),Total,10-14,202371,106324,96047,5240,149618,76568,25500,11187,14313,8872
27,497,District - Nandurbar (01),Total,15-19,176737,91697,85040,5030,122841,61740,31878,12632,19246,34259
27,497,District - Nandurbar (01),Total,20-24,150545,74923,75622,4555,102431,49230,42424,14930,27494,49118
27,497,District - Nandurbar (01),Total,Adolescent (10-19),379108,198021,181087,10270,272459,138308,57378,23819,33559,43131
27,497,District - Nandurbar (01),Total,Youth (15-24),327282,166620,160662,9585,225272,110970,74302,27562,46740,83377
27,497,District - Nandurbar (01),Rural,All Ages,1372821,687671,685150,30550,1094302,544172,676561,292357,384204,341779
27,497,District - Nandurbar (01),Rural,10-14,169724,87280,82444,3312,142119,72563,23933,10404,13529,8676
27,497,District - Nandurbar (01),Rural,15-19,143816,73032,70784,3162,116369,58442,29896,11681,18215,33479
27,497,District - Nandurbar (01),Rural,20-24,122491,59942,62549,2735,97703,46828,40109,14035,26074,48102
27,497,District - Nandurbar (01),Rural,Adolescent (10-19),313540,160312,153228,6474,258488,131005,53829,22085,31744,42155
27,497,District - Nandurbar (01),Rural,Youth (15-24),266307,132974,133333,5897,214072,105270,70005,25716,44289,81581
27,497,District - Nandurbar (01),Urban,All Ages,275474,145499,129975,17435,47631,23854,65225,28714,36511,8851
27,497,District - Nandurbar (01),Urban,10-14,32647,19044,13603,1928,7499,4005,1567,783,784,196
27,497,District - Nandurbar (01),Urban,15-19,32921,18665,14256,1868,6472,3298,1982,951,1031,780
27,497,District - Nandurbar (01),Urban,20-24,28054,14981,13073,1820,4728,2402,2315,895,1420,1016
27,497,District - Nandurbar (01),Urban,Adolescent (10-19),65568,37709,27859,3796,13971,7303,3549,1734,1815,976
27,497,District - Nandurbar (01),Urban,Youth (15-24),60975,33646,27329,3688,11200,5700,4297,1846,2451,1796
27,498,District - Dhule (02),Total,All Ages,2050862,1054031,996831,127571,647315,327034,756946,330643,426303,365828
27,498,District - Dhule (02),Total,10-14,218028,116595,101433,13959,79488,41759,23022,11071,11951,7983
27,498,District - Dhule (02),Total,15-19,196808,105508,91300,13119,61461,32897,24946,11203,13743,30061
27,498,District - Dhule (02),Total,20-24,186115,96888,89227,12296,54490,26993,34047,13223,20824,47611
27,498,District - Dhule (02),Total,Adolescent (10-19),414836,222103,192733,27078,140949,74656,47968,22274,25694,38044
27,498,District - Dhule (02),Total,Youth (15-24),382923,202396,180527,25415,115951,59890,58993,24426,34567,77672
27,498,District - Dhule (02),Rural,All Ages,1479826,758916,720910,82299,607824,306730,622386,269438,352948,354419
27,498,District - Dhule (02),Rural,10-14,160465,85319,75146,9288,74503,38985,19495,9161,10334,7804
27,498,District - Dhule (02),Rural,15-19,138904,75188,63716,8307,56865,30423,21496,9406,12090,29277
27,498,District - Dhule (02),Rural,20-24,129797,68249,61548,7596,50620,25062,29723,11321,18402,46219
27,498,District - Dhule (02),Rural,Adolescent (10-19),299369,160507,138862,17595,131368,69408,40991,18567,22424,37081
27,498,District - Dhule (02),Rural,Youth (15-24),268701,143437,125264,15903,107485,55485,51219,20727,30492,75496
27,498,District - Dhule (02),Urban,All Ages,571036,295115,275921,45272,39491,20304,134560,61205,73355,11409
27,498,District - Dhule (02),Urban,10-14,57563,31276,26287,4671,4985,2774,3527,1910,1617,179
27,498,District - Dhule (02),Urban,15-19,57904,30320,27584,4812,4596,2474,3450,1797,1653,784
27,498,District - Dhule (02),Urban,20-24,56318,28639,27679,4700,3870,1931,4324,1902,2422,1392
27,498,District - Dhule (02),Urban,Adolescent (10-19),115467,61596,53871,9483,9581,5248,6977,3707,3270,963
27,498,District - Dhule (02),Urban,Youth (15-24),114222,58959,55263,9512,8466,4405,7774,3699,4075,2176
27,499,District - Jalgaon (03),Total,All Ages,4229917,2197365,2032552,389273,604367,310150,1338035,568142,769893,808872
27,499,District - Jalgaon (03),Total,10-14,422723,227537,195186,40609,71624,38566,31227,14902,16325,10258
27,499,District - Jalgaon (03),Total,15-19,408596,221597,186999,39113,59877,33058,35329,16204,19125,57440
27,499,District - Jalgaon (03),Total,20-24,400533,213114,187419,39002,54941,27892,48664,18518,30146,105194
27,499,District - Jalgaon (03),Total,Adolescent (10-19),831319,449134,382185,79722,131501,71624,66556,31106,35450,67698
27,499,District - Jalgaon (03),Total,Youth (15-24),809129,434711,374418,78115,114818,60950,83993,34722,49271,162634
27,499,District - Jalgaon (03),Rural,All Ages,2887206,1500514,1386692,267718,537071,275373,1009644,420264,589380,757301
27,499,District - Jalgaon (03),Rural,10-14,296104,159411,136693,28827,64351,34522,23287,10851,12436,9816
27,499,District - Jalgaon (03),Rural,15-19,279904,153891,126013,26639,53021,29444,26682,11917,14765,54627
27,499,District - Jalgaon (03),Rural,20-24,268951,145693,123258,25919,48187,24540,37733,13895,23838,99530
27,499,District - Jalgaon (03),Rural,Adolescent (10-19),576008,313302,262706,55466,117372,63966,49969,22768,27201,64443
27,499,District - Jalgaon (03),Rural,Youth (15-24),548855,299584,249271,52558,101208,53984,64415,25812,38603,154157
27,499,District - Jalgaon (03),Urban,All Ages,1342711,696851,645860,121555,67296,34777,328391,147878,180513,51571
27,499,District - Jalgaon (03),Urban,10-14,126619,68126,58493,11782,7273,4044,7940,4051,3889,442
27,499,District - Jalgaon (03),Urban,15-19,128692,67706,60986,12474,6856,3614,8647,4287,4360,2813
27,499,District - Jalgaon (03),Urban,20-24,131582,67421,64161,13083,6754,3352,10931,4623,6308,5664
27,499,District - Jalgaon (03),Urban,Adolescent (10-19),255311,135832,119479,24256,14129,7658,16587,8338,8249,3255
27,499,District - Jalgaon (03),Urban,Youth (15-24),260274,135127,125147,25557,13610,6966,19578,8910,10668,8477
27,500,District - Buldana (04),Total,All Ages,2586258,1337560,1248698,470895,124837,64153,706384,288668,417716,537970
27,500,District - Buldana (04),Total,10-14,269529,141754,127775,51711,16685,8828,8399,3803,4596,5972
27,500,District - Buldana (04),Total,15-19,256362,136680,119682,47106,12809,6779,9249,3793,5456,36592
27,500,District - Buldana (04),Total,20-24,251706,133914,117792,46394,11325,5666,14454,4802,9652,75304
27,500,District - Buldana (04),Total,Adolescent (10-19),525891,278434,247457,98817,29494,15607,17648,7596,10052,42564
27,500,District - Buldana (04),Total,Youth (15-24),508068,270594,237474,93500,24134,12445,23703,8595,15108,111896
27,500,District - Buldana (04),Rural,All Ages,2037398,1055242,982156,395137,116176,59525,586640,236671,349969,504615
27,500,District - Buldana (04),Rural,10-14,213673,112147,101526,43640,15509,8115,6676,2953,3723,5769
27,500,District - Buldana (04),Rural,15-19,201499,107821,93678,39182,11814,6212,7482,2936,4546,34783
27,500,District - Buldana (04),Rural,20-24,197590,106149,91441,38570,10404,5216,12023,3822,8201,71385
27,500,District - Buldana (04),Rural,Adolescent (10-19),415172,219968,195204,82822,27323,14327,14158,5889,8269,40552
27,500,District - Buldana (04),Rural,Youth (15-24),399089,213970,185119,77752,22218,11428,19505,6758,12747,106168
27,500,District - Buldana (04),Urban,All Ages,548860,282318,266542,75758,8661,4628,119744,51997,67747,33355
27,500,District - Buldana (04),Urban,10-14,55856,29607,26249,8071,1176,713,1723,850,873,203
27,500,District - Buldana (04),Urban,15-19,54863,28859,26004,7924,995,567,1767,857,910,1809
27,500,District - Buldana (04),Urban,20-24,54116,27765,26351,7824,921,450,2431,980,1451,3919
27,500,District - Buldana (04),Urban,Adolescent (10-19),110719,58466,52253,15995,2171,1280,3490,1707,1783,2012
27,500,District - Buldana (04),Urban,Youth (15-24),108979,56624,52355,15748,1916,1017,4198,1837,2361,5728
27,501,District - Akola (05),Total,All Ages,1813906,932334,881572,364059,100280,51359,402625,173357,229268,340583
27,501,District - Akola (05),Total,10-14,182016,94148,87868,37897,11767,6130,5292,2664,2628,3489
27,501,District - Akola (05),Total,15-19,181483,94484,86999,37300,10705,5704,5195,2570,2625,19195
27,501,District - Akola (05),Total,20-24,176234,92678,83556,36899,9558,4987,6962,2916,4046,42160
27,501,District - Akola (05),Total,Adolescent (10-19),363499,188632,174867,75197,22472,11834,10487,5234,5253,22684
27,501,District - Akola (05),Total,Youth (15-24),357717,187162,170555,74199,20263,10691,12157,5486,6671,61355
27,501,District - Akola (05),Rural,All Ages,1094165,563933,530232,253575,85661,43797,264810,110789,154021,308716
27,501,District - Akola (05),Rural,10-14,112037,57968,54069,26888,10295,5347,3349,1659,1690,3293
27,501,District - Akola (05),Rural,15-19,109953,57551,52402,26045,9252,4857,3235,1508,1727,17259
27,501,District - Akola (05),Rural,20-24,104997,56076,48921,25041,8128,4263,4426,1691,2735,38335
27,501,District - Akola (05),Rural,Adolescent (10-19),221990,115519,106471,52933,19547,10204,6584,3167,3417,20552
27,501,District - Akola (05),Rural,Youth (15-24),214950,113627,101323,51086,17380,9120,7661,3199,4462,55594
27,501,District - Akola (05),Urban,All Ages,719741,368401,351340,110484,14619,7562,137815,62568,75247,31867
27,501,District - Akola (05),Urban,10-14,69979,36180,33799,11009,1472,783,1943,1005,938,196
27,501,District - Akola (05),Urban,15-19,71530,36933,34597,11255,1453,847,1960,1062,898,1936
27,501,District - Akola (05),Urban,20-24,71237,36602,34635,11858,1430,724,2536,1225,1311,3825
27,501,District - Akola (05),Urban,Adolescent (10-19),141509,73113,68396,22264,2925,1630,3903,2067,1836,2132
27,501,District - Akola (05),Urban,Youth (15-24),142767,73535,69232,23113,2883,1571,4496,2287,2209,5761
27,502,District - Washim (06),Total,All Ages,1197160,620302,576858,229462,80471,41403,327243,132599,194644,265060
27,502,District - Washim (06),Total,10-14,131385,69213,62172,26123,10476,5628,3327,1517,1810,3309
27,502,District - Washim (06),Total,15-19,121259,65274,55985,23205,9021,4870,3940,1552,2388,17271
27,502,District - Washim (06),Total,20-24,112637,61091,51546,21655,7318,3895,6283,1943,4340,35120
27,502,District - Washim (06),Total,Adolescent (10-19),252644,134487,118157,49328,19497,10498,7267,3069,4198,20580
27,502,District - Washim (06),Total,Youth (15-24),233896,126365,107531,44860,16339,8765,10223,3495,6728,52391
27,502,District - Washim (06),Rural,All Ages,985747,511727,474020,200187,77404,39801,278991,111243,167748,250570
27,502,District - Washim (06),Rural,10-14,108554,57399,51155,22796,10100,5422,2534,1113,1421,3197
27,502,District - Washim (06),Rural,15-19,99468,53978,45490,20206,8640,4651,3196,1186,2010,16416
27,502,District - Washim (06),Rural,20-24,92118,50446,41672,18740,7010,3723,5332,1555,3777,33412
27,502,District - Washim (06),Rural,Adolescent (10-19),208022,111377,96645,43002,18740,10073,5730,2299,3431,19613
27,502,District - Washim (06),Rural,Youth (15-24),191586,104424,87162,38946,15650,8374,8528,2741,5787,49828
27,502,District - Washim (06),Urban,All Ages,211413,108575,102838,29275,3067,1602,48252,21356,26896,14490
27,502,District - Washim (06),Urban,10-14,22831,11814,11017,3327,376,206,793,404,389,112
27,502,District - Washim (06),Urban,15-19,21791,11296,10495,2999,381,219,744,366,378,855
27,502,District - Washim (06),Urban,20-24,20519,10645,9874,2915,308,172,951,388,563,1708
27,502,District - Washim (06),Urban,Adolescent (10-19),44622,23110,21512,6326,757,425,1537,770,767,967
27,502,District - Washim (06),Urban,Youth (15-24),42310,21941,20369,5914,689,391,1695,754,941,2563
27,503,District - Amravati (07),Total,All Ages,2888445,1480768,1407677,506374,404128,205834,636570,273664,362906,552820
27,503,District - Amravati (07),Total,10-14,284577,146177,138400,48784,55250,28172,6320,3274,3046,2581
27,503,District - Amravati (07),Total,15-19,286150,147524,138626,50507,47778,24747,7043,3197,3846,28184
27,503,District - Amravati (07),Total,20-24,278265,144101,134164,51242,38466,19751,10511,4191,6320,61745
27,503,District - Amravati (07),Total,Adolescent (10-19),570727,293701,277026,99291,103028,52919,13363,6471,6892,30765
27,503,District - Amravati (07),Total,Youth (15-24),564415,291625,272790,101749,86244,44498,17554,7388,10166,89929
27,503,District - Amravati (07),Rural,All Ages,1851158,950633,900525,346056,368630,187465,450463,188968,261495,500018
27,503,District - Amravati (07),Rural,10-14,188147,96366,91781,33319,50700,25758,4003,1976,2027,2374
27,503,District - Amravati (07),Rural,15-19,185783,95883,89900,34499,43594,22464,4814,1980,2834,25947
27,503,District - Amravati (07),Rural,20-24,176132,92027,84105,34320,34821,17802,7382,2645,4737,56452
27,503,District - Amravati (07),Rural,Adolescent (10-19),373930,192249,181681,67818,94294,48222,8817,3956,4861,28321
27,503,District - Amravati (07),Rural,Youth (15-24),361915,187910,174005,68819,78415,40266,12196,4625,7571,82399
27,503,District - Amravati (07),Urban,All Ages,1037287,530135,507152,160318,35498,18369,186107,84696,101411,52802
27,503,District - Amravati (07),Urban,10-14,96430,49811,46619,15465,4550,2414,2317,1298,1019,207
27,503,District - Amravati (07),Urban,15-19,100367,51641,48726,16008,4184,2283,2229,1217,1012,2237
27,503,District - Amravati (07),Urban,20-24,102133,52074,50059,16922,3645,1949,3129,1546,1583,5293
27,503,District - Amravati (07),Urban,Adolescent (10-19),196797,101452,95345,31473,8734,4697,4546,2515,2031,2444
27,503,District - Amravati (07),Urban,Youth (15-24),202500,103715,98785,32930,7829,4232,5358,2763,2595,7530
27,504,District - Wardha (08),Total,All Ages,1300774,668385,632389,188830,149507,76698,281316,115768,165548,233609
27,504,District - Wardha (08),Total,10-14,115620,60061,55559,16222,15235,7956,1664,812,852,717
27,504,District - Wardha (08),Total,15-19,119648,62049,57599,17547,15239,7924,1892,851,1041,10389
27,504,District - Wardha (08),Total,20-24,123796,63617,60179,18644,14913,7703,2780,1152,1628,24100
27,504,District - Wardha (08),Total,Adolescent (10-19),235268,122110,113158,33769,30474,15880,3556,1663,1893,11106
27,504,District - Wardha (08),Total,Youth (15-24),243444,125666,117778,36191,30152,15627,4672,2003,2669,34489
27,504,District - Wardha (08),Rural,All Ages,877474,451874,425600,114889,125090,64327,212392,86676,125716,217833
27,504,District - Wardha (08),Rural,10-14,79525,41119,38406,9938,12984,6764,1153,565,588,683
27,504,District - Wardha (08),Rural,15-19,81770,42466,39304,10509,12952,6718,1281,600,681,9813
27,504,District - Wardha (08),Rural,20-24,82583,43314,39269,10957,12359,6467,1987,828,1159,22880
27,504,District - Wardha (08),Rural,Adolescent (10-19),161295,83585,77710,20447,25936,13482,2434,1165,1269,10496
27,504,District - Wardha (08),Rural,Youth (15-24),164353,85780,78573,21466,25311,13185,3268,1428,1840,32693
27,504,District - Wardha (08),Urban,All Ages,423300,216511,206789,73941,24417,12371,68924,29092,39832,15776
27,504,District - Wardha (08),Urban,10-14,36095,18942,17153,6284,2251,1192,511,247,264,34
27,504,District - Wardha (08),Urban,15-19,37878,19583,18295,7038,2287,1206,611,251,360,576
27,504,District - Wardha (08),Urban,20-24,41213,20303,20910,7687,2554,1236,793,324,469,1220
27,504,District - Wardha (08),Urban,Adolescent (10-19),73973,38525,35448,13322,4538,2398,1122,498,624,610
27,504,District - Wardha (08),Urban,Youth (15-24),79091,39886,39205,14725,4841,2442,1404,575,829,1796
27,505,District - Nagpur (09),Total,All Ages,4653570,2384975,2268595,867713,437571,223566,979762,425755,554007,338352
27,505,District - Nagpur (09),Total,10-14,410276,211457,198819,75533,43084,21842,11714,6102,5612,1436
27,505,District - Nagpur (09),Total,15-19,428956,222841,206115,79901,43879,22610,12242,6132,6110,17027
27,505,District - Nagpur (09),Total,20-24,470263,240179,230084,90031,45368,23522,17147,7641,9506,38235
27,505,District - Nagpur (09),Total,Adolescent (10-19),839232,434298,404934,155434,86963,44452,23956,12234,11722,18463
27,505,District - Nagpur (09),Total,Youth (15-24),899219,463020,436199,169932,89247,46132,29389,13773,15616,55262
27,505,District - Nagpur (09),Rural,All Ages,1474811,758357,716454,234062,200154,102275,401832,168530,233302,306824
27,505,District - Nagpur (09),Rural,10-14,136067,69339,66728,20979,21449,10805,4337,2164,2173,1352
27,505,District - Nagpur (09),Rural,15-19,142104,73329,68775,22230,21475,11050,4745,2268,2477,15905
27,505,District - Nagpur (09),Rural,20-24,147420,77086,70334,23302,20476,10747,6489,2840,3649,35607
27,505,District - Nagpur (09),Rural,Adolescent (10-19),278171,142668,135503,43209,42924,21855,9082,4432,4650,17257
27,505,District - Nagpur (09),Rural,Youth (15-24),289524,150415,139109,45532,41951,21797,11234,5108,6126,51512
27,505,District - Nagpur (09),Urban,All Ages,3178759,1626618,1552141,633651,237417,121291,577930,257225,320705,31528
27,505,District - Nagpur (09),Urban,10-14,274209,142118,132091,54554,21635,11037,7377,3938,3439,84
27,505,District - Nagpur (09),Urban,15-19,286852,149512,137340,57671,22404,11560,7497,3864,3633,1122
27,505,District - Nagpur (09),Urban,20-24,322843,163093,159750,66729,24892,12775,10658,4801,5857,2628
27,505,District - Nagpur (09),Urban,Adolescent (10-19),561061,291630,269431,112225,44039,22597,14874,7802,7072,1206
27,505,District - Nagpur (09),Urban,Youth (15-24),609695,312605,297090,124400,47296,24335,18155,8665,9490,3750
27,506,District - Bhandara (10),Total,All Ages,1200334,605520,594814,200372,88886,44515,300474,116811,183663,182433
27,506,District - Bhandara (10),Total,10-14,113835,58120,55715,18511,9619,4958,3457,1815,1642,747
27,506,District - Bhandara (10),Total,15-19,113720,58153,55567,18347,9029,4506,3275,1681,1594,7119
27,506,District - Bhandara (10),Total,20-24,114384,58687,55697,18848,8664,4404,4021,1962,2059,21401
27,506,District - Bhandara (10),Total,Adolescent (10-19),227555,116273,111282,36858,18648,9464,6732,3496,3236,7866
27,506,District - Bhandara (10),Total,Youth (15-24),228104,116840,111264,37195,17693,8910,7296,3643,3653,28520
27,506,District - Bhandara (10),Rural,All Ages,966503,487484,479019,155163,78943,39532,258175,99042,159133,177033
27,506,District - Bhandara (10),Rural,10-14,92538,47152,45386,14309,8635,4476,2822,1458,1364,738
27,506,District - Bhandara (10),Rural,15-19,91965,46928,45037,14115,7971,3985,2725,1354,1371,7007
27,506,District - Bhandara (10),Rural,20-24,91549,47350,44199,14356,7559,3852,3347,1618,1729,21038
27,506,District - Bhandara (10),Rural,Adolescent (10-19),184503,94080,90423,28424,16606,8461,5547,2812,2735,7745
27,506,District - Bhandara (10),Rural,Youth (15-24),183514,94278,89236,28471,15530,7837,6072,2972,3100,28045
27,506,District - Bhandara (10),Urban,All Ages,233831,118036,115795,45209,9943,4983,42299,17769,24530,5400
27,506,District - Bhandara (10),Urban,10-14,21297,10968,10329,4202,984,482,635,357,278,9
27,506,District - Bhandara (10),Urban,15-19,21755,11225,10530,4232,1058,521,550,327,223,112
27,506,District - Bhandara (10),Urban,20-24,22835,11337,11498,4492,1105,552,674,344,330,363
27,506,District - Bhandara (10),Urban,Adolescent (10-19),43052,22193,20859,8434,2042,1003,1185,684,501,121
27,506,District - Bhandara (10),Urban,Youth (15-24),44590,22562,22028,8724,2163,1073,1224,671,553,475
27,507,District - Gondiya (11),Total,All Ages,1322507,661554,660953,175961,214253,105944,318264,118717,199547,147366
27,507,District - Gondiya (11),Total,10-14,131663,67186,64477,16799,25898,13132,3066,1507,1559,1033
27,507,District - Gondiya (11),Total,15-19,132624,67000,65624,16692,24228,11978,2868,1336,1532,6605
27,507,District - Gondiya (11),Total,20-24,124979,63322,61657,17077,19405,9760,3266,1394,1872,17526
27,507,District - Gondiya (11),Total,Adolescent (10-19),264287,134186,130101,33491,50126,25110,5934,2843,3091,7638
27,507,District - Gondiya (11),Total,Youth (15-24),257603,130322,127281,33769,43633,21738,6134,2730,3404,24131
27,507,District - Gondiya (11),Rural,All Ages,1096577,547934,548643,135393,201913,99729,278156,102444,175712,143498
27,507,District - Gondiya (11),Rural,10-14,110592,56144,54448,12976,24308,12284,2631,1275,1356,1022
27,507,District - Gondiya (11),Rural,15-19,111323,56010,55313,12798,22616,11156,2467,1133,1334,6468
27,507,District - Gondiya (11),Rural,20-24,102960,52345,50615,12895,18120,9090,2825,1198,1627,17116
27,507,District - Gondiya (11),Rural,Adolescent (10-19),221915,112154,109761,25774,46924,23440,5098,2408,2690,7490
27,507,District - Gondiya (11),Rural,Youth (15-24),214283,108355,105928,25693,40736,20246,5292,2331,2961,23584
27,507,District - Gondiya (11),Urban,All Ages,225930,113620,112310,40568,12340,6215,40108,16273,23835,3868
27,507,District - Gondiya (11),Urban,10-14,21071,11042,10029,3823,1590,848,435,232,203,11
27,507,District - Gondiya (11),Urban,15-19,21301,10990,10311,3894,1612,822,401,203,198,137
27,507,District - Gondiya (11),Urban,20-24,22019,10977,11042,4182,1285,670,441,196,245,410
27,507,District - Gondiya (11),Urban,Adolescent (10-19),42372,22032,20340,7717,3202,1670,836,435,401,148
27,507,District - Gondiya (11),Urban,Youth (15-24),43320,21967,21353,8076,2897,1492,842,399,443,547
27,508,District - Gadchiroli (12),Total,All Ages,1072942,541328,531614,120745,415306,207377,364577,146218,218359,130112
27,508,District - Gadchiroli (12),Total,10-14,117564,60356,57208,12033,53247,27436,5094,2073,3021,2144
27,508,District - Gadchiroli (12),Total,15-19,116609,58926,57683,12659,48861,24420,6850,2380,4470,9499
27,508,District - Gadchiroli (12),Total,20-24,102773,52135,50638,11710,38737,19058,9557,2852,6705,17259
27,508,District - Gadchiroli (12),Total,Adolescent (10-19),234173,119282,114891,24692,102108,51856,11944,4453,7491,11643
27,508,District - Gadchiroli (12),Total,Youth (15-24),219382,111061,108321,24369,87598,43478,16407,5232,11175,26758
27,508,District - Gadchiroli (12),Rural,All Ages,954909,481290,473619,101879,398266,198753,341138,136697,204441,126176
27,508,District - Gadchiroli (12),Rural,10-14,105517,54184,51333,10099,51023,26303,4880,1984,2896,2135
27,508,District - Gadchiroli (12),Rural,15-19,104184,52564,51620,10654,46504,23180,6584,2270,4314,9372
27,508,District - Gadchiroli (12),Rural,20-24,91066,46251,44815,9859,36836,18095,9265,2722,6543,16891
27,508,District - Gadchiroli (12),Rural,Adolescent (10-19),209701,106748,102953,20753,97527,49483,11464,4254,7210,11507
27,508,District - Gadchiroli (12),Rural,Youth (15-24),195250,98815,96435,20513,83340,41275,15849,4992,10857,26263
27,508,District - Gadchiroli (12),Urban,All Ages,118033,60038,57995,18866,17040,8624,23439,9521,13918,3936
27,508,District - Gadchiroli (12),Urban,10-14,12047,6172,5875,1934,2224,1133,214,89,125,9
27,508,District - Gadchiroli (12),Urban,15-19,12425,6362,6063,2005,2357,1240,266,110,156,127
27,508,District - Gadchiroli (12),Urban,20-24,11707,5884,5823,1851,1901,963,292,130,162,368
27,508,District - Gadchiroli (12),Urban,Adolescent (10-19),24472,12534,11938,3939,4581,2373,480,199,281,136
27,508,District - Gadchiroli (12),Urban,Youth (15-24),24132,12246,11886,3856,4258,2203,558,240,318,495
27,509,District - Chandrapur (13),Total,All Ages,2204307,1123834,1080473,348365,389441,196753,625692,251269,374423,303057
27,509,District - Chandrapur (13),Total,10-14,204312,105849,98463,31281,39671,20390,6492,3187,3305,1430
27,509,District - Chandrapur (13),Total,15-19,214043,110091,103952,33630,40622,20763,7650,3521,4129,14956
27,509,District - Chandrapur (13),Total,20-24,217324,110798,106526,35550,38220,19552,10643,4265,6378,36597
27,509,District - Chandrapur (13),Total,Adolescent (10-19),418355,215940,202415,64911,80293,41153,14142,6708,7434,16386
27,509,District - Chandrapur (13),Total,Youth (15-24),431367,220889,210478,69180,78842,40315,18293,7786,10507,51553
27,509,District - Chandrapur (13),Rural,All Ages,1428929,726106,702823,187643,323796,163363,466535,184493,282042,291347
27,509,District - Chandrapur (13),Rural,10-14,134674,69190,65484,16800,33132,16980,4306,2095,2211,1398
27,509,District - Chandrapur (13),Rural,15-19,138749,71145,67604,17824,33794,17193,5306,2383,2923,14609
27,509,District - Chandrapur (13),Rural,20-24,135461,69948,65513,17818,31197,16048,7297,2871,4426,35615
27,509,District - Chandrapur (13),Rural,Adolescent (10-19),273423,140335,133088,34624,66926,34173,9612,4478,5134,16007
27,509,District - Chandrapur (13),Rural,Youth (15-24),274210,141093,133117,35642,64991,33241,12603,5254,7349,50224
27,509,District - Chandrapur (13),Urban,All Ages,775378,397728,377650,160722,65645,33390,159157,66776,92381,11710
27,509,District - Chandrapur (13),Urban,10-14,69638,36659,32979,14481,6539,3410,2186,1092,1094,32
27,509,District - Chandrapur (13),Urban,15-19,75294,38946,36348,15806,6828,3570,2344,1138,1206,347
27,509,District - Chandrapur (13),Urban,20-24,81863,40850,41013,17732,7023,3504,3346,1394,1952,982
27,509,District - Chandrapur (13),Urban,Adolescent (10-19),144932,75605,69327,30287,13367,6980,4530,2230,2300,379
27,509,District - Chandrapur (13),Urban,Youth (15-24),157157,79796,77361,33538,13851,7074,5690,2532,3158,1329
27,510,District - Yavatmal (14),Total,All Ages,2772348,1419965,1352383,328518,514057,260896,749774,303985,445789,633145
27,510,District - Yavatmal (14),Total,10-14,290304,151395,138909,33875,61068,31661,8393,3706,4687,8791
27,510,District - Yavatmal (14),Total,15-19,283138,149491,133647,32749,57949,30657,10071,4211,5860,46628
27,510,District - Yavatmal (14),Total,20-24,262712,136946,125766,32024,48419,25241,15618,4889,10729,81537
27,510,District - Yavatmal (14),Total,Adolescent (10-19),573442,300886,272556,66624,119017,62318,18464,7917,10547,55419
27,510,District - Yavatmal (14),Total,Youth (15-24),545850,286437,259413,64773,106368,55898,25689,9100,16589,128165
27,510,District - Yavatmal (14),Rural,All Ages,2174195,1115148,1059047,249800,473752,240656,638160,255467,382693,607327
27,510,District - Yavatmal (14),Rural,10-14,232038,120784,111254,25862,56512,29262,7048,3050,3998,8636
27,510,District - Yavatmal (14),Rural,15-19,225069,119778,105291,24937,53652,28450,8675,3570,5105,45334
27,510,District - Yavatmal (14),Rural,20-24,204881,108145,96736,24018,44337,23258,13866,4180,9686,78874
27,510,District - Yavatmal (14),Rural,Adolescent (10-19),457107,240562,216545,50799,110164,57712,15723,6620,9103,53970
27,510,District - Yavatmal (14),Rural,Youth (15-24),429950,227923,202027,48955,97989,51708,22541,7750,14791,124208
27,510,District - Yavatmal (14),Urban,All Ages,598153,304817,293336,78718,40305,20240,111614,48518,63096,25818
27,510,District - Yavatmal (14),Urban,10-14,58266,30611,27655,8013,4556,2399,1345,656,689,155
27,510,District - Yavatmal (14),Urban,15-19,58069,29713,28356,7812,4297,2207,1396,641,755,1294
27,510,District - Yavatmal (14),Urban,20-24,57831,28801,29030,8006,4082,1983,1752,709,1043,2663
27,510,District - Yavatmal (14),Urban,Adolescent (10-19),116335,60324,56011,15825,8853,4606,2741,1297,1444,1449
27,510,District - Yavatmal (14),Urban,Youth (15-24),115900,58514,57386,15818,8379,4190,3148,1350,1798,3957
27,511,District - Nanded (15),Total,All Ages,3361292,1730075,1631217,640483,281695,143892,1171867,474853,697014,539588
27,511,District - Nanded (15),Total,10-14,374776,196087,178689,72509,36052,18730,19748,9474,10274,7825
27,511,District - Nanded (15),Total,15-19,357044,194660,162384,70729,31381,17306,23700,10643,13057,46641
27,511,District - Nanded (15),Total,20-24,328772,174477,154295,64724,26266,14020,35289,12066,23223,76387
27,511,District - Nanded (15),Total,Adolescent (10-19),731820,390747,341073,143238,67433,36036,43448,20117,23331,54466
27,511,District - Nanded (15),Total,Youth (15-24),685816,369137,316679,135453,57647,31326,58989,22709,36280,123028
27,511,District - Nanded (15),Rural,All Ages,2447394,1258160,1189234,473434,241712,123467,918077,366110,551967,510577
27,511,District - Nanded (15),Rural,10-14,275026,143665,131361,54120,31679,16461,14535,6725,7810,7398
27,511,District - Nanded (15),Rural,15-19,258696,143316,115380,51899,26944,14894,17917,7755,10162,44582
27,511,District - Nanded (15),Rural,20-24,232966,124982,107984,46171,21881,11665,27777,8964,18813,73115
27,511,District - Nanded (15),Rural,Adolescent (10-19),533722,286981,246741,106019,58623,31355,32452,14480,17972,51980
27,511,District - Nanded (15),Rural,Youth (15-24),491662,268298,223364,98070,48825,26559,45694,16719,28975,117697
27,511,District - Nanded (15),Urban,All Ages,913898,471915,441983,167049,39983,20425,253790,108743,145047,29011
27,511,District - Nanded (15),Urban,10-14,99750,52422,47328,18389,4373,2269,5213,2749,2464,427
27,511,District - Nanded (15),Urban,15-19,98348,51344,47004,18830,4437,2412,5783,2888,2895,2059
27,511,District - Nanded (15),Urban,20-24,95806,49495,46311,18553,4385,2355,7512,3102,4410,3272
27,511,District - Nanded (15),Urban,Adolescent (10-19),198098,103766,94332,37219,8810,4681,10996,5637,5359,2486
27,511,District - Nanded (15),Urban,Youth (15-24),194154,100839,93315,37383,8822,4767,13295,5990,7305,5331
27,512,District - Hingoli (16),Total,All Ages,1177345,606294,571051,182565,111954,57674,386602,155743,230859,198494
27,512,District - Hingoli (16),Total,10-14,131504,68919,62585,20866,14015,7406,4897,2163,2734,3440
27,512,District - Hingoli (16),Total,15-19,119948,67289,52659,19174,11467,6536,5147,2098,3049,16771
27,512,District - Hingoli (16),Total,20-24,108312,57728,50584,16847,9764,5086,8247,2358,5889,27094
27,512,District - Hingoli (16),Total,Adolescent (10-19),251452,136208,115244,40040,25482,13942,10044,4261,5783,20211
27,512,District - Hingoli (16),Total,Youth (15-24),228260,125017,103243,36021,21231,11622,13394,4456,8938,43865
27,512,District - Hingoli (16),Rural,All Ages,998612,514430,484182,161751,106739,54901,340460,135733,204727,192201
27,512,District - Hingoli (16),Rural,10-14,110513,57773,52740,18308,13185,6898,4032,1715,2317,3356
27,512,District - Hingoli (16),Rural,15-19,100086,56802,43284,16858,10758,6155,4273,1677,2596,16323
27,512,District - Hingoli (16),Rural,20-24,90710,48613,42097,14736,9298,4843,7200,1947,5253,26355
27,512,District - Hingoli (16),Rural,Adolescent (10-19),210599,114575,96024,35166,23943,13053,8305,3392,4913,19679
27,512,District - Hingoli (16),Rural,Youth (15-24),190796,105415,85381,31594,20056,10998,11473,3624,7849,42678
27,512,District - Hingoli (16),Urban,All Ages,178733,91864,86869,20814,5215,2773,46142,20010,26132,6293
27,512,District - Hingoli (16),Urban,10-14,20991,11146,9845,2558,830,508,865,448,417,84
27,512,District - Hingoli (16),Urban,15-19,19862,10487,9375,2316,709,381,874,421,453,448
27,512,District - Hingoli (16),Urban,20-24,17602,9115,8487,2111,466,243,1047,411,636,739
27,512,District - Hingoli (16),Urban,Adolescent (10-19),40853,21633,19220,4874,1539,889,1739,869,870,532
27,512,District - Hingoli (16),Urban,Youth (15-24),37464,19602,17862,4427,1175,624,1921,832,1089,1187
27,513,District - Parbhani (17),Total,All Ages,1836086,942870,893216,247308,40514,20570,678272,276579,401693,288438
27,513,District - Parbhani (17),Total,10-14,200359,104511,95848,28230,4785,2449,11693,5519,6174,3787
27,513,District - Parbhani (17),Total,15-19,189391,104583,84808,26229,4051,2239,13140,6110,7030,24711
27,513,District - Parbhani (17),Total,20-24,173587,91586,82001,23694,3415,1701,18907,6708,12199,38860
27,513,District - Parbhani (17),Total,Adolescent (10-19),389750,209094,180656,54459,8836,4688,24833,11629,13204,28498
27,513,District - Parbhani (17),Total,Youth (15-24),362978,196169,166809,49923,7466,3940,32047,12818,19229,63571
27,513,District - Parbhani (17),Rural,All Ages,1266280,651886,614394,172674,32150,16332,502832,201190,301642,266158
27,513,District - Parbhani (17),Rural,10-14,137830,72135,65695,20203,3772,1932,7098,3249,3849,3520
27,513,District - Parbhani (17),Rural,15-19,128900,72598,56302,18031,3073,1740,8440,3754,4686,23113
27,513,District - Parbhani (17),Rural,20-24,115666,61933,53733,15605,2631,1320,13269,4324,8945,36352
27,513,District - Parbhani (17),Rural,Adolescent (10-19),266730,144733,121997,38234,6845,3672,15538,7003,8535,26633
27,513,District - Parbhani (17),Rural,Youth (15-24),244566,134531,110035,33636,5704,3060,21709,8078,13631,59465
27,513,District - Parbhani (17),Urban,All Ages,569806,290984,278822,74634,8364,4238,175440,75389,100051,22280
27,513,District - Parbhani (17),Urban,10-14,62529,32376,30153,8027,1013,517,4595,2270,2325,267
27,513,District - Parbhani (17),Urban,15-19,60491,31985,28506,8198,978,499,4700,2356,2344,1598
27,513,District - Parbhani (17),Urban,20-24,57921,29653,28268,8089,784,381,5638,2384,3254,2508
27,513,District - Parbhani (17),Urban,Adolescent (10-19),123020,64361,58659,16225,1991,1016,9295,4626,4669,1865
27,513,District - Parbhani (17),Urban,Youth (15-24),118412,61638,56774,16287,1762,880,10338,4740,5598,4106
27,514,District - Jalna (18),Total,All Ages,1959046,1011473,947573,272266,42263,21988,763523,312045,451478,261713
27,514,District - Jalna (18),Total,10-14,207476,109747,97729,30277,4981,2762,13342,6283,7059,3416
27,514,District - Jalna (18),Total,15-19,191823,107047,84776,27002,4252,2427,15013,6771,8242,22062
27,514,District - Jalna (18),Total,20-24,185191,97565,87626,25303,3886,2090,23170,7811,15359,37952
27,514,District - Jalna (18),Total,Adolescent (10-19),399299,216794,182505,57279,9233,5189,28355,13054,15301,25478
27,514,District - Jalna (18),Total,Youth (15-24),377014,204612,172402,52305,8138,4517,38183,14582,23601,60014
27,514,District - Jalna (18),Rural,All Ages,1581617,817279,764338,226345,35876,18543,650103,262609,387494,256149
27,514,District - Jalna (18),Rural,10-14,167862,88936,78926,25167,4146,2291,10567,4900,5667,3354
27,514,District - Jalna (18),Rural,15-19,152907,86551,66356,21950,3483,2001,11883,5236,6647,21719
27,514,District - Jalna (18),Rural,20-24,145973,77493,68480,20457,3178,1649,19135,6142,12993,37246
27,514,District - Jalna (18),Rural,Adolescent (10-19),320769,175487,145282,47117,7629,4292,22450,10136,12314,25073
27,514,District - Jalna (18),Rural,Youth (15-24),298880,164044,134836,42407,6661,3650,31018,11378,19640,58965
27,514,District - Jalna (18),Urban,All Ages,377429,194194,183235,45921,6387,3445,113420,49436,63984,5564
27,514,District - Jalna (18),Urban,10-14,39614,20811,18803,5110,835,471,2775,1383,1392,62
27,514,District - Jalna (18),Urban,15-19,38916,20496,18420,5052,769,426,3130,1535,1595,343
27,514,District - Jalna (18),Urban,20-24,39218,20072,19146,4846,708,441,4035,1669,2366,706
27,514,District - Jalna (18),Urban,Adolescent (10-19),78530,41307,37223,10162,1604,897,5905,2918,2987,405
27,514,District - Jalna (18),Urban,Youth (15-24),78134,40568,37566,9898,1477,867,7165,3204,3961,1049
27,515,District - Aurangabad (19),Total,All Ages,3701282,1924469,1776813,539368,143366,73876,1197445,493533,703912,351679
27,515,District - Aurangabad (19),Total,10-14,387150,206932,180218,57847,17618,9642,16078,7774,8304,4613
27,515,District - Aurangabad (19),Total,15-19,370165,201934,168231,54797,14343,8018,18765,8150,10615,31107
27,515,District - Aurangabad (19),Total,20-24,373898,192951,180947,57187,13308,6750,29577,9453,20124,52567
27,515,District - Aurangabad (19),Total,Adolescent (10-19),757315,408866,348449,112644,31961,17660,34843,15924,18919,35720
27,515,District - Aurangabad (19),Total,Youth (15-24),744063,394885,349178,111984,27651,14768,48342,17603,30739,83674
27,515,District - Aurangabad (19),Rural,All Ages,2081112,1081825,999287,246659,118070,60537,787782,313414,474368,330212
27,515,District - Aurangabad (19),Rural,10-14,224321,119777,104544,27459,14833,8006,9772,4537,5235,4446
27,515,District - Aurangabad (19),Rural,15-19,211996,118579,93417,25153,11701,6585,12097,5089,7008,29758
27,515,District - Aurangabad (19),Rural,20-24,199743,106990,92753,23800,10517,5330,19387,5792,13595,49835
27,515,District - Aurangabad (19),Rural,Adolescent (10-19),436317,238356,197961,52612,26534,14591,21869,9626,12243,34204
27,515,District - Aurangabad (19),Rural,Youth (15-24),411739,225569,186170,48953,22218,11915,31484,10881,20603,79593
27,515,District - Aurangabad (19),Urban,All Ages,1620170,842644,777526,292709,25296,13339,409663,180119,229544,21467
27,515,District - Aurangabad (19),Urban,10-14,162829,87155,75674,30388,2785,1636,6306,3237,3069,167
27,515,District - Aurangabad (19),Urban,15-19,158169,83355,74814,29644,2642,1433,6668,3061,3607,1349
27,515,District - Aurangabad (19),Urban,20-24,174155,85961,88194,33387,2791,1420,10190,3661,6529,2732
27,515,District - Aurangabad (19),Urban,Adolescent (10-19),320998,170510,150488,60032,5427,3069,12974,6298,6676,1516
27,515,District - Aurangabad (19),Urban,Youth (15-24),332324,169316,163008,63031,5433,2853,16858,6722,10136,4081
27,516,District - Nashik (20),Total,All Ages,6107187,3157186,2950001,554687,1564369,792547,1761821,759648,1002173,644052
27,516,District - Nashik (20),Total,10-14,632261,333215,299046,57646,191150,99051,27785,13166,14619,15600
27,516,District - Nashik (20),Total,15-19,594633,314518,280115,55775,158103,82793,32317,13692,18625,60938
27,516,District - Nashik (20),Total,20-24,611895,314437,297458,58980,151514,75119,54338,19037,35301,96513
27,516,District - Nashik (20),Total,Adolescent (10-19),1226894,647733,579161,113421,349253,181844,60102,26858,33244,76538
27,516,District - Nashik (20),Total,Youth (15-24),1206528,628955,577573,114755,309617,157912,86655,32729,53926,157451
27,516,District - Nashik (20),Rural,All Ages,3509814,1804712,1705102,231171,1399280,707246,1183382,498248,685134,614845
27,516,District - Nashik (20),Rural,10-14,382361,200683,181678,25231,172679,89295,17998,8046,9952,15070
27,516,District - Nashik (20),Rural,15-19,344433,182039,162394,23155,139901,73220,22278,8626,13652,58780
27,516,District - Nashik (20),Rural,20-24,336021,172847,163174,22738,132153,65226,38636,12327,26309,92639
27,516,District - Nashik (20),Rural,Adolescent (10-19),726794,382722,344072,48386,312580,162515,40276,16672,23604,73850
27,516,District - Nashik (20),Rural,Youth (15-24),680454,354886,325568,45893,272054,138446,60914,20953,39961,151419
27,516,District - Nashik (20),Urban,All Ages,2597373,1352474,1244899,323516,165089,85301,578439,261400,317039,29207
27,516,District - Nashik (20),Urban,10-14,249900,132532,117368,32415,18471,9756,9787,5120,4667,530
27,516,District - Nashik (20),Urban,15-19,250200,132479,117721,32620,18202,9573,10039,5066,4973,2158
27,516,District - Nashik (20),Urban,20-24,275874,141590,134284,36242,19361,9893,15702,6710,8992,3874
27,516,District - Nashik (20),Urban,Adolescent (10-19),500100,265011,235089,65035,36673,19329,19826,10186,9640,2688
27,516,District - Nashik (20),Urban,Youth (15-24),526074,274069,252005,68862,37563,19466,25741,11776,13965,6032
27,517,District - Thane (21),Total,All Ages,11060148,5865078,5195070,730089,1542451,769192,2832987,1273682,1559305,273218
27,517,District - Thane (21),Total,10-14,994881,523506,471375,66934,185193,95665,62776,29850,32926,4088
27,517,District - Thane (21),Total,15-19,977232,530784,446448,70453,147982,75955,69829,33115,36714,20747
27,517,District - Thane (21),Total,20-24,1147520,611986,535534,83254,148496,71843,112420,46374,66046,36936
27,517,District - Thane (21),Total,Adolescent (10-19),1972113,1054290,917823,137387,333175,171620,132605,62965,69640,24835
27,517,District - Thane (21),Total,Youth (15-24),2124752,1142770,981982,153707,296478,147798,182249,79489,102760,57683
27,517,District - Thane (21),Rural,All Ages,2545470,1300136,1245334,84982,1265162,627288,1005585,416726,588859,241722
27,517,District - Thane (21),Rural,10-14,271491,140467,131024,7920,155966,80479,24828,10380,14448,3808
27,517,District - Thane (21),Rural,15-19,238288,124648,113640,8082,120325,61567,29386,10686,18700,19175
27,517,District - Thane (21),Rural,20-24,254861,130064,124797,9252,118639,56794,46667,14931,31736,33607
27,517,District - Thane (21),Rural,Adolescent (10-19),509779,265115,244664,16002,276291,142046,54214,21066,33148,22983
27,517,District - Thane (21),Rural,Youth (15-24),493149,254712,238437,17334,238964,118361,76053,25617,50436,52782
27,517,District - Thane (21),Urban,All Ages,8514678,4564942,3949736,645107,277289,141904,1827402,856956,970446,31496
27,517,District - Thane (21),Urban,10-14,723390,383039,340351,59014,29227,15186,37948,19470,18478,280
27,517,District - Thane (21),Urban,15-19,738944,406136,332808,62371,27657,14388,40443,22429,18014,1572
27,517,District - Thane (21),Urban,20-24,892659,481922,410737,74002,29857,15049,65753,31443,34310,3329
27,517,District - Thane (21),Urban,Adolescent (10-19),1462334,789175,673159,121385,56884,29574,78391,41899,36492,1852
27,517,District - Thane (21),Urban,Youth (15-24),1631603,888058,743545,136373,57514,29437,106196,53872,52324,4901
27,518,District - Mumbai Suburban (22),Total,All Ages,9356962,5031323,4325639,583302,104560,55033,1781477,808294,973183,17621
27,518,District - Mumbai Suburban (22),Total,10-14,767735,406821,360914,52781,9346,4840,26016,13191,12825,131
27,518,District - Mumbai Suburban (22),Total,15-19,834831,462660,372171,58323,9851,5220,32792,18316,14476,838
27,518,District - Mumbai Suburban (22),Total,20-24,999427,563925,435502,67650,11549,6202,58700,30010,28690,2267
27,518,District - Mumbai Suburban (22),Total,Adolescent (10-19),1602566,869481,733085,111104,19197,10060,58808,31507,27301,969
27,518,District - Mumbai Suburban (22),Total,Youth (15-24),1834258,1026585,807673,125973,21400,11422,91492,48326,43166,3105
27,518,District - Mumbai Suburban (22),Rural,All Ages,0,0,0,0,0,0,0,0,0,0
27,518,District - Mumbai Suburban (22),Rural,10-14,0,0,0,0,0,0,0,0,0,0
27,518,District - Mumbai Suburban (22),Rural,15-19,0,0,0,0,0,0,0,0,0,0
27,518,District - Mumbai Suburban (22),Rural,20-24,0,0,0,0,0,0,0,0,0,0
27,518,District - Mumbai Suburban (22),Rural,Adolescent (10-19),0,0,0,0,0,0,0,0,0,0
27,518,District - Mumbai Suburban (22),Rural,Youth (15-24),0,0,0,0,0,0,0,0,0,0
27,518,District - Mumbai Suburban (22),Urban,All Ages,9356962,5031323,4325639,583302,104560,55033,1781477,808294,973183,17621
27,518,District - Mumbai Suburban (22),Urban,10-14,767735,406821,360914,52781,9346,4840,26016,13191,12825,131
27,518,District - Mumbai Suburban (22),Urban,15-19,834831,462660,372171,58323,9851,5220,32792,18316,14476,838
27,518,District - Mumbai Suburban (22),Urban,20-24,999427,563925,435502,67650,11549,6202,58700,30010,28690,2267
27,518,District - Mumbai Suburban (22),Urban,Adolescent (10-19),1602566,869481,733085,111104,19197,10060,58808,31507,27301,969
27,518,District - Mumbai Suburban (22),Urban,Youth (15-24),1834258,1026585,807673,125973,21400,11422,91492,48326,43166,3105
27,519,District - Mumbai (23),Total,All Ages,3085411,1684608,1400803,219934,25093,13488,576389,273928,302461,5086
27,519,District - Mumbai (23),Total,10-14,230713,122365,108348,17858,2082,1095,10512,5598,4914,43
27,519,District - Mumbai (23),Total,15-19,265548,150557,114991,19984,2214,1241,14120,9022,5098,255
27,519,District - Mumbai (23),Total,20-24,334119,198073,136046,24089,2754,1516,24967,15459,9508,669
27,519,District - Mumbai (23),Total,Adolescent (10-19),496261,272922,223339,37842,4296,2336,24632,14620,10012,298
27,519,District - Mumbai (23),Total,Youth (15-24),599667,348630,251037,44073,4968,2757,39087,24481,14606,924
27,519,District - Mumbai (23),Rural,All Ages,0,0,0,0,0,0,0,0,0,0
27,519,District - Mumbai (23),Rural,10-14,0,0,0,0,0,0,0,0,0,0
27,519,District - Mumbai (23),Rural,15-19,0,0,0,0,0,0,0,0,0,0
27,519,District - Mumbai (23),Rural,20-24,0,0,0,0,0,0,0,0,0,0
27,519,District - Mumbai (23),Rural,Adolescent (10-19),0,0,0,0,0,0,0,0,0,0
27,519,District - Mumbai (23),Rural,Youth (15-24),0,0,0,0,0,0,0,0,0,0
27,519,District - Mumbai (23),Urban,All Ages,3085411,1684608,1400803,219934,25093,13488,576389,273928,302461,5086
27,519,District - Mumbai (23),Urban,10-14,230713,122365,108348,17858,2082,1095,10512,5598,4914,43
27,519,District - Mumbai (23),Urban,15-19,265548,150557,114991,19984,2214,1241,14120,9022,5098,255
27,519,District - Mumbai (23),Urban,20-24,334119,198073,136046,24089,2754,1516,24967,15459,9508,669
27,519,District - Mumbai (23),Urban,Adolescent (10-19),496261,272922,223339,37842,4296,2336,24632,14620,10012,298
27,519,District - Mumbai (23),Urban,Youth (15-24),599667,348630,251037,44073,4968,2757,39087,24481,14606,924
27,520,District - Raigarh (24),Total,All Ages,2634200,1344345,1289855,134952,305125,153657,694206,284653,409553,115250
27,520,District - Raigarh (24),Total,10-14,243177,126154,117023,12654,33815,17591,10411,4962,5449,1146
27,520,District - Raigarh (24),Total,15-19,239580,125665,113915,12994,26700,13944,11790,5121,6669,6054
27,520,District - Raigarh (24),Total,20-24,253293,129247,124046,14252,28686,13780,19623,7226,12397,12454
27,520,District - Raigarh (24),Total,Adolescent (10-19),482757,251819,230938,25648,60515,31535,22201,10083,12118,7200
27,520,District - Raigarh (24),Total,Youth (15-24),492873,254912,237961,27246,55386,27724,31413,12347,19066,18508
27,520,District - Raigarh (24),Rural,All Ages,1664005,836996,827009,64338,270768,135959,501114,197295,303819,110644
27,520,District - Raigarh (24),Rural,10-14,159424,81946,77478,6441,29988,15620,7422,3483,3939,1116
27,520,District - Raigarh (24),Rural,15-19,155325,80635,74690,6335,23272,12124,8684,3569,5115,5853
27,520,District - Raigarh (24),Rural,20-24,155038,78999,76039,6336,25226,11990,14321,5007,9314,12047
27,520,District - Raigarh (24),Rural,Adolescent (10-19),314749,162581,152168,12776,53260,27744,16106,7052,9054,6969
27,520,District - Raigarh (24),Rural,Youth (15-24),310363,159634,150729,12671,48498,24114,23005,8576,14429,17900
27,520,District - Raigarh (24),Urban,All Ages,970195,507349,462846,70614,34357,17698,193092,87358,105734,4606
27,520,District - Raigarh (24),Urban,10-14,83753,44208,39545,6213,3827,1971,2989,1479,1510,30
27,520,District - Raigarh (24),Urban,15-19,84255,45030,39225,6659,3428,1820,3106,1552,1554,201
27,520,District - Raigarh (24),Urban,20-24,98255,50248,48007,7916,3460,1790,5302,2219,3083,407
27,520,District - Raigarh (24),Urban,Adolescent (10-19),168008,89238,78770,12872,7255,3791,6095,3031,3064,231
27,520,District - Raigarh (24),Urban,Youth (15-24),182510,95278,87232,14575,6888,3610,8408,3771,4637,608
27,521,District - Pune (25),Total,All Ages,9429408,4924105,4505303,1180703,348876,179132,2257685,983895,1273790,366010
27,521,District - Pune (25),Total,10-14,787915,417129,370786,112635,36456,18836,32420,16127,16293,3873
27,521,District - Pune (25),Total,15-19,819364,438697,380667,114789,34698,18241,35303,17055,18248,21678
27,521,District - Pune (25),Total,20-24,1028019,537628,490391,137212,37454,18960,58322,23792,34530,44386
27,521,District - Pune (25),Total,Adolescent (10-19),1607279,855826,751453,227424,71154,37077,67723,33182,34541,25551
27,521,District - Pune (25),Total,Youth (15-24),1847383,976325,871058,252001,72152,37201,93625,40847,52778,66064
27,521,District - Pune (25),Rural,All Ages,3678226,1903440,1774786,361029,255389,129711,1056004,431249,624755,348022
27,521,District - Pune (25),Rural,10-14,336345,177424,158921,35468,27699,14154,12854,6164,6690,3784
27,521,District - Pune (25),Rural,15-19,343011,183074,159937,34540,25475,13394,14141,6338,7803,20986
27,521,District - Pune (25),Rural,20-24,375152,194713,180439,39037,25390,12820,21625,7989,13636,42561
27,521,District - Pune (25),Rural,Adolescent (10-19),679356,360498,318858,70008,53174,27548,26995,12502,14493,24770
27,521,District - Pune (25),Rural,Youth (15-24),718163,377787,340376,73577,50865,26214,35766,14327,21439,63547
27,521,District - Pune (25),Urban,All Ages,5751182,3020665,2730517,819674,93487,49421,1201681,552646,649035,17988
27,521,District - Pune (25),Urban,10-14,451570,239705,211865,77167,8757,4682,19566,9963,9603,89
27,521,District - Pune (25),Urban,15-19,476353,255623,220730,80249,9223,4847,21162,10717,10445,692
27,521,District - Pune (25),Urban,20-24,652867,342915,309952,98175,12064,6140,36697,15803,20894,1825
27,521,District - Pune (25),Urban,Adolescent (10-19),927923,495328,432595,157416,17980,9529,40728,20680,20048,781
27,521,District - Pune (25),Urban,Youth (15-24),1129220,598538,530682,178424,21287,10987,57859,26520,31339,2517
27,522,District - Ahmadnagar (26),Total,All Ages,4543159,2342825,2200334,573698,378230,191165,1391269,569470,821799,501873
27,522,District - Ahmadnagar (26),Total,10-14,444802,237754,207048,60406,45496,23503,19447,9393,10054,5335
27,522,District - Ahmadnagar (26),Total,15-19,433199,232550,200649,57128,38151,20163,20965,9191,11774,35605
27,522,District - Ahmadnagar (26),Total,20-24,440174,227933,212241,57164,36080,18073,31056,10983,20073,68968
27,522,District - Ahmadnagar (26),Total,Adolescent (10-19),878001,470304,407697,117534,83647,43666,40412,18584,21828,40940
27,522,District - Ahmadnagar (26),Total,Youth (15-24),873373,460483,412890,114292,74231,38236,52021,20174,31847,104573
27,522,District - Ahmadnagar (26),Rural,All Ages,3630542,1872907,1757635,443302,354975,179133,1185395,480016,705379,479225
27,522,District - Ahmadnagar (26),Rural,10-14,359231,191788,167443,46902,42571,21900,16023,7639,8384,5124
27,522,District - Ahmadnagar (26),Rural,15-19,345397,186250,159147,43279,35276,18597,17509,7529,9980,34243
27,522,District - Ahmadnagar (26),Rural,20-24,345132,179614,165518,42748,33645,16815,26286,9011,17275,66264
27,522,District - Ahmadnagar (26),Rural,Adolescent (10-19),704628,378038,326590,90181,77847,40497,33532,15168,18364,39367
27,522,District - Ahmadnagar (26),Rural,Youth (15-24),690529,365864,324665,86027,68921,35412,43795,16540,27255,100507
27,522,District - Ahmadnagar (26),Urban,All Ages,912617,469918,442699,130396,23255,12032,205874,89454,116420,22648
27,522,District - Ahmadnagar (26),Urban,10-14,85571,45966,39605,13504,2925,1603,3424,1754,1670,211
27,522,District - Ahmadnagar (26),Urban,15-19,87802,46300,41502,13849,2875,1566,3456,1662,1794,1362
27,522,District - Ahmadnagar (26),Urban,20-24,95042,48319,46723,14416,2435,1258,4770,1972,2798,2704
27,522,District - Ahmadnagar (26),Urban,Adolescent (10-19),173373,92266,81107,27353,5800,3169,6880,3416,3464,1573
27,522,District - Ahmadnagar (26),Urban,Youth (15-24),182844,94619,88225,28265,5310,2824,8226,3634,4592,4066
27,523,District - Bid (27),Total,All Ages,2585049,1349106,1235943,351254,32722,16806,866542,361921,504621,327830
27,523,District - Bid (27),Total,10-14,266304,142840,123464,37922,3764,1998,7652,3443,4209,4722
27,523,District - Bid (27),Total,15-19,254810,142603,112207,34802,3216,1733,9254,3686,5568,23561
27,523,District - Bid (27),Total,20-24,244593,131929,112664,33202,3074,1586,17155,4885,12270,43918
27,523,District - Bid (27),Total,Adolescent (10-19),521114,285443,235671,72724,6980,3731,16906,7129,9777,28283
27,523,District - Bid (27),Total,Youth (15-24),499403,274532,224871,68004,6290,3319,26409,8571,17838,67479
27,523,District - Bid (27),Rural,All Ages,2070751,1082978,987773,278869,26681,13659,735162,305141,430021,313683
27,523,District - Bid (27),Rural,10-14,212342,113823,98519,30104,3055,1619,5859,2541,3318,4581
27,523,District - Bid (27),Rural,15-19,201532,114211,87321,26929,2562,1385,7318,2772,4546,22765
27,523,District - Bid (27),Rural,20-24,191568,104873,86695,25459,2486,1292,14279,3787,10492,42343
27,523,District - Bid (27),Rural,Adolescent (10-19),413874,228034,185840,57033,5617,3004,13177,5313,7864,27346
27,523,District - Bid (27),Rural,Youth (15-24),393100,219084,174016,52388,5048,2677,21597,6559,15038,65108
27,523,District - Bid (27),Urban,All Ages,514298,266128,248170,72385,6041,3147,131380,56780,74600,14147
27,523,District - Bid (27),Urban,10-14,53962,29017,24945,7818,709,379,1793,902,891,141
27,523,District - Bid (27),Urban,15-19,53278,28392,24886,7873,654,348,1936,914,1022,796
27,523,District - Bid (27),Urban,20-24,53025,27056,25969,7743,588,294,2876,1098,1778,1575
27,523,District - Bid (27),Urban,Adolescent (10-19),107240,57409,49831,15691,1363,727,3729,1816,1913,937
27,523,District - Bid (27),Urban,Youth (15-24),106303,55448,50855,15616,1242,642,4812,2012,2800,2371
27,524,District - Latur (28),Total,All Ages,2454196,1273140,1181056,480913,57488,29872,803524,340708,462816,383939
27,524,District - Latur (28),Total,10-14,263155,138984,124171,54300,6684,3518,12860,6443,6417,3493
27,524,District - Latur (28),Total,15-19,252520,136069,116451,50862,5918,3218,13632,6441,7191,25520
27,524,District - Latur (28),Total,20-24,234429,127223,107206,46497,5396,2936,17865,7427,10438,49558
27,524,District - Latur (28),Total,Adolescent (10-19),515675,275053,240622,105162,12602,6736,26492,12884,13608,29013
27,524,District - Latur (28),Total,Youth (15-24),486949,263292,223657,97359,11314,6154,31497,13868,17629,75078
27,524,District - Latur (28),Rural,All Ages,1829216,949707,879509,369609,48147,24970,634371,266458,367913,371168
27,524,District - Latur (28),Rural,10-14,193323,101490,91833,41522,5459,2819,9176,4518,4658,3351
27,524,District - Latur (28),Rural,15-19,184727,100897,83830,38468,4889,2676,9953,4649,5304,24740
27,524,District - Latur (28),Rural,20-24,170648,94778,75870,34589,4430,2424,13207,5412,7795,48035
27,524,District - Latur (28),Rural,Adolescent (10-19),378050,202387,175663,79990,10348,5495,19129,9167,9962,28091
27,524,District - Latur (28),Rural,Youth (15-24),355375,195675,159700,73057,9319,5100,23160,10061,13099,72775
27,524,District - Latur (28),Urban,All Ages,624980,323433,301547,111304,9341,4902,169153,74250,94903,12771
27,524,District - Latur (28),Urban,10-14,69832,37494,32338,12778,1225,699,3684,1925,1759,142
27,524,District - Latur (28),Urban,15-19,67793,35172,32621,12394,1029,542,3679,1792,1887,780
27,524,District - Latur (28),Urban,20-24,63781,32445,31336,11908,966,512,4658,2015,2643,1523
27,524,District - Latur (28),Urban,Adolescent (10-19),137625,72666,64959,25172,2254,1241,7363,3717,3646,922
27,524,District - Latur (28),Urban,Youth (15-24),131574,67617,63957,24302,1995,1054,8337,3807,4530,2303
27,525,District - Osmanabad (29),Total,All Ages,1657576,861535,796041,265184,36039,18569,519766,217231,302535,265167
27,525,District - Osmanabad (29),Total,10-14,167875,89019,78856,28182,4238,2304,5589,2602,2987,2831
27,525,District - Osmanabad (29),Total,15-19,165540,90866,74674,27115,3496,1917,5419,2338,3081,17015
27,525,District - Osmanabad (29),Total,20-24,157097,85841,71256,25523,3267,1620,8743,3011,5732,32354
27,525,District - Osmanabad (29),Total,Adolescent (10-19),333415,179885,153530,55297,7734,4221,11008,4940,6068,19846
27,525,District - Osmanabad (29),Total,Youth (15-24),322637,176707,145930,52638,6763,3537,14162,5349,8813,49369
27,525,District - Osmanabad (29),Rural,All Ages,1376519,716237,660282,221325,30007,15426,450497,187494,263003,254182
27,525,District - Osmanabad (29),Rural,10-14,137532,72649,64883,23287,3396,1831,4472,2082,2390,2766
27,525,District - Osmanabad (29),Rural,15-19,136199,75283,60916,22258,2858,1573,4396,1873,2523,16419
27,525,District - Osmanabad (29),Rural,20-24,128631,71311,57320,20771,2657,1314,7310,2464,4846,31137
27,525,District - Osmanabad (29),Rural,Adolescent (10-19),273731,147932,125799,45545,6254,3404,8868,3955,4913,19185
27,525,District - Osmanabad (29),Rural,Youth (15-24),264830,146594,118236,43029,5515,2887,11706,4337,7369,47556
27,525,District - Osmanabad (29),Urban,All Ages,281057,145298,135759,43859,6032,3143,69269,29737,39532,10985
27,525,District - Osmanabad (29),Urban,10-14,30343,16370,13973,4895,842,473,1117,520,597,65
27,525,District - Osmanabad (29),Urban,15-19,29341,15583,13758,4857,638,344,1023,465,558,596
27,525,District - Osmanabad (29),Urban,20-24,28466,14530,13936,4752,610,306,1433,547,886,1217
27,525,District - Osmanabad (29),Urban,Adolescent (10-19),59684,31953,27731,9752,1480,817,2140,985,1155,661
27,525,District - Osmanabad (29),Urban,Youth (15-24),57807,30113,27694,9609,1248,650,2456,1012,1444,1813
27,526,District - Solapur (30),Total,All Ages,4317756,2227852,2089904,649745,77592,39785,1407080,576586,830494,508141
27,526,District - Solapur (30),Total,10-14,433240,230004,203236,68905,8462,4540,15500,7458,8042,3980
27,526,District - Solapur (30),Total,15-19,421326,230588,190738,65748,7551,4161,19838,8862,10976,33347
27,526,District - Solapur (30),Total,20-24,422422,223496,198926,65335,7632,3822,32718,11728,20990,64927
27,526,District - Solapur (30),Total,Adolescent (10-19),854566,460592,393974,134653,16013,8701,35338,16320,19018,37327
27,526,District - Solapur (30),Total,Youth (15-24),843748,454084,389664,131083,15183,7983,52556,20590,31966,98274
27,526,District - Solapur (30),Rural,All Ages,2918665,1518343,1400322,443181,49731,25648,1035877,427258,608619,486132
27,526,District - Solapur (30),Rural,10-14,296766,158242,138524,47321,5525,3010,10084,4829,5255,3821
27,526,District - Solapur (30),Rural,15-19,280262,156606,123656,43571,4679,2631,12420,5469,6951,32165
27,526,District - Solapur (30),Rural,20-24,278180,150509,127671,42447,4669,2372,21127,7418,13709,62625
27,526,District - Solapur (30),Rural,Adolescent (10-19),577028,314848,262180,90892,10204,5641,22504,10298,12206,35986
27,526,District - Solapur (30),Rural,Youth (15-24),558442,307115,251327,86018,9348,5003,33547,12887,20660,94790
27,526,District - Solapur (30),Urban,All Ages,1399091,709509,689582,206564,27861,14137,371203,149328,221875,22009
27,526,District - Solapur (30),Urban,10-14,136474,71762,64712,21584,2937,1530,5416,2629,2787,159
27,526,District - Solapur (30),Urban,15-19,141064,73982,67082,22177,2872,1530,7418,3393,4025,1182
27,526,District - Solapur (30),Urban,20-24,144242,72987,71255,22888,2963,1450,11591,4310,7281,2302
27,526,District - Solapur (30),Urban,Adolescent (10-19),277538,145744,131794,43761,5809,3060,12834,6022,6812,1341
27,526,District - Solapur (30),Urban,Youth (15-24),285306,146969,138337,45065,5835,2980,19009,7703,11306,3484
27,527,District - Satara (31),Total,All Ages,3003741,1510842,1492899,323236,29635,15210,778047,309808,468239,243687
27,527,District - Satara (31),Total,10-14,269413,143827,125586,30411,3076,1657,10159,5273,4886,1723
27,527,District - Satara (31),Total,15-19,272217,144326,127891,30896,2753,1463,10762,5181,5581,11503
27,527,District - Satara (31),Total,20-24,271808,135212,136596,31105,2756,1281,14630,5909,8721,24899
27,527,District - Satara (31),Total,Adolescent (10-19),541630,288153,253477,61307,5829,3120,20921,10454,10467,13226
27,527,District - Satara (31),Total,Youth (15-24),544025,279538,264487,62001,5509,2744,25392,11090,14302,36402
27,527,District - Satara (31),Rural,All Ages,2433363,1219749,1213614,247575,22463,11500,662613,258950,403663,233616
27,527,District - Satara (31),Rural,10-14,216365,114608,101757,22939,2280,1209,8267,4285,3982,1655
27,527,District - Satara (31),Rural,15-19,220040,116112,103928,23340,2098,1100,8790,4232,4558,11091
27,527,District - Satara (31),Rural,20-24,217770,108506,109264,23248,2104,999,11833,4741,7092,24005
27,527,District - Satara (31),Rural,Adolescent (10-19),436405,230720,205685,46279,4378,2309,17057,8517,8540,12746
27,527,District - Satara (31),Rural,Youth (15-24),437810,224618,213192,46588,4202,2099,20623,8973,11650,35096
27,527,District - Satara (31),Urban,All Ages,570378,291093,279285,75661,7172,3710,115434,50858,64576,10071
27,527,District - Satara (31),Urban,10-14,53048,29219,23829,7472,796,448,1892,988,904,68
27,527,District - Satara (31),Urban,15-19,52177,28214,23963,7556,655,363,1972,949,1023,412
27,527,District - Satara (31),Urban,20-24,54038,26706,27332,7857,652,282,2797,1168,1629,894
27,527,District - Satara (31),Urban,Adolescent (10-19),105225,57433,47792,15028,1451,811,3864,1937,1927,480
27,527,District - Satara (31),Urban,Youth (15-24),106215,54920,51295,15413,1307,645,4769,2117,2652,1306
27,528,District - Ratnagiri (32),Total,All Ages,1615069,761121,853948,66948,20374,10402,415677,142109,273568,97146
27,528,District - Ratnagiri (32),Total,10-14,160681,82345,78336,6718,2382,1260,2344,1126,1218,390
27,528,District - Ratnagiri (32),Total,15-19,148160,75521,72639,6385,1944,1061,2695,1184,1511,4663
27,528,District - Ratnagiri (32),Total,20-24,122290,56359,65931,5584,1833,858,4529,1688,2841,9284
27,528,District - Ratnagiri (32),Total,Adolescent (10-19),308841,157866,150975,13103,4326,2321,5039,2310,2729,5053
27,528,District - Ratnagiri (32),Total,Youth (15-24),270450,131880,138570,11969,3777,1919,7224,2872,4352,13947
27,528,District - Ratnagiri (32),Rural,All Ages,1351346,630213,721133,57524,18788,9577,371989,123014,248975,95248
27,528,District - Ratnagiri (32),Rural,10-14,136447,69670,66777,5826,2200,1168,1859,871,988,380
27,528,District - Ratnagiri (32),Rural,15-19,124191,63067,61124,5393,1802,978,2228,950,1278,4607
27,528,District - Ratnagiri (32),Rural,20-24,98682,44687,53995,4653,1682,784,3714,1334,2380,9138
27,528,District - Ratnagiri (32),Rural,Adolescent (10-19),260638,132737,127901,11219,4002,2146,4087,1821,2266,4987
27,528,District - Ratnagiri (32),Rural,Youth (15-24),222873,107754,115119,10046,3484,1762,5942,2284,3658,13745
27,528,District - Ratnagiri (32),Urban,All Ages,263723,130908,132815,9424,1586,825,43688,19095,24593,1898
27,528,District - Ratnagiri (32),Urban,10-14,24234,12675,11559,892,182,92,485,255,230,10
27,528,District - Ratnagiri (32),Urban,15-19,23969,12454,11515,992,142,83,467,234,233,56
27,528,District - Ratnagiri (32),Urban,20-24,23608,11672,11936,931,151,74,815,354,461,146
27,528,District - Ratnagiri (32),Urban,Adolescent (10-19),48203,25129,23074,1884,324,175,952,489,463,66
27,528,District - Ratnagiri (32),Urban,Youth (15-24),47577,24126,23451,1923,293,157,1282,588,694,202
27,529,District - Sindhudurg (33),Total,All Ages,849651,417332,432319,55586,6976,3575,183584,69043,114541,36543
27,529,District - Sindhudurg (33),Total,10-14,74551,38416,36135,5124,668,332,2167,1180,987,164
27,529,District - Sindhudurg (33),Total,15-19,75179,38506,36673,5081,635,356,2261,1192,1069,1410
27,529,District - Sindhudurg (33),Total,20-24,64768,32084,32684,4843,672,349,2846,1313,1533,3341
27,529,District - Sindhudurg (33),Total,Adolescent (10-19),149730,76922,72808,10205,1303,688,4428,2372,2056,1574
27,529,District - Sindhudurg (33),Total,Youth (15-24),139947,70590,69357,9924,1307,705,5107,2505,2602,4751
27,529,District - Sindhudurg (33),Rural,All Ages,742645,363268,379377,48709,6019,3061,166372,61157,105215,35917
27,529,District - Sindhudurg (33),Rural,10-14,65849,33844,32005,4454,559,273,1874,1008,866,164
27,529,District - Sindhudurg (33),Rural,15-19,66266,33900,32366,4431,549,316,1960,1044,916,1399
27,529,District - Sindhudurg (33),Rural,20-24,55802,27664,28138,4168,591,310,2363,1082,1281,3292
27,529,District - Sindhudurg (33),Rural,Adolescent (10-19),132115,67744,64371,8885,1108,589,3834,2052,1782,1563
27,529,District - Sindhudurg (33),Rural,Youth (15-24),122068,61564,60504,8599,1140,626,4323,2126,2197,4691
27,529,District - Sindhudurg (33),Urban,All Ages,107006,54064,52942,6877,957,514,17212,7886,9326,626
27,529,District - Sindhudurg (33),Urban,10-14,8702,4572,4130,670,109,59,293,172,121,0
27,529,District - Sindhudurg (33),Urban,15-19,8913,4606,4307,650,86,40,301,148,153,11
27,529,District - Sindhudurg (33),Urban,20-24,8966,4420,4546,675,81,39,483,231,252,49
27,529,District - Sindhudurg (33),Urban,Adolescent (10-19),17615,9178,8437,1320,195,99,594,320,274,11
27,529,District - Sindhudurg (33),Urban,Youth (15-24),17879,9026,8853,1325,167,79,784,379,405,60
27,530,District - Kolhapur (34),Total,All Ages,3876001,1980658,1895343,504461,30206,15478,1050156,420898,629258,207790
27,530,District - Kolhapur (34),Total,10-14,341105,185951,155154,46626,2833,1542,13062,6915,6147,1071
27,530,District - Kolhapur (34),Total,15-19,352458,190503,161955,48514,2798,1479,13707,6801,6906,8038
27,530,District - Kolhapur (34),Total,20-24,359124,182594,176530,50449,2946,1436,18403,7573,10830,19123
27,530,District - Kolhapur (34),Total,Adolescent (10-19),693563,376454,317109,95140,5631,3021,26769,13716,13053,9109
27,530,District - Kolhapur (34),Total,Youth (15-24),711582,373097,338485,98963,5744,2915,32110,14374,17736,27161
27,530,District - Kolhapur (34),Rural,All Ages,2645992,1348815,1297177,355641,22318,11408,792123,309100,483023,195801
27,530,District - Kolhapur (34),Rural,10-14,236671,128811,107860,32727,2043,1117,9397,4908,4489,1036
27,530,District - Kolhapur (34),Rural,15-19,242712,130905,111807,33711,2053,1091,9666,4738,4928,7660
27,530,District - Kolhapur (34),Rural,20-24,237377,121331,116046,34242,2116,1037,12600,5135,7465,18214
27,530,District - Kolhapur (34),Rural,Adolescent (10-19),479383,259716,219667,66438,4096,2208,19063,9646,9417,8696
27,530,District - Kolhapur (34),Rural,Youth (15-24),480089,252236,227853,67953,4169,2128,22266,9873,12393,25874
27,530,District - Kolhapur (34),Urban,All Ages,1230009,631843,598166,148820,7888,4070,258033,111798,146235,11989
27,530,District - Kolhapur (34),Urban,10-14,104434,57140,47294,13899,790,425,3665,2007,1658,35
27,530,District - Kolhapur (34),Urban,15-19,109746,59598,50148,14803,745,388,4041,2063,1978,378
27,530,District - Kolhapur (34),Urban,20-24,121747,61263,60484,16207,830,399,5803,2438,3365,909
27,530,District - Kolhapur (34),Urban,Adolescent (10-19),214180,116738,97442,28702,1535,813,7706,4070,3636,413
27,530,District - Kolhapur (34),Urban,Youth (15-24),231493,120861,110632,31010,1575,787,9844,4501,5343,1287
27,531,District - Sangli (35),Total,All Ages,2822143,1435728,1386415,353093,18333,9406,772676,314178,458498,245826
27,531,District - Sangli (35),Total,10-14,261259,141563,119696,34522,1804,985,9711,5080,4631,1704
27,531,District - Sangli (35),Total,15-19,256166,139159,117007,33593,1564,820,10528,5103,5425,13052
27,531,District - Sangli (35),Total,20-24,257962,130447,127515,34310,1713,781,14869,5801,9068,26564
27,531,District - Sangli (35),Total,Adolescent (10-19),517425,280722,236703,68115,3368,1805,20239,10183,10056,14756
27,531,District - Sangli (35),Total,Youth (15-24),514128,269606,244522,67903,3277,1601,25397,10904,14493,39616
27,531,District - Sangli (35),Rural,All Ages,2102786,1071124,1031662,252350,12820,6592,607692,243318,364374,226323
27,531,District - Sangli (35),Rural,10-14,196703,106623,90080,24718,1282,705,6720,3512,3208,1589
27,531,District - Sangli (35),Rural,15-19,190206,104187,86019,23706,1072,548,7313,3528,3785,12101
27,531,District - Sangli (35),Rural,20-24,186928,95271,91657,23526,1168,535,10370,3985,6385,24689
27,531,District - Sangli (35),Rural,Adolescent (10-19),386909,210810,176099,48424,2354,1253,14033,7040,6993,13690
27,531,District - Sangli (35),Rural,Youth (15-24),377134,199458,177676,47232,2240,1083,17683,7513,10170,36790
27,531,District - Sangli (35),Urban,All Ages,719357,364604,354753,100743,5513,2814,164984,70860,94124,19503
27,531,District - Sangli (35),Urban,10-14,64556,34940,29616,9804,522,280,2991,1568,1423,115
27,531,District - Sangli (35),Urban,15-19,65960,34972,30988,9887,492,272,3215,1575,1640,951
27,531,District - Sangli (35),Urban,20-24,71034,35176,35858,10784,545,246,4499,1816,2683,1875
27,531,District - Sangli (35),Urban,Adolescent (10-19),130516,69912,60604,19691,1014,552,6206,3143,3063,1066
27,531,District - Sangli (35),Urban,Youth (15-24),136994,70148,66846,20671,1037,518,7714,3391,4323,2826
28,0,State - ANDHRA PRADESH (28),Total,All Ages,84580777,42442146,42138631,13878078,5918073,2969362,34024017,14190903,19833114,13201989
28,0,State - ANDHRA PRADESH (28),Total,10-14,8201595,4208884,3992711,1464258,703736,364570,473562,210424,263138,176827
28,0,State - ANDHRA PRADESH (28),Total,15-19,8093747,4196307,3897440,1418821,603227,312850,722006,291942,430064,893074
28,0,State - ANDHRA PRADESH (28),Total,20-24,8132094,4055697,4076397,1407020,558213,267864,1383362,469916,913446,1512658
28,0,State - ANDHRA PRADESH (28),Total,Adolescent (10-19),16295342,8405191,7890151,2883079,1306963,677420,1195568,502366,693202,1069901
28,0,State - ANDHRA PRADESH (28),Total,Youth (15-24),16225841,8252004,7973837,2825841,1161440,580714,2105368,761858,1343510,2405732
28,0,State - ANDHRA PRADESH (28),Rural,All Ages,56361702,28243241,28118461,10846333,5232129,2620892,26010637,10847641,15162996,12538929
28,0,State - ANDHRA PRADESH (28),Rural,10-14,5565402,2859860,2705542,1145568,614402,317941,341493,147362,194131,169981
28,0,State - ANDHRA PRADESH (28),Rural,15-19,5334069,2799993,2534076,1097827,525562,272913,549362,216492,332870,857530
28,0,State - ANDHRA PRADESH (28),Rural,20-24,5263277,2682670,2580607,1074890,486684,234941,1075901,358687,717214,1446915
28,0,State - ANDHRA PRADESH (28),Rural,Adolescent (10-19),10899471,5659853,5239618,2243395,1139964,590854,890855,363854,527001,1027511
28,0,State - ANDHRA PRADESH (28),Rural,Youth (15-24),10597346,5482663,5114683,2172717,1012246,507854,1625263,575179,1050084,2304445
28,0,State - ANDHRA PRADESH (28),Urban,All Ages,28219075,14198905,14020170,3031745,685944,348470,8013380,3343262,4670118,663060
28,0,State - ANDHRA PRADESH (28),Urban,10-14,2636193,1349024,1287169,318690,89334,46629,132069,63062,69007,6846
28,0,State - ANDHRA PRADESH (28),Urban,15-19,2759678,1396314,1363364,320994,77665,39937,172644,75450,97194,35544
28,0,State - ANDHRA PRADESH (28),Urban,20-24,2868817,1373027,1495790,332130,71529,32923,307461,111229,196232,65743
28,0,State - ANDHRA PRADESH (28),Urban,Adolescent (10-19),5395871,2745338,2650533,639684,166999,86566,304713,138512,166201,42390
28,0,State - ANDHRA PRADESH (28),Urban,Youth (15-24),5628495,2769341,2859154,653124,149194,72860,480105,186679,293426,101287
28,532,District - Adilabad (01),Total,All Ages,2741239,1369597,1371642,488596,495794,247472,1257892,513247,744645,332524
28,532,District - Adilabad (01),Total,10-14,291813,148800,143013,51523,64070,32735,23597,10381,13216,6736
28,532,District - Adilabad (01),Total,15-19,280583,142884,137699,51925,53302,26937,32926,12738,20188,27093
28,532,District - Adilabad (01),Total,20-24,260882,131538,129344,48123,42827,21049,54294,17455,36839,39603
28,532,District - Adilabad (01),Total,Adolescent (10-19),572396,291684,280712,103448,117372,59672,56523,23119,33404,33829
28,532,District - Adilabad (01),Total,Youth (15-24),541465,274422,267043,100048,96129,47986,87220,30193,57027,66696
28,532,District - Adilabad (01),Rural,All Ages,1980980,985303,995677,368490,463089,231551,1015273,416270,599003,314964
28,532,District - Adilabad (01),Rural,10-14,215497,109890,105607,39159,58478,30174,20031,8615,11416,6556
28,532,District - Adilabad (01),Rural,15-19,199504,102149,97355,38405,48887,24927,28516,10741,17775,26225
28,532,District - Adilabad (01),Rural,20-24,179532,90479,89053,34520,39888,19620,47133,14944,32189,37998
28,532,District - Adilabad (01),Rural,Adolescent (10-19),415001,212039,202962,77564,107365,55101,48547,19356,29191,32781
28,532,District - Adilabad (01),Rural,Youth (15-24),379036,192628,186408,72925,88775,44547,75649,25685,49964,64223
28,532,District - Adilabad (01),Urban,All Ages,760259,384294,375965,120106,32705,15921,242619,96977,145642,17560
28,532,District - Adilabad (01),Urban,10-14,76316,38910,37406,12364,5592,2561,3566,1766,1800,180
28,532,District - Adilabad (01),Urban,15-19,81079,40735,40344,13520,4415,2010,4410,1997,2413,868
28,532,District - Adilabad (01),Urban,20-24,81350,41059,40291,13603,2939,1429,7161,2511,4650,1605
28,532,District - Adilabad (01),Urban,Adolescent (10-19),157395,79645,77750,25884,10007,4571,7976,3763,4213,1048
28,532,District - Adilabad (01),Urban,Youth (15-24),162429,81794,80635,27123,7354,3439,11571,4508,7063,2473
28,533,District - Nizamabad (02),Total,All Ages,2551335,1250641,1300694,371074,192941,95679,1161525,460427,701098,330793
28,533,District - Nizamabad (02),Total,10-14,264999,135099,129900,39247,24683,12891,17222,7592,9630,3836
28,533,District - Nizamabad (02),Total,15-19,246388,125141,121247,36819,19364,10039,23928,9528,14400,19955
28,533,District - Nizamabad (02),Total,20-24,238689,116429,122260,35069,16882,7928,46306,15066,31240,38182
28,533,District - Nizamabad (02),Total,Adolescent (10-19),511387,260240,251147,76066,44047,22930,41150,17120,24030,23791
28,533,District - Nizamabad (02),Total,Youth (15-24),485077,241570,243507,71888,36246,17967,70234,24594,45640,58137
28,533,District - Nizamabad (02),Rural,All Ages,1962963,958837,1004126,323425,185297,92056,975369,385653,589716,316810
28,533,District - Nizamabad (02),Rural,10-14,203831,104157,99674,33855,23116,12217,14016,6003,8013,3672
28,533,District - Nizamabad (02),Rural,15-19,187224,95982,91242,31897,18462,9623,19919,7606,12313,19280
28,533,District - Nizamabad (02),Rural,20-24,178806,87810,90996,30050,16159,7611,39812,12465,27347,36834
28,533,District - Nizamabad (02),Rural,Adolescent (10-19),391055,200139,190916,65752,41578,21840,33935,13609,20326,22952
28,533,District - Nizamabad (02),Rural,Youth (15-24),366030,183792,182238,61947,34621,17234,59731,20071,39660,56114
28,533,District - Nizamabad (02),Urban,All Ages,588372,291804,296568,47649,7644,3623,186156,74774,111382,13983
28,533,District - Nizamabad (02),Urban,10-14,61168,30942,30226,5392,1567,674,3206,1589,1617,164
28,533,District - Nizamabad (02),Urban,15-19,59164,29159,30005,4922,902,416,4009,1922,2087,675
28,533,District - Nizamabad (02),Urban,20-24,59883,28619,31264,5019,723,317,6494,2601,3893,1348
28,533,District - Nizamabad (02),Urban,Adolescent (10-19),120332,60101,60231,10314,2469,1090,7215,3511,3704,839
28,533,District - Nizamabad (02),Urban,Youth (15-24),119047,57778,61269,9941,1625,733,10503,4523,5980,2023
28,534,District - Karimnagar (03),Total,All Ages,3776269,1880800,1895469,709757,106745,53495,1569440,623562,945878,584654
28,534,District - Karimnagar (03),Total,10-14,371045,189598,181447,74568,13973,7236,12596,6061,6535,2889
28,534,District - Karimnagar (03),Total,15-19,367249,185934,181315,74561,11032,5674,17286,6884,10402,25949
28,534,District - Karimnagar (03),Total,20-24,358220,180718,177502,68579,9581,4784,37772,11573,26199,58974
28,534,District - Karimnagar (03),Total,Adolescent (10-19),738294,375532,362762,149129,25005,12910,29882,12945,16937,28838
28,534,District - Karimnagar (03),Total,Youth (15-24),725469,366652,358817,143140,20613,10458,55058,18457,36601,84923
28,534,District - Karimnagar (03),Rural,All Ages,2825044,1401950,1423094,587484,92353,46204,1286763,512462,774301,560060
28,534,District - Karimnagar (03),Rural,10-14,281523,143832,137691,62238,11968,6187,9653,4582,5071,2772
28,534,District - Karimnagar (03),Rural,15-19,273629,139024,134605,61519,9335,4837,13581,5242,8339,25047
28,534,District - Karimnagar (03),Rural,20-24,257960,131693,126267,54591,8119,4055,31041,9258,21783,56865
28,534,District - Karimnagar (03),Rural,Adolescent (10-19),555152,282856,272296,123757,21303,11024,23234,9824,13410,27819
28,534,District - Karimnagar (03),Rural,Youth (15-24),531589,270717,260872,116110,17454,8892,44622,14500,30122,81912
28,534,District - Karimnagar (03),Urban,All Ages,951225,478850,472375,122273,14392,7291,282677,111100,171577,24594
28,534,District - Karimnagar (03),Urban,10-14,89522,45766,43756,12330,2005,1049,2943,1479,1464,117
28,534,District - Karimnagar (03),Urban,15-19,93620,46910,46710,13042,1697,837,3705,1642,2063,902
28,534,District - Karimnagar (03),Urban,20-24,100260,49025,51235,13988,1462,729,6731,2315,4416,2109
28,534,District - Karimnagar (03),Urban,Adolescent (10-19),183142,92676,90466,25372,3702,1886,6648,3121,3527,1019
28,534,District - Karimnagar (03),Urban,Youth (15-24),193880,95935,97945,27030,3159,1566,10436,3957,6479,3011
28,535,District - Medak (04),Total,All Ages,3033288,1523030,1510258,537947,168985,86574,1396151,569624,826527,420719
28,535,District - Medak (04),Total,10-14,321072,164203,156869,60083,22712,12140,17966,7579,10387,4791
28,535,District - Medak (04),Total,15-19,299463,155707,143756,55854,16661,9007,28407,10978,17429,27035
28,535,District - Medak (04),Total,20-24,292001,147147,144854,51089,14712,7086,58215,18027,40188,50146
28,535,District - Medak (04),Total,Adolescent (10-19),620535,319910,300625,115937,39373,21147,46373,18557,27816,31826
28,535,District - Medak (04),Total,Youth (15-24),591464,302854,288610,106943,31373,16093,86622,29005,57617,77181
28,535,District - Medak (04),Rural,All Ages,2305417,1152806,1152611,461017,156801,80309,1170928,478390,692538,402402
28,535,District - Medak (04),Rural,10-14,248469,127305,121164,51777,20910,11247,14943,6149,8794,4664
28,535,District - Medak (04),Rural,15-19,227860,119541,108319,47880,15342,8313,24317,9183,15134,26099
28,535,District - Medak (04),Rural,20-24,213802,108897,104905,42473,13413,6480,50119,15259,34860,48346
28,535,District - Medak (04),Rural,Adolescent (10-19),476329,246846,229483,99657,36252,19560,39260,15332,23928,30763
28,535,District - Medak (04),Rural,Youth (15-24),441662,228438,213224,90353,28755,14793,74436,24442,49994,74445
28,535,District - Medak (04),Urban,All Ages,727871,370224,357647,76930,12184,6265,225223,91234,133989,18317
28,535,District - Medak (04),Urban,10-14,72603,36898,35705,8306,1802,893,3023,1430,1593,127
28,535,District - Medak (04),Urban,15-19,71603,36166,35437,7974,1319,694,4090,1795,2295,936
28,535,District - Medak (04),Urban,20-24,78199,38250,39949,8616,1299,606,8096,2768,5328,1800
28,535,District - Medak (04),Urban,Adolescent (10-19),144206,73064,71142,16280,3121,1587,7113,3225,3888,1063
28,535,District - Medak (04),Urban,Youth (15-24),149802,74416,75386,16590,2618,1300,12186,4563,7623,2736
28,536,District - Hyderabad (05),Total,All Ages,3943323,2018575,1924748,247927,48937,25556,1051168,475887,575281,16751
28,536,District - Hyderabad (05),Total,10-14,377399,195104,182295,22653,5358,2868,30231,14512,15719,186
28,536,District - Hyderabad (05),Total,15-19,379760,194945,184815,23931,4912,2536,32197,15242,16955,1440
28,536,District - Hyderabad (05),Total,20-24,414782,203305,211477,27558,5394,2494,47367,19219,28148,1947
28,536,District - Hyderabad (05),Total,Adolescent (10-19),757159,390049,367110,46584,10270,5404,62428,29754,32674,1626
28,536,District - Hyderabad (05),Total,Youth (15-24),794542,398250,396292,51489,10306,5030,79564,34461,45103,3387
28,536,District - Hyderabad (05),Rural,All Ages,0,0,0,0,0,0,0,0,0,0
28,536,District - Hyderabad (05),Rural,10-14,0,0,0,0,0,0,0,0,0,0
28,536,District - Hyderabad (05),Rural,15-19,0,0,0,0,0,0,0,0,0,0
28,536,District - Hyderabad (05),Rural,20-24,0,0,0,0,0,0,0,0,0,0
28,536,District - Hyderabad (05),Rural,Adolescent (10-19),0,0,0,0,0,0,0,0,0,0
28,536,District - Hyderabad (05),Rural,Youth (15-24),0,0,0,0,0,0,0,0,0,0
28,536,District - Hyderabad (05),Urban,All Ages,3943323,2018575,1924748,247927,48937,25556,1051168,475887,575281,16751
28,536,District - Hyderabad (05),Urban,10-14,377399,195104,182295,22653,5358,2868,30231,14512,15719,186
28,536,District - Hyderabad (05),Urban,15-19,379760,194945,184815,23931,4912,2536,32197,15242,16955,1440
28,536,District - Hyderabad (05),Urban,20-24,414782,203305,211477,27558,5394,2494,47367,19219,28148,1947
28,536,District - Hyderabad (05),Urban,Adolescent (10-19),757159,390049,367110,46584,10270,5404,62428,29754,32674,1626
28,536,District - Hyderabad (05),Urban,Youth (15-24),794542,398250,396292,51489,10306,5030,79564,34461,45103,3387
28,537,District - Rangareddy (06),Total,All Ages,5296741,2701008,2595733,652042,218757,112768,1758713,752224,1006489,258878
28,537,District - Rangareddy (06),Total,10-14,484906,248457,236449,65611,27231,14257,29799,13431,16368,3140
28,537,District - Rangareddy (06),Total,15-19,478399,246310,232089,65427,20858,11165,38218,15527,22691,16046
28,537,District - Rangareddy (06),Total,20-24,534397,258192,276205,68661,20642,9713,71413,23573,47840,29342
28,537,District - Rangareddy (06),Total,Adolescent (10-19),963305,494767,468538,131038,48089,25422,68017,28958,39059,19186
28,537,District - Rangareddy (06),Total,Youth (15-24),1012796,504502,508294,134088,41500,20878,109631,39100,70531,45388
28,537,District - Rangareddy (06),Rural,All Ages,1577569,801013,776556,325517,133890,68748,738382,307520,430862,226208
28,537,District - Rangareddy (06),Rural,10-14,165378,85000,80378,34398,18071,9501,10713,4653,6060,2835
28,537,District - Rangareddy (06),Rural,15-19,157046,83419,73627,33604,13117,7321,14932,5710,9222,14366
28,537,District - Rangareddy (06),Rural,20-24,153201,78989,74212,32277,11036,5412,29872,9303,20569,26117
28,537,District - Rangareddy (06),Rural,Adolescent (10-19),322424,168419,154005,68002,31188,16822,25645,10363,15282,17201
28,537,District - Rangareddy (06),Rural,Youth (15-24),310247,162408,147839,65881,24153,12733,44804,15013,29791,40483
28,537,District - Rangareddy (06),Urban,All Ages,3719172,1899995,1819177,326525,84867,44020,1020331,444704,575627,32670
28,537,District - Rangareddy (06),Urban,10-14,319528,163457,156071,31213,9160,4756,19086,8778,10308,305
28,537,District - Rangareddy (06),Urban,15-19,321353,162891,158462,31823,7741,3844,23286,9817,13469,1680
28,537,District - Rangareddy (06),Urban,20-24,381196,179203,201993,36384,9606,4301,41541,14270,27271,3225
28,537,District - Rangareddy (06),Urban,Adolescent (10-19),640881,326348,314533,63036,16901,8600,42372,18595,23777,1985
28,537,District - Rangareddy (06),Urban,Youth (15-24),702549,342094,360455,68207,17347,8145,64827,24087,40740,4905
28,538,District - Mahbubnagar (07),Total,All Ages,4053028,2050386,2002642,708954,364269,187035,2112382,892000,1220382,762853
28,538,District - Mahbubnagar (07),Total,10-14,447496,230984,216512,82300,48041,25671,48675,18924,29751,20716
28,538,District - Mahbubnagar (07),Total,15-19,388794,206562,182232,71017,35360,19353,70063,26247,43816,63846
28,538,District - Mahbubnagar (07),Total,20-24,372870,190816,182054,64611,31178,14998,119389,38869,80520,93864
28,538,District - Mahbubnagar (07),Total,Adolescent (10-19),836290,437546,398744,153317,83401,45024,118738,45171,73567,84562
28,538,District - Mahbubnagar (07),Total,Youth (15-24),761664,397378,364286,135628,66538,34351,189452,65116,124336,157710
28,538,District - Mahbubnagar (07),Rural,All Ages,3445336,1742438,1702898,651273,345359,176540,1923558,816273,1107285,741520
28,538,District - Mahbubnagar (07),Rural,10-14,379766,195755,184011,74054,44465,23339,45168,17393,27775,20359
28,538,District - Mahbubnagar (07),Rural,15-19,326591,175218,151373,64617,33240,18126,65518,24533,40985,62395
28,538,District - Mahbubnagar (07),Rural,20-24,311404,160932,150472,58741,29508,14240,111619,36439,75180,91499
28,538,District - Mahbubnagar (07),Rural,Adolescent (10-19),706357,370973,335384,138671,77705,41465,110686,41926,68760,82754
28,538,District - Mahbubnagar (07),Rural,Youth (15-24),637995,336150,301845,123358,62748,32366,177137,60972,116165,153894
28,538,District - Mahbubnagar (07),Urban,All Ages,607692,307948,299744,57681,18910,10495,188824,75727,113097,21333
28,538,District - Mahbubnagar (07),Urban,10-14,67730,35229,32501,8246,3576,2332,3507,1531,1976,357
28,538,District - Mahbubnagar (07),Urban,15-19,62203,31344,30859,6400,2120,1227,4545,1714,2831,1451
28,538,District - Mahbubnagar (07),Urban,20-24,61466,29884,31582,5870,1670,758,7770,2430,5340,2365
28,538,District - Mahbubnagar (07),Urban,Adolescent (10-19),129933,66573,63360,14646,5696,3559,8052,3245,4807,1808
28,538,District - Mahbubnagar (07),Urban,Youth (15-24),123669,61228,62441,12270,3790,1985,12315,4144,8171,3816
28,539,District - Nalgonda (08),Total,All Ages,3488809,1759772,1729037,637385,394279,203876,1487790,599015,888775,693259
28,539,District - Nalgonda (08),Total,10-14,358772,184054,174718,70965,47748,25524,15004,6097,8907,6824
28,539,District - Nalgonda (08),Total,15-19,354258,184876,169382,72596,39891,22107,23738,7752,15986,43307
28,539,District - Nalgonda (08),Total,20-24,342001,174642,167359,66950,37255,18465,53541,13884,39657,81701
28,539,District - Nalgonda (08),Total,Adolescent (10-19),713030,368930,344100,143561,87639,47631,38742,13849,24893,50131
28,539,District - Nalgonda (08),Total,Youth (15-24),696259,359518,336741,139546,77146,40572,77279,21636,55643,125008
28,539,District - Nalgonda (08),Rural,All Ages,2826302,1427716,1398586,550732,366300,189061,1310755,530720,780035,673409
28,539,District - Nalgonda (08),Rural,10-14,286722,147078,139644,59803,42329,22374,12849,5148,7701,6717
28,539,District - Nalgonda (08),Rural,15-19,282460,149121,133339,61749,36201,20083,21208,6837,14371,42437
28,539,District - Nalgonda (08),Rural,20-24,273915,142797,131118,57135,34592,17282,48558,12573,35985,79749
28,539,District - Nalgonda (08),Rural,Adolescent (10-19),569182,296199,272983,121552,78530,42457,34057,11985,22072,49154
28,539,District - Nalgonda (08),Rural,Youth (15-24),556375,291918,264457,118884,70793,37365,69766,19410,50356,122186
28,539,District - Nalgonda (08),Urban,All Ages,662507,332056,330451,86653,27979,14815,177035,68295,108740,19850
28,539,District - Nalgonda (08),Urban,10-14,72050,36976,35074,11162,5419,3150,2155,949,1206,107
28,539,District - Nalgonda (08),Urban,15-19,71798,35755,36043,10847,3690,2024,2530,915,1615,870
28,539,District - Nalgonda (08),Urban,20-24,68086,31845,36241,9815,2663,1183,4983,1311,3672,1952
28,539,District - Nalgonda (08),Urban,Adolescent (10-19),143848,72731,71117,22009,9109,5174,4685,1864,2821,977
28,539,District - Nalgonda (08),Urban,Youth (15-24),139884,67600,72284,20662,6353,3207,7513,2226,5287,2822
28,540,District - Warangal (09),Total,All Ages,3512576,1759281,1753295,616102,530656,268976,1447553,579491,868062,576649
28,540,District - Warangal (09),Total,10-14,373688,192527,181161,71598,67026,35019,14766,6860,7906,4628
28,540,District - Warangal (09),Total,15-19,351103,181155,169948,68140,54412,28870,20308,7639,12669,29455
28,540,District - Warangal (09),Total,20-24,330463,166805,163658,62102,46437,23209,44440,12885,31555,61240
28,540,District - Warangal (09),Total,Adolescent (10-19),724791,373682,351109,139738,121438,63889,35074,14499,20575,34083
28,540,District - Warangal (09),Total,Youth (15-24),681566,347960,333606,130242,100849,52079,64748,20524,44224,90695
28,540,District - Warangal (09),Rural,All Ages,2520243,1260594,1259649,461297,486034,246028,1182835,479177,703658,547928
28,540,District - Warangal (09),Rural,10-14,275433,141453,133980,54086,60298,31376,11685,5364,6321,4449
28,540,District - Warangal (09),Rural,15-19,248684,128567,120117,50138,48809,25859,16990,6284,10706,28416
28,540,District - Warangal (09),Rural,20-24,228026,117440,110586,44818,41903,21048,37955,10872,27083,58760
28,540,District - Warangal (09),Rural,Adolescent (10-19),524117,270020,254097,104224,109107,57235,28675,11648,17027,32865
28,540,District - Warangal (09),Rural,Youth (15-24),476710,246007,230703,94956,90712,46907,54945,17156,37789,87176
28,540,District - Warangal (09),Urban,All Ages,992333,498687,493646,154805,44622,22948,264718,100314,164404,28721
28,540,District - Warangal (09),Urban,10-14,98255,51074,47181,17512,6728,3643,3081,1496,1585,179
28,540,District - Warangal (09),Urban,15-19,102419,52588,49831,18002,5603,3011,3318,1355,1963,1039
28,540,District - Warangal (09),Urban,20-24,102437,49365,53072,17284,4534,2161,6485,2013,4472,2480
28,540,District - Warangal (09),Urban,Adolescent (10-19),200674,103662,97012,35514,12331,6654,6399,2851,3548,1218
28,540,District - Warangal (09),Urban,Youth (15-24),204856,101953,102903,35286,10137,5172,9803,3368,6435,3519
28,541,District - Khammam (10),Total,All Ages,2797370,1390988,1406382,462896,765565,378532,1167136,489348,677788,667342
28,541,District - Khammam (10),Total,10-14,279445,141142,138303,48470,90595,45260,14080,6719,7361,9723
28,541,District - Khammam (10),Total,15-19,275217,141876,133341,48017,85889,43923,22541,9435,13106,48772
28,541,District - Khammam (10),Total,20-24,280062,137324,142738,50060,77212,37557,49646,16285,33361,80565
28,541,District - Khammam (10),Total,Adolescent (10-19),554662,283018,271644,96487,176484,89183,36621,16154,20467,58495
28,541,District - Khammam (10),Total,Youth (15-24),555279,279200,276079,98077,163101,81480,72187,25720,46467,129337
28,541,District - Khammam (10),Rural,All Ages,2141459,1066781,1074678,366888,709904,352019,991926,419275,572651,643554
28,541,District - Khammam (10),Rural,10-14,218220,110725,107495,38738,83324,42153,12109,5770,6339,9500
28,541,District - Khammam (10),Rural,15-19,213728,111295,102433,38468,79678,41009,19986,8344,11642,47450
28,541,District - Khammam (10),Rural,20-24,210452,104918,105534,38979,70897,34714,44008,14482,29526,78029
28,541,District - Khammam (10),Rural,Adolescent (10-19),431948,222020,209928,77206,163002,83162,32095,14114,17981,56950
28,541,District - Khammam (10),Rural,Youth (15-24),424180,216213,207967,77447,150575,75723,63994,22826,41168,125479
28,541,District - Khammam (10),Urban,All Ages,655911,324207,331704,96008,55661,26513,175210,70073,105137,23788
28,541,District - Khammam (10),Urban,10-14,61225,30417,30808,9732,7271,3107,1971,949,1022,223
28,541,District - Khammam (10),Urban,15-19,61489,30581,30908,9549,6211,2914,2555,1091,1464,1322
28,541,District - Khammam (10),Urban,20-24,69610,32406,37204,11081,6315,2843,5638,1803,3835,2536
28,541,District - Khammam (10),Urban,Adolescent (10-19),122714,60998,61716,19281,13482,6021,4526,2040,2486,1545
28,541,District - Khammam (10),Urban,Youth (15-24),131099,62987,68112,20630,12526,5757,8193,2894,5299,3858
28,542,District - Srikakulam (11),Total,All Ages,2703114,1341738,1361376,255664,166118,81382,1207733,483914,723819,442295
28,542,District - Srikakulam (11),Total,10-14,260941,135215,125726,27582,20681,10413,9376,3809,5567,3229
28,542,District - Srikakulam (11),Total,15-19,256804,133026,123778,26049,18502,9357,20616,7158,13458,26603
28,542,District - Srikakulam (11),Total,20-24,248563,126454,122109,24409,16037,7845,45198,14009,31189,48066
28,542,District - Srikakulam (11),Total,Adolescent (10-19),517745,268241,249504,53631,39183,19770,29992,10967,19025,29832
28,542,District - Srikakulam (11),Total,Youth (15-24),505367,259480,245887,50458,34539,17202,65814,21167,44647,74669
28,542,District - Srikakulam (11),Rural,All Ages,2266411,1126888,1139523,214824,160438,78438,1079749,434766,644983,426793
28,542,District - Srikakulam (11),Rural,10-14,219947,114763,105184,23181,19940,10036,8295,3321,4974,3155
28,542,District - Srikakulam (11),Rural,15-19,215519,112613,102906,21707,17656,8879,18678,6411,12267,25874
28,542,District - Srikakulam (11),Rural,20-24,206629,106494,100135,20016,15388,7482,40986,12697,28289,46599
28,542,District - Srikakulam (11),Rural,Adolescent (10-19),435466,227376,208090,44888,37596,18915,26973,9732,17241,29029
28,542,District - Srikakulam (11),Rural,Youth (15-24),422148,219107,203041,41723,33044,16361,59664,19108,40556,72473
28,542,District - Srikakulam (11),Urban,All Ages,436703,214850,221853,40840,5680,2944,127984,49148,78836,15502
28,542,District - Srikakulam (11),Urban,10-14,40994,20452,20542,4401,741,377,1081,488,593,74
28,542,District - Srikakulam (11),Urban,15-19,41285,20413,20872,4342,846,478,1938,747,1191,729
28,542,District - Srikakulam (11),Urban,20-24,41934,19960,21974,4393,649,363,4212,1312,2900,1467
28,542,District - Srikakulam (11),Urban,Adolescent (10-19),82279,40865,41414,8743,1587,855,3019,1235,1784,803
28,542,District - Srikakulam (11),Urban,Youth (15-24),83219,40373,42846,8735,1495,841,6150,2059,4091,2196
28,543,District - Vizianagaram (12),Total,All Ages,2344474,1161477,1182997,247728,235556,114687,1106086,453974,652112,419339
28,543,District - Vizianagaram (12),Total,10-14,222262,114435,107827,25889,28688,14753,13042,5583,7459,5106
28,543,District - Vizianagaram (12),Total,15-19,214869,110391,104478,24997,24225,11916,25132,9482,15650,28596
28,543,District - Vizianagaram (12),Total,20-24,208095,104818,103277,23301,21938,10417,47330,16126,31204,44389
28,543,District - Vizianagaram (12),Total,Adolescent (10-19),437131,224826,212305,50886,52913,26669,38174,15065,23109,33702
28,543,District - Vizianagaram (12),Total,Youth (15-24),422964,215209,207755,48298,46163,22333,72462,25608,46854,72985
28,543,District - Vizianagaram (12),Rural,All Ages,1853563,920428,933135,190373,226130,110300,961725,397112,564613,408292
28,543,District - Vizianagaram (12),Rural,10-14,177741,92411,85330,19471,26604,13899,11476,4821,6655,5025
28,543,District - Vizianagaram (12),Rural,15-19,169788,88139,81649,18914,23041,11426,22603,8457,14146,28036
28,543,District - Vizianagaram (12),Rural,20-24,160216,82043,78173,17210,20977,9908,42270,14364,27906,43414
28,543,District - Vizianagaram (12),Rural,Adolescent (10-19),347529,180550,166979,38385,49645,25325,34079,13278,20801,33061
28,543,District - Vizianagaram (12),Rural,Youth (15-24),330004,170182,159822,36124,44018,21334,64873,22821,42052,71450
28,543,District - Vizianagaram (12),Urban,All Ages,490911,241049,249862,57355,9426,4387,144361,56862,87499,11047
28,543,District - Vizianagaram (12),Urban,10-14,44521,22024,22497,6418,2084,854,1566,762,804,81
28,543,District - Vizianagaram (12),Urban,15-19,45081,22252,22829,6083,1184,490,2529,1025,1504,560
28,543,District - Vizianagaram (12),Urban,20-24,47879,22775,25104,6091,961,509,5060,1762,3298,975
28,543,District - Vizianagaram (12),Urban,Adolescent (10-19),89602,44276,45326,12501,3268,1344,4095,1787,2308,641
28,543,District - Vizianagaram (12),Urban,Youth (15-24),92960,45027,47933,12174,2145,999,7589,2787,4802,1535
28,544,District - Visakhapatnam (13),Total,All Ages,4290589,2138910,2151679,329486,618500,302905,1722340,716032,1006308,376573
28,544,District - Visakhapatnam (13),Total,10-14,402050,205966,196084,32849,70346,35886,24825,10889,13936,4291
28,544,District - Visakhapatnam (13),Total,15-19,388888,197546,191342,32160,61298,29535,38344,13956,24388,22911
28,544,District - Visakhapatnam (13),Total,20-24,407228,198334,208894,34108,59222,27131,72469,23102,49367,40474
28,544,District - Visakhapatnam (13),Total,Adolescent (10-19),790938,403512,387426,65009,131644,65421,63169,24845,38324,27202
28,544,District - Visakhapatnam (13),Total,Youth (15-24),796116,395880,400236,66268,120520,56666,110813,37058,73755,63385
28,544,District - Visakhapatnam (13),Rural,All Ages,2254667,1113234,1141433,151980,579968,282244,1182500,494837,687663,357108
28,544,District - Visakhapatnam (13),Rural,10-14,223222,113324,109898,15847,64509,32313,18533,7918,10615,4183
28,544,District - Visakhapatnam (13),Rural,15-19,207187,105704,101483,14945,56312,26721,30249,10713,19536,22149
28,544,District - Visakhapatnam (13),Rural,20-24,207162,102840,104322,15218,55148,25279,54849,17423,37426,38780
28,544,District - Visakhapatnam (13),Rural,Adolescent (10-19),430409,219028,211381,30792,120821,59034,48782,18631,30151,26332
28,544,District - Visakhapatnam (13),Rural,Youth (15-24),414349,208544,205805,30163,111460,52000,85098,28136,56962,60929
28,544,District - Visakhapatnam (13),Urban,All Ages,2035922,1025676,1010246,177506,38532,20661,539840,221195,318645,19465
28,544,District - Visakhapatnam (13),Urban,10-14,178828,92642,86186,17002,5837,3573,6292,2971,3321,108
28,544,District - Visakhapatnam (13),Urban,15-19,181701,91842,89859,17215,4986,2814,8095,3243,4852,762
28,544,District - Visakhapatnam (13),Urban,20-24,200066,95494,104572,18890,4074,1852,17620,5679,11941,1694
28,544,District - Visakhapatnam (13),Urban,Adolescent (10-19),360529,184484,176045,34217,10823,6387,14387,6214,8173,870
28,544,District - Visakhapatnam (13),Urban,Youth (15-24),381767,187336,194431,36105,9060,4666,25715,8922,16793,2456
28,545,District - East Godavari (14),Total,All Ages,5154296,2569688,2584608,945269,213195,104422,1865719,852755,1012964,878084
28,545,District - East Godavari (14),Total,10-14,468065,236179,231886,94539,22494,11206,16882,8834,8048,6071
28,545,District - East Godavari (14),Total,15-19,487559,249462,238097,99507,22755,11867,31912,16794,15118,56453
28,545,District - East Godavari (14),Total,20-24,513641,257911,255730,102872,22604,10975,67398,32121,35277,101406
28,545,District - East Godavari (14),Total,Adolescent (10-19),955624,485641,469983,194046,45249,23073,48794,25628,23166,62524
28,545,District - East Godavari (14),Total,Youth (15-24),1001200,507373,493827,202379,45359,22842,99310,48915,50395,157859
28,545,District - East Godavari (14),Rural,All Ages,3840324,1922293,1918031,785984,198698,96988,1510563,698599,811964,833064
28,545,District - East Godavari (14),Rural,10-14,350750,176933,173817,77857,20511,10094,12688,6722,5966,5850
28,545,District - East Godavari (14),Rural,15-19,363847,188487,175360,82624,20772,10681,25301,13696,11605,54304
28,545,District - East Godavari (14),Rural,20-24,379659,194927,184732,85155,20933,10199,53859,26536,27323,96741
28,545,District - East Godavari (14),Rural,Adolescent (10-19),714597,365420,349177,160481,41283,20775,37989,20418,17571,60154
28,545,District - East Godavari (14),Rural,Youth (15-24),743506,383414,360092,167779,41705,20880,79160,40232,38928,151045
28,545,District - East Godavari (14),Urban,All Ages,1313972,647395,666577,159285,14497,7434,355156,154156,201000,45020
28,545,District - East Godavari (14),Urban,10-14,117315,59246,58069,16682,1983,1112,4194,2112,2082,221
28,545,District - East Godavari (14),Urban,15-19,123712,60975,62737,16883,1983,1186,6611,3098,3513,2149
28,545,District - East Godavari (14),Urban,20-24,133982,62984,70998,17717,1671,776,13539,5585,7954,4665
28,545,District - East Godavari (14),Urban,Adolescent (10-19),241027,120221,120806,33565,3966,2298,10805,5210,5595,2370
28,545,District - East Godavari (14),Urban,Youth (15-24),257694,123959,133735,34600,3654,1962,20150,8683,11467,6814
28,546,District - West Godavari (15),Total,All Ages,3936966,1964918,1972048,811698,109072,53367,1284577,585695,698882,888815
28,546,District - West Godavari (15),Total,10-14,355153,179419,175734,83586,12124,5997,10430,5362,5068,8219
28,546,District - West Godavari (15),Total,15-19,373437,192631,180806,85185,11739,6022,18299,9432,8867,64534
28,546,District - West Godavari (15),Total,20-24,391913,197797,194116,88014,11679,5524,39664,18507,21157,108353
28,546,District - West Godavari (15),Total,Adolescent (10-19),728590,372050,356540,168771,23863,12019,28729,14794,13935,72753
28,546,District - West Godavari (15),Total,Youth (15-24),765350,390428,374922,173199,23418,11546,57963,27939,30024,172887
28,546,District - West Godavari (15),Rural,All Ages,3128189,1567013,1561176,710703,99659,48661,1092559,503338,589221,844279
28,546,District - West Godavari (15),Rural,10-14,281822,142935,138887,73019,11019,5430,8360,4298,4062,7978
28,546,District - West Godavari (15),Rural,15-19,293949,152575,141374,74069,10710,5525,15299,8046,7253,62257
28,546,District - West Godavari (15),Rural,20-24,310032,158986,151046,76689,10687,5066,33281,15823,17458,103701
28,546,District - West Godavari (15),Rural,Adolescent (10-19),575771,295510,280261,147088,21729,10955,23659,12344,11315,70235
28,546,District - West Godavari (15),Rural,Youth (15-24),603981,311561,292420,150758,21397,10591,48580,23869,24711,165958
28,546,District - West Godavari (15),Urban,All Ages,808777,397905,410872,100995,9413,4706,192018,82357,109661,44536
28,546,District - West Godavari (15),Urban,10-14,73331,36484,36847,10567,1105,567,2070,1064,1006,241
28,546,District - West Godavari (15),Urban,15-19,79488,40056,39432,11116,1029,497,3000,1386,1614,2277
28,546,District - West Godavari (15),Urban,20-24,81881,38811,43070,11325,992,458,6383,2684,3699,4652
28,546,District - West Godavari (15),Urban,Adolescent (10-19),152819,76540,76279,21683,2134,1064,5070,2450,2620,2518
28,546,District - West Godavari (15),Urban,Youth (15-24),161369,78867,82502,22441,2021,955,9383,4070,5313,6929
28,547,District - Krishna (16),Total,All Ages,4517398,2267375,2250023,871063,132464,66734,1507680,668416,839264,813137
28,547,District - Krishna (16),Total,10-14,395023,202829,192194,87142,14586,7614,19416,9445,9971,7988
28,547,District - Krishna (16),Total,15-19,443109,231151,211958,86295,13638,7129,29413,13061,16352,51337
28,547,District - Krishna (16),Total,20-24,439514,216455,223059,92299,13557,6471,58824,23101,35723,91404
28,547,District - Krishna (16),Total,Adolescent (10-19),838132,433980,404152,173437,28224,14743,48829,22506,26323,59325
28,547,District - Krishna (16),Total,Youth (15-24),882623,447606,435017,178594,27195,13600,88237,36162,52075,142741
28,547,District - Krishna (16),Rural,All Ages,2673738,1343534,1330204,665621,93915,47291,1016146,451924,564222,753443
28,547,District - Krishna (16),Rural,10-14,238015,122605,115410,66549,10546,5471,11320,5508,5812,7448
28,547,District - Krishna (16),Rural,15-19,244009,129625,114384,64420,9197,4913,17445,7907,9538,48047
28,547,District - Krishna (16),Rural,20-24,257011,130268,126743,69736,9454,4572,37083,14579,22504,85449
28,547,District - Krishna (16),Rural,Adolescent (10-19),482024,252230,229794,130969,19743,10384,28765,13415,15350,55495
28,547,District - Krishna (16),Rural,Youth (15-24),501020,259893,241127,134156,18651,9485,54528,22486,32042,133496
28,547,District - Krishna (16),Urban,All Ages,1843660,923841,919819,205442,38549,19443,491534,216492,275042,59694
28,547,District - Krishna (16),Urban,10-14,157008,80224,76784,20593,4040,2143,8096,3937,4159,540
28,547,District - Krishna (16),Urban,15-19,199100,101526,97574,21875,4441,2216,11968,5154,6814,3290
28,547,District - Krishna (16),Urban,20-24,182503,86187,96316,22563,4103,1899,21741,8522,13219,5955
28,547,District - Krishna (16),Urban,Adolescent (10-19),356108,181750,174358,42468,8481,4359,20064,9091,10973,3830
28,547,District - Krishna (16),Urban,Youth (15-24),381603,187713,193890,44438,8544,4115,33709,13676,20033,9245
28,548,District - Guntur (17),Total,All Ages,4887813,2440521,2447292,957407,247089,125105,1927372,805795,1121577,1035569
28,548,District - Guntur (17),Total,10-14,446393,230570,215823,96298,26402,13956,25144,11243,13901,15891
28,548,District - Guntur (17),Total,15-19,461689,238430,223259,95467,23072,12020,43979,17487,26492,70324
28,548,District - Guntur (17),Total,20-24,478898,235579,243319,102470,25468,11950,87991,29995,57996,117836
28,548,District - Guntur (17),Total,Adolescent (10-19),908082,469000,439082,191765,49474,25976,69123,28730,40393,86215
28,548,District - Guntur (17),Total,Youth (15-24),940587,474009,466578,197937,48540,23970,131970,47482,84488,188160
28,548,District - Guntur (17),Rural,All Ages,3235075,1621491,1613584,740117,190905,96911,1437141,604197,832944,951348
28,548,District - Guntur (17),Rural,10-14,294040,152455,141585,73070,20081,10610,17863,7771,10092,14642
28,548,District - Guntur (17),Rural,15-19,295066,157437,137629,71823,17260,9141,32284,12520,19764,64881
28,548,District - Guntur (17),Rural,20-24,309761,155810,153951,78346,19377,9121,65890,22039,43851,109112
28,548,District - Guntur (17),Rural,Adolescent (10-19),589106,309892,279214,144893,37341,19751,50147,20291,29856,79523
28,548,District - Guntur (17),Rural,Youth (15-24),604827,313247,291580,150169,36637,18262,98174,34559,63615,173993
28,548,District - Guntur (17),Urban,All Ages,1652738,819030,833708,217290,56184,28194,490231,201598,288633,84221
28,548,District - Guntur (17),Urban,10-14,152353,78115,74238,23228,6321,3346,7281,3472,3809,1249
28,548,District - Guntur (17),Urban,15-19,166623,80993,85630,23644,5812,2879,11695,4967,6728,5443
28,548,District - Guntur (17),Urban,20-24,169137,79769,89368,24124,6091,2829,22101,7956,14145,8724
28,548,District - Guntur (17),Urban,Adolescent (10-19),318976,159108,159868,46872,12133,6225,18976,8439,10537,6692
28,548,District - Guntur (17),Urban,Youth (15-24),335760,160762,174998,47768,11903,5708,33796,12923,20873,14167
28,549,District - Prakasam (18),Total,All Ages,3397448,1714764,1682684,787861,151145,76677,1493013,607078,885935,721512
28,549,District - Prakasam (18),Total,10-14,328482,169600,158882,86519,16476,8756,19969,8318,11651,10589
28,549,District - Prakasam (18),Total,15-19,307602,165413,142189,76895,13813,7068,35341,13503,21838,50364
28,549,District - Prakasam (18),Total,20-24,320805,162548,158257,78904,15022,6935,70444,22537,47907,82932
28,549,District - Prakasam (18),Total,Adolescent (10-19),636084,335013,301071,163414,30289,15824,55310,21821,33489,60953
28,549,District - Prakasam (18),Total,Youth (15-24),628407,327961,300446,155799,28835,14003,105785,36040,69745,133296
28,549,District - Prakasam (18),Rural,All Ages,2732866,1382641,1350225,698090,124386,63386,1296953,530053,766900,697207
28,549,District - Prakasam (18),Rural,10-14,264775,137031,127744,76073,13548,7197,17293,7083,10210,10294
28,549,District - Prakasam (18),Rural,15-19,245307,133525,111782,67569,11361,5874,31613,11984,19629,49207
28,549,District - Prakasam (18),Rural,20-24,255581,131486,124095,69424,12246,5781,62942,20055,42887,80657
28,549,District - Prakasam (18),Rural,Adolescent (10-19),510082,270556,239526,143642,24909,13071,48906,19067,29839,59501
28,549,District - Prakasam (18),Rural,Youth (15-24),500888,265011,235877,136993,23607,11655,94555,32039,62516,129864
28,549,District - Prakasam (18),Urban,All Ages,664582,332123,332459,89771,26759,13291,196060,77025,119035,24305
28,549,District - Prakasam (18),Urban,10-14,63707,32569,31138,10446,2928,1559,2676,1235,1441,295
28,549,District - Prakasam (18),Urban,15-19,62295,31888,30407,9326,2452,1194,3728,1519,2209,1157
28,549,District - Prakasam (18),Urban,20-24,65224,31062,34162,9480,2776,1154,7502,2482,5020,2275
28,549,District - Prakasam (18),Urban,Adolescent (10-19),126002,64457,61545,19772,5380,2753,6404,2754,3650,1452
28,549,District - Prakasam (18),Urban,Youth (15-24),127519,62950,64569,18806,5228,2348,11230,4001,7229,3432
28,550,District - Sri Potti Sriramulu Nellore (19),Total,All Ages,2963557,1492974,1470583,666588,285997,145168,1131368,481052,650316,456592
28,550,District - Sri Potti Sriramulu Nellore (19),Total,10-14,272221,141628,130593,69407,28922,15388,13294,6946,6348,5275
28,550,District - Sri Potti Sriramulu Nellore (19),Total,15-19,301772,161569,140203,68270,26919,14147,20565,9309,11256,29845
28,550,District - Sri Potti Sriramulu Nellore (19),Total,20-24,278088,137345,140743,67920,26813,12247,40759,14844,25915,50439
28,550,District - Sri Potti Sriramulu Nellore (19),Total,Adolescent (10-19),573993,303197,270796,137677,55841,29535,33859,16255,17604,35120
28,550,District - Sri Potti Sriramulu Nellore (19),Total,Youth (15-24),579860,298914,280946,136190,53732,26394,61324,24153,37171,80284
28,550,District - Sri Potti Sriramulu Nellore (19),Rural,All Ages,2105927,1060810,1045117,544770,240972,122388,908308,387864,520444,437917
28,550,District - Sri Potti Sriramulu Nellore (19),Rural,10-14,197113,103035,94078,56081,24272,12971,10041,5237,4804,5102
28,550,District - Sri Potti Sriramulu Nellore (19),Rural,15-19,190402,101257,89145,53716,20947,10971,15964,7259,8705,28982
28,550,District - Sri Potti Sriramulu Nellore (19),Rural,20-24,199307,100231,99076,55644,22506,10267,33126,11919,21207,48697
28,550,District - Sri Potti Sriramulu Nellore (19),Rural,Adolescent (10-19),387515,204292,183223,109797,45219,23942,26005,12496,13509,34084
28,550,District - Sri Potti Sriramulu Nellore (19),Rural,Youth (15-24),389709,201488,188221,109360,43453,21238,49090,19178,29912,77679
28,550,District - Sri Potti Sriramulu Nellore (19),Urban,All Ages,857630,432164,425466,121818,45025,22780,223060,93188,129872,18675
28,550,District - Sri Potti Sriramulu Nellore (19),Urban,10-14,75108,38593,36515,13326,4650,2417,3253,1709,1544,173
28,550,District - Sri Potti Sriramulu Nellore (19),Urban,15-19,111370,60312,51058,14554,5972,3176,4601,2050,2551,863
28,550,District - Sri Potti Sriramulu Nellore (19),Urban,20-24,78781,37114,41667,12276,4307,1980,7633,2925,4708,1742
28,550,District - Sri Potti Sriramulu Nellore (19),Urban,Adolescent (10-19),186478,98905,87573,27880,10622,5593,7854,3759,4095,1036
28,550,District - Sri Potti Sriramulu Nellore (19),Urban,Youth (15-24),190151,97426,92725,26830,10279,5156,12234,4975,7259,2605
28,551,District - Y.S.R. (20),Total,All Ages,2882469,1451777,1430692,465794,75886,38571,1165703,457078,708625,398305
28,551,District - Y.S.R. (20),Total,10-14,273328,140625,132703,49395,7868,4187,11023,4921,6102,3538
28,551,District - Y.S.R. (20),Total,15-19,264768,138176,126592,44473,6776,3568,18287,6958,11329,22046
28,551,District - Y.S.R. (20),Total,20-24,268608,135324,133284,44984,7031,3251,40547,11816,28731,42004
28,551,District - Y.S.R. (20),Total,Adolescent (10-19),538096,278801,259295,93868,14644,7755,29310,11879,17431,25584
28,551,District - Y.S.R. (20),Total,Youth (15-24),533376,273500,259876,89457,13807,6819,58834,18774,40060,64050
28,551,District - Y.S.R. (20),Rural,All Ages,1903337,959693,943644,355350,58181,29754,840981,328753,512228,366579
28,551,District - Y.S.R. (20),Rural,10-14,180205,92486,87719,37786,5997,3203,7217,3165,4052,3296
28,551,District - Y.S.R. (20),Rural,15-19,171503,90897,80606,33578,5126,2756,12228,4414,7814,20584
28,551,District - Y.S.R. (20),Rural,20-24,171434,88088,83346,33548,5382,2502,28534,7869,20665,39132
28,551,District - Y.S.R. (20),Rural,Adolescent (10-19),351708,183383,168325,71364,11123,5959,19445,7579,11866,23880
28,551,District - Y.S.R. (20),Rural,Youth (15-24),342937,178985,163952,67126,10508,5258,40762,12283,28479,59716
28,551,District - Y.S.R. (20),Urban,All Ages,979132,492084,487048,110444,17705,8817,324722,128325,196397,31726
28,551,District - Y.S.R. (20),Urban,10-14,93123,48139,44984,11609,1871,984,3806,1756,2050,242
28,551,District - Y.S.R. (20),Urban,15-19,93265,47279,45986,10895,1650,812,6059,2544,3515,1462
28,551,District - Y.S.R. (20),Urban,20-24,97174,47236,49938,11436,1649,749,12013,3947,8066,2872
28,551,District - Y.S.R. (20),Urban,Adolescent (10-19),186388,95418,90970,22504,3521,1796,9865,4300,5565,1704
28,551,District - Y.S.R. (20),Urban,Youth (15-24),190439,94515,95924,22331,3299,1561,18072,6491,11581,4334
28,552,District - Kurnool (21),Total,All Ages,4053463,2039227,2014236,737945,82831,42052,1926302,792858,1133444,869074
28,552,District - Kurnool (21),Total,10-14,442302,227842,214460,85578,10600,5622,50588,20202,30386,28526
28,552,District - Kurnool (21),Total,15-19,407679,214548,193131,77103,9415,5124,75216,29569,45647,81273
28,552,District - Kurnool (21),Total,20-24,395011,198891,196120,74372,8233,4037,119297,40777,78520,111067
28,552,District - Kurnool (21),Total,Adolescent (10-19),849981,442390,407591,162681,20015,10746,125804,49771,76033,109799
28,552,District - Kurnool (21),Total,Youth (15-24),802690,413439,389251,151475,17648,9161,194513,70346,124167,192340
28,552,District - Kurnool (21),Rural,All Ages,2904177,1464569,1439608,569045,64735,32573,1513718,623058,890660,825230
28,552,District - Kurnool (21),Rural,10-14,319254,164881,154373,66069,8270,4274,40615,15513,25102,27310
28,552,District - Kurnool (21),Rural,15-19,289102,154817,134285,58650,6932,3563,60517,23272,37245,78012
28,552,District - Kurnool (21),Rural,20-24,276640,141979,134661,56119,6384,3165,95883,32161,63722,105969
28,552,District - Kurnool (21),Rural,Adolescent (10-19),608356,319698,288658,124719,15202,7837,101132,38785,62347,105322
28,552,District - Kurnool (21),Rural,Youth (15-24),565742,296796,268946,114769,13316,6728,156400,55433,100967,183981
28,552,District - Kurnool (21),Urban,All Ages,1149286,574658,574628,168900,18096,9479,412584,169800,242784,43844
28,552,District - Kurnool (21),Urban,10-14,123048,62961,60087,19509,2330,1348,9973,4689,5284,1216
28,552,District - Kurnool (21),Urban,15-19,118577,59731,58846,18453,2483,1561,14699,6297,8402,3261
28,552,District - Kurnool (21),Urban,20-24,118371,56912,61459,18253,1849,872,23414,8616,14798,5098
28,552,District - Kurnool (21),Urban,Adolescent (10-19),241625,122692,118933,37962,4813,2909,24672,10986,13686,4477
28,552,District - Kurnool (21),Urban,Youth (15-24),236948,116643,120305,36706,4332,2433,38113,14913,23200,8359
28,553,District - Anantapur (22),Total,All Ages,4081148,2064495,2016653,583135,154127,78573,1770188,726021,1044167,653162
28,553,District - Anantapur (22),Total,10-14,389193,201144,188049,61652,16470,8558,21693,10185,11508,9128
28,553,District - Anantapur (22),Total,15-19,388002,203027,184975,60102,14901,8055,36417,15552,20865,50687
28,553,District - Anantapur (22),Total,20-24,381660,193325,188335,56181,14188,7127,72218,24317,47901,77209
28,553,District - Anantapur (22),Total,Adolescent (10-19),777195,404171,373024,121754,31371,16613,58110,25737,32373,59815
28,553,District - Anantapur (22),Total,Youth (15-24),769662,396352,373310,116283,29089,15182,108635,39869,68766,127896
28,553,District - Anantapur (22),Rural,All Ages,2935437,1489157,1446280,475929,126362,64563,1389043,572099,816944,627657
28,553,District - Anantapur (22),Rural,10-14,279005,145009,133996,49841,13165,6897,15980,7406,8574,8789
28,553,District - Anantapur (22),Rural,15-19,274918,145504,129414,49073,12019,6544,27583,11526,16057,49170
28,553,District - Anantapur (22),Rural,20-24,268238,138487,129751,45027,11462,5879,56543,18585,37958,74824
28,553,District - Anantapur (22),Rural,Adolescent (10-19),553923,290513,263410,98914,25184,13441,43563,18932,24631,57959
28,553,District - Anantapur (22),Rural,Youth (15-24),543156,283991,259165,94100,23481,12423,84126,30111,54015,123994
28,553,District - Anantapur (22),Urban,All Ages,1145711,575338,570373,107206,27765,14010,381145,153922,227223,25505
28,553,District - Anantapur (22),Urban,10-14,110188,56135,54053,11811,3305,1661,5713,2779,2934,339
28,553,District - Anantapur (22),Urban,15-19,113084,57523,55561,11029,2882,1511,8834,4026,4808,1517
28,553,District - Anantapur (22),Urban,20-24,113422,54838,58584,11154,2726,1248,15675,5732,9943,2385
28,553,District - Anantapur (22),Urban,Adolescent (10-19),223272,113658,109614,22840,6187,3172,14547,6805,7742,1856
28,553,District - Anantapur (22),Urban,Youth (15-24),226506,112361,114145,22183,5608,2759,24509,9758,14751,3902
28,554,District - Chittoor (23),Total,All Ages,4174064,2090204,2083860,785760,159165,79756,1506186,605410,900776,605110
28,554,District - Chittoor (23),Total,10-14,375547,193464,182083,76804,16642,8633,13944,6531,7413,5507
28,554,District - Chittoor (23),Total,15-19,376355,195547,180808,74031,14493,7431,18873,7711,11162,35203
28,554,District - Chittoor (23),Total,20-24,375703,184000,191703,74384,14301,6671,38840,11828,27012,61515
28,554,District - Chittoor (23),Total,Adolescent (10-19),751902,389011,362891,150835,31135,16064,32817,14242,18575,40710
28,554,District - Chittoor (23),Total,Youth (15-24),752058,379547,372511,148415,28794,14102,57713,19539,38174,96718
28,554,District - Chittoor (23),Rural,All Ages,2942678,1474052,1468626,647424,128753,64879,1185462,475301,710161,583157
28,554,District - Chittoor (23),Rural,10-14,264674,136797,127877,62616,12981,6978,10645,4922,5723,5385
28,554,District - Chittoor (23),Rural,15-19,256746,135097,121649,58462,11158,5821,14631,5807,8824,34312
28,554,District - Chittoor (23),Rural,20-24,254509,127076,127433,59174,11225,5258,30538,9042,21496,59643
28,554,District - Chittoor (23),Rural,Adolescent (10-19),521420,271894,249526,121078,24139,12799,25276,10729,14547,39697
28,554,District - Chittoor (23),Rural,Youth (15-24),511255,262173,249082,117636,22383,11079,45169,14849,30320,93955
28,554,District - Chittoor (23),Urban,All Ages,1231386,616152,615234,138336,30412,14877,320724,130109,190615,21953
28,554,District - Chittoor (23),Urban,10-14,110873,56667,54206,14188,3661,1655,3299,1609,1690,122
28,554,District - Chittoor (23),Urban,15-19,119609,60450,59159,15569,3335,1610,4242,1904,2338,891
28,554,District - Chittoor (23),Urban,20-24,121194,56924,64270,15210,3076,1413,8302,2786,5516,1872
28,554,District - Chittoor (23),Urban,Adolescent (10-19),230482,117117,113365,29757,6996,3265,7541,3513,4028,1013
28,554,District - Chittoor (23),Urban,Youth (15-24),240803,117374,123429,30779,6411,3023,12544,4690,7854,2763
29,0,State - KARNATAKA (29),Total,All Ages,61095297,30966657,30128640,10474992,4248987,2134754,20447975,8458186,11989789,5119921
29,0,State - KARNATAKA (29),Total,10-14,5736646,2955287,2781359,1103733,447364,228616,267129,116156,150973,75786
29,0,State - KARNATAKA (29),Total,15-19,5827277,3042048,2785229,1087822,447122,234606,409854,172854,237000,432855
29,0,State - KARNATAKA (29),Total,20-24,6052558,3109586,2942972,1058885,421821,215390,684094,250002,434092,636819
29,0,State - KARNATAKA (29),Total,Adolescent (10-19),11563923,5997335,5566588,2191555,894486,463222,676983,289010,387973,508641
29,0,State - KARNATAKA (29),Total,Youth (15-24),11879835,6151634,5728201,2146707,868943,449996,1093948,422856,671092,1069674
29,0,State - KARNATAKA (29),Rural,All Ages,37469335,18929354,18539981,7495763,3429791,1723762,14820159,6035917,8784242,4795763
29,0,State - KARNATAKA (29),Rural,10-14,3662475,1889725,1772750,800727,365850,187087,190066,79690,110376,71674
29,0,State - KARNATAKA (29),Rural,15-19,3658264,1933809,1724455,774120,361744,190912,306921,125521,181400,411252
29,0,State - KARNATAKA (29),Rural,20-24,3549425,1849584,1699841,728105,330756,170624,507006,178697,328309,600928
29,0,State - KARNATAKA (29),Rural,Adolescent (10-19),7320739,3823534,3497205,1574847,727594,377999,496987,205211,291776,482926
29,0,State - KARNATAKA (29),Rural,Youth (15-24),7207689,3783393,3424296,1502225,692500,361536,813927,304218,509709,1012180
29,0,State - KARNATAKA (29),Urban,All Ages,23625962,12037303,11588659,2979229,819196,410992,5627816,2422269,3205547,324158
29,0,State - KARNATAKA (29),Urban,10-14,2074171,1065562,1008609,303006,81514,41529,77063,36466,40597,4112
29,0,State - KARNATAKA (29),Urban,15-19,2169013,1108239,1060774,313702,85378,43694,102933,47333,55600,21603
29,0,State - KARNATAKA (29),Urban,20-24,2503133,1260002,1243131,330780,91065,44766,177088,71305,105783,35891
29,0,State - KARNATAKA (29),Urban,Adolescent (10-19),4243184,2173801,2069383,616708,166892,85223,179996,83799,96197,25715
29,0,State - KARNATAKA (29),Urban,Youth (15-24),4672146,2368241,2303905,644482,176443,88460,280021,118638,161383,57494
29,555,District - Belgaum (01),Total,All Ages,4779661,2423063,2356598,577418,297198,148673,1727629,697515,1030114,465995
29,555,District - Belgaum (01),Total,10-14,473479,247027,226452,60796,31913,16498,16574,7463,9111,4667
29,555,District - Belgaum (01),Total,15-19,457740,249599,208141,55930,29929,16377,25553,10987,14566,35217
29,555,District - Belgaum (01),Total,20-24,444897,232409,212488,55513,27792,14042,48472,16847,31625,58383
29,555,District - Belgaum (01),Total,Adolescent (10-19),931219,496626,434593,116726,61842,32875,42127,18450,23677,39884
29,555,District - Belgaum (01),Total,Youth (15-24),902637,482008,420629,111443,57721,30419,74025,27834,46191,93600
29,555,District - Belgaum (01),Rural,All Ages,3568466,1811094,1757372,448375,253876,127133,1433674,577292,856382,440954
29,555,District - Belgaum (01),Rural,10-14,361880,188611,173269,47501,27446,14163,13199,5864,7335,4489
29,555,District - Belgaum (01),Rural,15-19,344423,189860,154563,43098,25377,14028,21291,9033,12258,33923
29,555,District - Belgaum (01),Rural,20-24,325672,171965,153707,42085,23164,11810,41236,14063,27173,55781
29,555,District - Belgaum (01),Rural,Adolescent (10-19),706303,378471,327832,90599,52823,28191,34490,14897,19593,38412
29,555,District - Belgaum (01),Rural,Youth (15-24),670095,361825,308270,85183,48541,25838,62527,23096,39431,89704
29,555,District - Belgaum (01),Urban,All Ages,1211195,611969,599226,129043,43322,21540,293955,120223,173732,25041
29,555,District - Belgaum (01),Urban,10-14,111599,58416,53183,13295,4467,2335,3375,1599,1776,178
29,555,District - Belgaum (01),Urban,15-19,113317,59739,53578,12832,4552,2349,4262,1954,2308,1294
29,555,District - Belgaum (01),Urban,20-24,119225,60444,58781,13428,4628,2232,7236,2784,4452,2602
29,555,District - Belgaum (01),Urban,Adolescent (10-19),224916,118155,106761,26127,9019,4684,7637,3553,4084,1472
29,555,District - Belgaum (01),Urban,Youth (15-24),232542,120183,112359,26260,9180,4581,11498,4738,6760,3896
29,556,District - Bagalkot (02),Total,All Ages,1889752,950111,939641,319149,97203,48470,776340,308723,467617,223373
29,556,District - Bagalkot (02),Total,10-14,198739,102271,96468,37269,10627,5438,11112,4903,6209,3560
29,556,District - Bagalkot (02),Total,15-19,189079,101865,87214,33766,10071,5493,17569,7311,10258,19953
29,556,District - Bagalkot (02),Total,20-24,180276,92562,87714,30729,9278,4750,32424,10976,21448,29918
29,556,District - Bagalkot (02),Total,Adolescent (10-19),387818,204136,183682,71035,20698,10931,28681,12214,16467,23513
29,556,District - Bagalkot (02),Total,Youth (15-24),369355,194427,174928,64495,19349,10243,49993,18287,31706,49871
29,556,District - Bagalkot (02),Rural,All Ages,1291906,650267,641639,238014,80820,40322,586994,233421,353573,203072
29,556,District - Bagalkot (02),Rural,10-14,138838,71351,67487,28128,8875,4532,8205,3585,4620,3249
29,556,District - Bagalkot (02),Rural,15-19,128443,70795,57648,24727,8324,4587,13329,5486,7843,18447
29,556,District - Bagalkot (02),Rural,20-24,119228,62361,56867,22202,7508,3895,25103,8349,16754,27481
29,556,District - Bagalkot (02),Rural,Adolescent (10-19),267281,142146,125135,52855,17199,9119,21534,9071,12463,21696
29,556,District - Bagalkot (02),Rural,Youth (15-24),247671,133156,114515,46929,15832,8482,38432,13835,24597,45928
29,556,District - Bagalkot (02),Urban,All Ages,597846,299844,298002,81135,16383,8148,189346,75302,114044,20301
29,556,District - Bagalkot (02),Urban,10-14,59901,30920,28981,9141,1752,906,2907,1318,1589,311
29,556,District - Bagalkot (02),Urban,15-19,60636,31070,29566,9039,1747,906,4240,1825,2415,1506
29,556,District - Bagalkot (02),Urban,20-24,61048,30201,30847,8527,1770,855,7321,2627,4694,2437
29,556,District - Bagalkot (02),Urban,Adolescent (10-19),120537,61990,58547,18180,3499,1812,7147,3143,4004,1817
29,556,District - Bagalkot (02),Urban,Youth (15-24),121684,61271,60413,17566,3517,1761,11561,4452,7109,3943
29,557,District - Bijapur (03),Total,All Ages,2177331,1111022,1066309,442773,39314,19912,929063,380456,548607,260791
29,557,District - Bijapur (03),Total,10-14,236092,122745,113347,52332,4411,2244,15522,6270,9252,3846
29,557,District - Bijapur (03),Total,15-19,218221,119316,98905,46390,4096,2228,25931,10427,15504,22100
29,557,District - Bijapur (03),Total,20-24,203007,106802,96205,40736,3765,1953,41352,14148,27204,34231
29,557,District - Bijapur (03),Total,Adolescent (10-19),454313,242061,212252,98722,8507,4472,41453,16697,24756,25946
29,557,District - Bijapur (03),Total,Youth (15-24),421228,226118,195110,87126,7861,4181,67283,24575,42708,56331
29,557,District - Bijapur (03),Rural,All Ages,1675353,857562,817791,364088,31644,16124,781221,319162,462059,250666
29,557,District - Bijapur (03),Rural,10-14,182944,95300,87644,42947,3579,1822,12799,5050,7749,3683
29,557,District - Bijapur (03),Rural,15-19,166861,93090,73771,37658,3266,1814,22046,8781,13265,21359
29,557,District - Bijapur (03),Rural,20-24,151729,81612,70117,32698,2981,1580,35373,12027,23346,33059
29,557,District - Bijapur (03),Rural,Adolescent (10-19),349805,188390,161415,80605,6845,3636,34845,13831,21014,25042
29,557,District - Bijapur (03),Rural,Youth (15-24),318590,174702,143888,70356,6247,3394,57419,20808,36611,54418
29,557,District - Bijapur (03),Urban,All Ages,501978,253460,248518,78685,7670,3788,147842,61294,86548,10125
29,557,District - Bijapur (03),Urban,10-14,53148,27445,25703,9385,832,422,2723,1220,1503,163
29,557,District - Bijapur (03),Urban,15-19,51360,26226,25134,8732,830,414,3885,1646,2239,741
29,557,District - Bijapur (03),Urban,20-24,51278,25190,26088,8038,784,373,5979,2121,3858,1172
29,557,District - Bijapur (03),Urban,Adolescent (10-19),104508,53671,50837,18117,1662,836,6608,2866,3742,904
29,557,District - Bijapur (03),Urban,Youth (15-24),102638,51416,51222,16770,1614,787,9864,3767,6097,1913
29,558,District - Bidar (04),Total,All Ages,1703300,870665,832635,399785,235822,119787,660627,273467,387160,198559
29,558,District - Bidar (04),Total,10-14,194987,100067,94920,48020,28354,14239,11058,5000,6058,2587
29,558,District - Bidar (04),Total,15-19,191206,100134,91072,44108,27054,14122,15934,7054,8880,14209
29,558,District - Bidar (04),Total,20-24,165566,91164,74402,37857,22153,12444,23511,8999,14512,22721
29,558,District - Bidar (04),Total,Adolescent (10-19),386193,200201,185992,92128,55408,28361,26992,12054,14938,16796
29,558,District - Bidar (04),Total,Youth (15-24),356772,191298,165474,81965,49207,26566,39445,16053,23392,36930
29,558,District - Bidar (04),Rural,All Ages,1277348,651250,626098,330419,214759,109197,537637,220569,317068,190271
29,558,District - Bidar (04),Rural,10-14,145013,74073,70940,39264,25696,12918,8452,3710,4742,2494
29,558,District - Bidar (04),Rural,15-19,141929,74476,67453,36045,24572,12862,12671,5437,7234,13690
29,558,District - Bidar (04),Rural,20-24,120674,67529,53145,30661,20015,11380,19076,7083,11993,21875
29,558,District - Bidar (04),Rural,Adolescent (10-19),286942,148549,138393,75309,50268,25780,21123,9147,11976,16184
29,558,District - Bidar (04),Rural,Youth (15-24),262603,142005,120598,66706,44587,24242,31747,12520,19227,35565
29,558,District - Bidar (04),Urban,All Ages,425952,219415,206537,69366,21063,10590,122990,52898,70092,8288
29,558,District - Bidar (04),Urban,10-14,49974,25994,23980,8756,2658,1321,2606,1290,1316,93
29,558,District - Bidar (04),Urban,15-19,49277,25658,23619,8063,2482,1260,3263,1617,1646,519
29,558,District - Bidar (04),Urban,20-24,44892,23635,21257,7196,2138,1064,4435,1916,2519,846
29,558,District - Bidar (04),Urban,Adolescent (10-19),99251,51652,47599,16819,5140,2581,5869,2907,2962,612
29,558,District - Bidar (04),Urban,Youth (15-24),94169,49293,44876,15259,4620,2324,7698,3533,4165,1365
29,559,District - Raichur (05),Total,All Ages,1928812,964511,964301,400933,367071,182101,949043,387298,561745,269528
29,559,District - Raichur (05),Total,10-14,216585,111067,105518,47952,44422,22546,24632,9370,15262,8779
29,559,District - Raichur (05),Total,15-19,212033,110397,101636,45144,41794,21755,44546,16362,28184,34682
29,559,District - Raichur (05),Total,20-24,189067,95333,93734,38976,34497,17122,61315,20276,41039,39715
29,559,District - Raichur (05),Total,Adolescent (10-19),428618,221464,207154,93096,86216,44301,69178,25732,43446,43461
29,559,District - Raichur (05),Total,Youth (15-24),401100,205730,195370,84120,76291,38877,105861,36638,69223,74397
29,559,District - Raichur (05),Rural,All Ages,1438464,717972,720492,313581,334023,165593,779024,318385,460639,255973
29,559,District - Raichur (05),Rural,10-14,164308,84407,79901,38068,40375,20478,21327,7949,13378,8423
29,559,District - Raichur (05),Rural,15-19,158035,82502,75533,35078,37775,19663,38650,13967,24683,33198
29,559,District - Raichur (05),Rural,20-24,136524,69142,67382,29146,31003,15369,52409,17239,35170,37880
29,559,District - Raichur (05),Rural,Adolescent (10-19),322343,166909,155434,73146,78150,40141,59977,21916,38061,41621
29,559,District - Raichur (05),Rural,Youth (15-24),294559,151644,142915,64224,68778,35032,91059,31206,59853,71078
29,559,District - Raichur (05),Urban,All Ages,490348,246539,243809,87352,33048,16508,170019,68913,101106,13555
29,559,District - Raichur (05),Urban,10-14,52277,26660,25617,9884,4047,2068,3305,1421,1884,356
29,559,District - Raichur (05),Urban,15-19,53998,27895,26103,10066,4019,2092,5896,2395,3501,1484
29,559,District - Raichur (05),Urban,20-24,52543,26191,26352,9830,3494,1753,8906,3037,5869,1835
29,559,District - Raichur (05),Urban,Adolescent (10-19),106275,54555,51720,19950,8066,4160,9201,3816,5385,1840
29,559,District - Raichur (05),Urban,Youth (15-24),106541,54086,52455,19896,7513,3845,14802,5432,9370,3319
29,560,District - Koppal (06),Total,All Ages,1389920,699926,689994,258608,164271,82761,580835,231141,349694,180632
29,560,District - Koppal (06),Total,10-14,156128,80050,76078,31502,20282,10502,9943,3924,6019,4705
29,560,District - Koppal (06),Total,15-19,153733,81464,72269,28787,19361,10459,18303,6933,11370,22432
29,560,District - Koppal (06),Total,20-24,135314,70256,65058,24051,15695,8194,28523,9129,19394,26177
29,560,District - Koppal (06),Total,Adolescent (10-19),309861,161514,148347,60289,39643,20961,28246,10857,17389,27137
29,560,District - Koppal (06),Total,Youth (15-24),289047,151720,137327,52838,35056,18653,46826,16062,30764,48609
29,560,District - Koppal (06),Rural,All Ages,1156216,582958,573258,222935,152563,76987,505215,200688,304527,174719
29,560,District - Koppal (06),Rural,10-14,131538,67542,63996,27249,18880,9790,8848,3438,5410,4600
29,560,District - Koppal (06),Rural,15-19,128575,68805,59770,24717,17983,9792,16467,6245,10222,21875
29,560,District - Koppal (06),Rural,20-24,111022,58122,52900,20297,14466,7588,25305,7987,17318,25448
29,560,District - Koppal (06),Rural,Adolescent (10-19),260113,136347,123766,51966,36863,19582,25315,9683,15632,26475
29,560,District - Koppal (06),Rural,Youth (15-24),239597,126927,112670,45014,32449,17380,41772,14232,27540,47323
29,560,District - Koppal (06),Urban,All Ages,233704,116968,116736,35673,11708,5774,75620,30453,45167,5913
29,560,District - Koppal (06),Urban,10-14,24590,12508,12082,4253,1402,712,1095,486,609,105
29,560,District - Koppal (06),Urban,15-19,25158,12659,12499,4070,1378,667,1836,688,1148,557
29,560,District - Koppal (06),Urban,20-24,24292,12134,12158,3754,1229,606,3218,1142,2076,729
29,560,District - Koppal (06),Urban,Adolescent (10-19),49748,25167,24581,8323,2780,1379,2931,1174,1757,662
29,560,District - Koppal (06),Urban,Youth (15-24),49450,24793,24657,7824,2607,1273,5054,1830,3224,1286
29,561,District - Gadag (07),Total,All Ages,1064570,537147,527423,174196,61654,30975,364393,139969,224424,157393
29,561,District - Gadag (07),Total,10-14,103829,53204,50625,19867,6173,3198,3907,1760,2147,2237
29,561,District - Gadag (07),Total,15-19,108759,57834,50925,19419,6570,3540,6958,2912,4046,14751
29,561,District - Gadag (07),Total,20-24,105623,55321,50302,17560,6392,3377,13069,4445,8624,21289
29,561,District - Gadag (07),Total,Adolescent (10-19),212588,111038,101550,39286,12743,6738,10865,4672,6193,16988
29,561,District - Gadag (07),Total,Youth (15-24),214382,113155,101227,36979,12962,6917,20027,7357,12670,36040
29,561,District - Gadag (07),Rural,All Ages,685261,347585,337676,127515,50637,25558,255588,96884,158704,134744
29,561,District - Gadag (07),Rural,10-14,66840,34435,32405,14420,5040,2617,2580,1152,1428,1971
29,561,District - Gadag (07),Rural,15-19,70255,37956,32299,14089,5309,2893,4890,2018,2872,12859
29,561,District - Gadag (07),Rural,20-24,67533,36138,31395,12540,5133,2750,9367,3110,6257,18500
29,561,District - Gadag (07),Rural,Adolescent (10-19),137095,72391,64704,28509,10349,5510,7470,3170,4300,14830
29,561,District - Gadag (07),Rural,Youth (15-24),137788,74094,63694,26629,10442,5643,14257,5128,9129,31359
29,561,District - Gadag (07),Urban,All Ages,379309,189562,189747,46681,11017,5417,108805,43085,65720,22649
29,561,District - Gadag (07),Urban,10-14,36989,18769,18220,5447,1133,581,1327,608,719,266
29,561,District - Gadag (07),Urban,15-19,38504,19878,18626,5330,1261,647,2068,894,1174,1892
29,561,District - Gadag (07),Urban,20-24,38090,19183,18907,5020,1259,627,3702,1335,2367,2789
29,561,District - Gadag (07),Urban,Adolescent (10-19),75493,38647,36846,10777,2394,1228,3395,1502,1893,2158
29,561,District - Gadag (07),Urban,Youth (15-24),76594,39061,37533,10350,2520,1274,5770,2229,3541,4681
29,562,District - Dharwad (08),Total,All Ages,1847023,937206,909817,177855,87548,44173,545359,225430,319929,169525
29,562,District - Dharwad (08),Total,10-14,174269,89676,84593,18344,8795,4584,4741,2329,2412,1476
29,562,District - Dharwad (08),Total,15-19,177607,93105,84502,17926,8771,4609,7674,3794,3880,12646
29,562,District - Dharwad (08),Total,20-24,183861,95334,88527,18761,9159,4687,16062,6484,9578,20206
29,562,District - Dharwad (08),Total,Adolescent (10-19),351876,182781,169095,36270,17566,9193,12415,6123,6292,14122
29,562,District - Dharwad (08),Total,Youth (15-24),361468,188439,173029,36687,17930,9296,23736,10278,13458,32852
29,562,District - Dharwad (08),Rural,All Ages,797484,409416,388068,71387,50089,25586,295530,120245,175285,145204
29,562,District - Dharwad (08),Rural,10-14,76181,39302,36879,7574,5003,2641,1916,919,997,1214
29,562,District - Dharwad (08),Rural,15-19,76864,41506,35358,7009,4905,2645,3390,1632,1758,11087
29,562,District - Dharwad (08),Rural,20-24,77363,41790,35573,6926,5077,2690,8220,3223,4997,17736
29,562,District - Dharwad (08),Rural,Adolescent (10-19),153045,80808,72237,14583,9908,5286,5306,2551,2755,12301
29,562,District - Dharwad (08),Rural,Youth (15-24),154227,83296,70931,13935,9982,5335,11610,4855,6755,28823
29,562,District - Dharwad (08),Urban,All Ages,1049539,527790,521749,106468,37459,18587,249829,105185,144644,24321
29,562,District - Dharwad (08),Urban,10-14,98088,50374,47714,10770,3792,1943,2825,1410,1415,262
29,562,District - Dharwad (08),Urban,15-19,100743,51599,49144,10917,3866,1964,4284,2162,2122,1559
29,562,District - Dharwad (08),Urban,20-24,106498,53544,52954,11835,4082,1997,7842,3261,4581,2470
29,562,District - Dharwad (08),Urban,Adolescent (10-19),198831,101973,96858,21687,7658,3907,7109,3572,3537,1821
29,562,District - Dharwad (08),Urban,Youth (15-24),207241,105143,102098,22752,7948,3961,12126,5423,6703,4029
29,563,District - Uttara Kannada (09),Total,All Ages,1437169,726256,710913,116431,34239,17095,355263,144157,211106,82131
29,563,District - Uttara Kannada (09),Total,10-14,129579,67126,62453,11509,3547,1858,2202,1029,1173,503
29,563,District - Uttara Kannada (09),Total,15-19,129525,66658,62867,11091,3470,1841,2513,1138,1375,5442
29,563,District - Uttara Kannada (09),Total,20-24,134794,68242,66552,12079,3584,1727,5343,1904,3439,9526
29,563,District - Uttara Kannada (09),Total,Adolescent (10-19),259104,133784,125320,22600,7017,3699,4715,2167,2548,5945
29,563,District - Uttara Kannada (09),Total,Youth (15-24),264319,134900,129419,23170,7054,3568,7856,3042,4814,14968
29,563,District - Uttara Kannada (09),Rural,All Ages,1018188,514910,503278,78859,27949,13976,277059,111491,165568,77746
29,563,District - Uttara Kannada (09),Rural,10-14,92187,47773,44414,7843,2724,1436,1678,800,878,493
29,563,District - Uttara Kannada (09),Rural,15-19,92256,47406,44850,7542,2829,1498,1935,845,1090,5230
29,563,District - Uttara Kannada (09),Rural,20-24,95388,48239,47149,8243,2921,1422,4221,1499,2722,9132
29,563,District - Uttara Kannada (09),Rural,Adolescent (10-19),184443,95179,89264,15385,5553,2934,3613,1645,1968,5723
29,563,District - Uttara Kannada (09),Rural,Youth (15-24),187644,95645,91999,15785,5750,2920,6156,2344,3812,14362
29,563,District - Uttara Kannada (09),Urban,All Ages,418981,211346,207635,37572,6290,3119,78204,32666,45538,4385
29,563,District - Uttara Kannada (09),Urban,10-14,37392,19353,18039,3666,823,422,524,229,295,10
29,563,District - Uttara Kannada (09),Urban,15-19,37269,19252,18017,3549,641,343,578,293,285,212
29,563,District - Uttara Kannada (09),Urban,20-24,39406,20003,19403,3836,663,305,1122,405,717,394
29,563,District - Uttara Kannada (09),Urban,Adolescent (10-19),74661,38605,36056,7215,1464,765,1102,522,580,222
29,563,District - Uttara Kannada (09),Urban,Youth (15-24),76675,39255,37420,7385,1304,648,1700,698,1002,606
29,564,District - Haveri (10),Total,All Ages,1597668,819128,778540,219976,141380,72109,512225,215335,296890,230419
29,564,District - Haveri (10),Total,10-14,158009,81153,76856,24128,13946,7195,4290,2006,2284,2581
29,564,District - Haveri (10),Total,15-19,164613,86225,78388,23584,14513,7639,7860,3718,4142,21463
29,564,District - Haveri (10),Total,20-24,160382,86144,74238,22094,14621,7915,15218,6385,8833,30506
29,564,District - Haveri (10),Total,Adolescent (10-19),322622,167378,155244,47712,28459,14834,12150,5724,6426,24044
29,564,District - Haveri (10),Total,Youth (15-24),324995,172369,152626,45678,29134,15554,23078,10103,12975,51969
29,564,District - Haveri (10),Rural,All Ages,1242167,638450,603717,188161,126249,64580,417066,172847,244219,216084
29,564,District - Haveri (10),Rural,10-14,120862,62043,58819,20319,12166,6328,3217,1464,1753,2426
29,564,District - Haveri (10),Rural,15-19,126405,66841,59564,19980,12867,6813,6003,2773,3230,20268
29,564,District - Haveri (10),Rural,20-24,123545,67361,56184,18723,12897,7038,11934,4870,7064,28736
29,564,District - Haveri (10),Rural,Adolescent (10-19),247267,128884,118383,40299,25033,13141,9220,4237,4983,22694
29,564,District - Haveri (10),Rural,Youth (15-24),249950,134202,115748,38703,25764,13851,17937,7643,10294,49004
29,564,District - Haveri (10),Urban,All Ages,355501,180678,174823,31815,15131,7529,95159,42488,52671,14335
29,564,District - Haveri (10),Urban,10-14,37147,19110,18037,3809,1780,867,1073,542,531,155
29,564,District - Haveri (10),Urban,15-19,38208,19384,18824,3604,1646,826,1857,945,912,1195
29,564,District - Haveri (10),Urban,20-24,36837,18783,18054,3371,1724,877,3284,1515,1769,1770
29,564,District - Haveri (10),Urban,Adolescent (10-19),75355,38494,36861,7413,3426,1693,2930,1487,1443,1350
29,564,District - Haveri (10),Urban,Youth (15-24),75045,38167,36878,6975,3370,1703,5141,2460,2681,2965
29,565,District - Bellary (11),Total,All Ages,2452595,1236954,1215641,517409,451406,225451,1030974,423514,607460,323923
29,565,District - Bellary (11),Total,10-14,256603,131430,125173,59696,51951,26631,19392,7621,11771,9862
29,565,District - Bellary (11),Total,15-19,260887,136411,124476,57408,52337,27219,36884,13948,22936,40862
29,565,District - Bellary (11),Total,20-24,249942,127863,122079,51683,45200,22978,56203,19166,37037,46929
29,565,District - Bellary (11),Total,Adolescent (10-19),517490,267841,249649,117104,104288,53850,56276,21569,34707,50724
29,565,District - Bellary (11),Total,Youth (15-24),510829,264274,246555,109091,97537,50197,93087,33114,59973,87791
29,565,District - Bellary (11),Rural,All Ages,1532356,774093,758263,366016,334131,167653,723044,295993,427051,290764
29,565,District - Bellary (11),Rural,10-14,167120,85793,81327,43183,39258,20203,13997,5269,8728,8940
29,565,District - Bellary (11),Rural,15-19,170515,90261,80254,41206,39741,20821,27939,10290,17649,37427
29,565,District - Bellary (11),Rural,20-24,153598,80114,73484,35669,32667,16891,41397,13773,27624,42843
29,565,District - Bellary (11),Rural,Adolescent (10-19),337635,176054,161581,84389,78999,41024,41936,15559,26377,46367
29,565,District - Bellary (11),Rural,Youth (15-24),324113,170375,153738,76875,72408,37712,69336,24063,45273,80270
29,565,District - Bellary (11),Urban,All Ages,920239,462861,457378,151393,117275,57798,307930,127521,180409,33159
29,565,District - Bellary (11),Urban,10-14,89483,45637,43846,16513,12693,6428,5395,2352,3043,922
29,565,District - Bellary (11),Urban,15-19,90372,46150,44222,16202,12596,6398,8945,3658,5287,3435
29,565,District - Bellary (11),Urban,20-24,96344,47749,48595,16014,12533,6087,14806,5393,9413,4086
29,565,District - Bellary (11),Urban,Adolescent (10-19),179855,91787,88068,32715,25289,12826,14340,6010,8330,4357
29,565,District - Bellary (11),Urban,Youth (15-24),186716,93899,92817,32216,25129,12485,23751,9051,14700,7521
29,566,District - Chitradurga (12),Total,All Ages,1659456,840843,818613,389117,302554,152939,572064,233655,338409,192769
29,566,District - Chitradurga (12),Total,10-14,157645,81374,76271,40850,30728,15807,5257,2338,2919,2235
29,566,District - Chitradurga (12),Total,15-19,165160,85820,79340,41589,32689,16918,8316,3415,4901,16861
29,566,District - Chitradurga (12),Total,20-24,156981,79747,77234,38173,29977,15309,15254,4909,10345,24431
29,566,District - Chitradurga (12),Total,Adolescent (10-19),322805,167194,155611,82439,63417,32725,13573,5753,7820,19096
29,566,District - Chitradurga (12),Total,Youth (15-24),322141,165567,156574,79762,62666,32227,23570,8324,15246,41292
29,566,District - Chitradurga (12),Rural,All Ages,1329923,675573,654350,333571,266526,135209,495504,201288,294216,189496
29,566,District - Chitradurga (12),Rural,10-14,125615,65007,60608,34630,27156,14018,4338,1890,2448,2204
29,566,District - Chitradurga (12),Rural,15-19,131862,68985,62877,35195,28785,15018,7199,2927,4272,16676
29,566,District - Chitradurga (12),Rural,20-24,123936,63880,60056,32074,26088,13467,13333,4193,9140,24109
29,566,District - Chitradurga (12),Rural,Adolescent (10-19),257477,133992,123485,69825,55941,29036,11537,4817,6720,18880
29,566,District - Chitradurga (12),Rural,Youth (15-24),255798,132865,122933,67269,54873,28485,20532,7120,13412,40785
29,566,District - Chitradurga (12),Urban,All Ages,329533,165270,164263,55546,36028,17730,76560,32367,44193,3273
29,566,District - Chitradurga (12),Urban,10-14,32030,16367,15663,6220,3572,1789,919,448,471,31
29,566,District - Chitradurga (12),Urban,15-19,33298,16835,16463,6394,3904,1900,1117,488,629,185
29,566,District - Chitradurga (12),Urban,20-24,33045,15867,17178,6099,3889,1842,1921,716,1205,322
29,566,District - Chitradurga (12),Urban,Adolescent (10-19),65328,33202,32126,12614,7476,3689,2036,936,1100,216
29,566,District - Chitradurga (12),Urban,Youth (15-24),66343,32702,33641,12493,7793,3742,3038,1204,1834,507
29,567,District - Davanagere (13),Total,All Ages,1945497,986400,959097,392595,233112,117808,636957,265763,371194,216553
29,567,District - Davanagere (13),Total,10-14,183791,94482,89309,40770,23098,11744,6227,2860,3367,2595
29,567,District - Davanagere (13),Total,15-19,196956,101300,95656,42889,25753,13355,10581,4591,5990,19965
29,567,District - Davanagere (13),Total,20-24,194098,99903,94195,39677,24145,12615,19945,7623,12322,28172
29,567,District - Davanagere (13),Total,Adolescent (10-19),380747,195782,184965,83659,48851,25099,16808,7451,9357,22560
29,567,District - Davanagere (13),Total,Youth (15-24),391054,201203,189851,82566,49898,25970,30526,12214,18312,48137
29,567,District - Davanagere (13),Rural,All Ages,1316487,668267,648220,315926,191754,96936,477664,196579,281085,207797
29,567,District - Davanagere (13),Rural,10-14,123883,63753,60130,32782,18738,9508,4137,1872,2265,2466
29,567,District - Davanagere (13),Rural,15-19,132283,67941,64342,33969,21002,10773,7600,3174,4426,19270
29,567,District - Davanagere (13),Rural,20-24,127998,66681,61317,31265,19676,10364,14773,5421,9352,27204
29,567,District - Davanagere (13),Rural,Adolescent (10-19),256166,131694,124472,66751,39740,20281,11737,5046,6691,21736
29,567,District - Davanagere (13),Rural,Youth (15-24),260281,134622,125659,65234,40678,21137,22373,8595,13778,46474
29,567,District - Davanagere (13),Urban,All Ages,629010,318133,310877,76669,41358,20872,159293,69184,90109,8756
29,567,District - Davanagere (13),Urban,10-14,59908,30729,29179,7988,4360,2236,2090,988,1102,129
29,567,District - Davanagere (13),Urban,15-19,64673,33359,31314,8920,4751,2582,2981,1417,1564,695
29,567,District - Davanagere (13),Urban,20-24,66100,33222,32878,8412,4469,2251,5172,2202,2970,968
29,567,District - Davanagere (13),Urban,Adolescent (10-19),124581,64088,60493,16908,9111,4818,5071,2405,2666,824
29,567,District - Davanagere (13),Urban,Youth (15-24),130773,66581,64192,17332,9220,4833,8153,3619,4534,1663
29,568,District - Shimoga (14),Total,All Ages,1752753,877415,875338,308158,65412,32707,489737,202477,287260,179780
29,568,District - Shimoga (14),Total,10-14,162453,83174,79279,31805,6414,3249,3477,1706,1771,1198
29,568,District - Shimoga (14),Total,15-19,164421,83549,80872,31887,6630,3414,4302,2038,2264,12333
29,568,District - Shimoga (14),Total,20-24,164792,82133,82659,31236,6580,3288,8970,3638,5332,20814
29,568,District - Shimoga (14),Total,Adolescent (10-19),326874,166723,160151,63692,13044,6663,7779,3744,4035,13531
29,568,District - Shimoga (14),Total,Youth (15-24),329213,165682,163531,63123,13210,6702,13272,5676,7596,33147
29,568,District - Shimoga (14),Rural,All Ages,1129026,565821,563205,225316,49963,25045,358209,146231,211978,168803
29,568,District - Shimoga (14),Rural,10-14,105851,54408,51443,23337,4969,2529,2275,1110,1165,1143
29,568,District - Shimoga (14),Rural,15-19,103415,52780,50635,22868,4958,2568,2954,1344,1610,11825
29,568,District - Shimoga (14),Rural,20-24,103290,51887,51403,22439,4876,2469,6531,2526,4005,19862
29,568,District - Shimoga (14),Rural,Adolescent (10-19),209266,107188,102078,46205,9927,5097,5229,2454,2775,12968
29,568,District - Shimoga (14),Rural,Youth (15-24),206705,104667,102038,45307,9834,5037,9485,3870,5615,31687
29,568,District - Shimoga (14),Urban,All Ages,623727,311594,312133,82842,15449,7662,131528,56246,75282,10977
29,568,District - Shimoga (14),Urban,10-14,56602,28766,27836,8468,1445,720,1202,596,606,55
29,568,District - Shimoga (14),Urban,15-19,61006,30769,30237,9019,1672,846,1348,694,654,508
29,568,District - Shimoga (14),Urban,20-24,61502,30246,31256,8797,1704,819,2439,1112,1327,952
29,568,District - Shimoga (14),Urban,Adolescent (10-19),117608,59535,58073,17487,3117,1566,2550,1290,1260,563
29,568,District - Shimoga (14),Urban,Youth (15-24),122508,61015,61493,17816,3376,1665,3787,1806,1981,1460
29,569,District - Udupi (15),Total,All Ages,1177361,562131,615230,75429,52897,26228,250932,96427,154505,45390
29,569,District - Udupi (15),Total,10-14,91113,46336,44777,6557,4792,2461,1729,810,919,214
29,569,District - Udupi (15),Total,15-19,100319,50084,50235,7021,4781,2369,1477,679,798,1297
29,569,District - Udupi (15),Total,20-24,111819,52110,59709,8452,5478,2621,2394,921,1473,3446
29,569,District - Udupi (15),Total,Adolescent (10-19),191432,96420,95012,13578,9573,4830,3206,1489,1717,1511
29,569,District - Udupi (15),Total,Youth (15-24),212138,102194,109944,15473,10259,4990,3871,1600,2271,4743
29,569,District - Udupi (15),Rural,All Ages,843300,398847,444453,55996,41596,20630,198054,74538,123516,42431
29,569,District - Udupi (15),Rural,10-14,66661,33883,32778,5027,3836,1975,1263,600,663,211
29,569,District - Udupi (15),Rural,15-19,73891,36695,37196,5392,3824,1880,1026,474,552,1267
29,569,District - Udupi (15),Rural,20-24,81708,37291,44417,6330,4268,2020,1712,660,1052,3275
29,569,District - Udupi (15),Rural,Adolescent (10-19),140552,70578,69974,10419,7660,3855,2289,1074,1215,1478
29,569,District - Udupi (15),Rural,Youth (15-24),155599,73986,81613,11722,8092,3900,2738,1134,1604,4542
29,569,District - Udupi (15),Urban,All Ages,334061,163284,170777,19433,11301,5598,52878,21889,30989,2959
29,569,District - Udupi (15),Urban,10-14,24452,12453,11999,1530,956,486,466,210,256,3
29,569,District - Udupi (15),Urban,15-19,26428,13389,13039,1629,957,489,451,205,246,30
29,569,District - Udupi (15),Urban,20-24,30111,14819,15292,2122,1210,601,682,261,421,171
29,569,District - Udupi (15),Urban,Adolescent (10-19),50880,25842,25038,3159,1913,975,917,415,502,33
29,569,District - Udupi (15),Urban,Youth (15-24),56539,28208,28331,3751,2167,1090,1133,466,667,201
29,570,District - Chikmagalur (16),Total,All Ages,1137961,566622,571339,253651,44970,21990,319616,128365,191251,92037
29,570,District - Chikmagalur (16),Total,10-14,103500,52708,50792,26658,4820,2371,2477,1116,1361,667
29,570,District - Chikmagalur (16),Total,15-19,101692,51215,50477,25841,4484,2255,2941,1180,1761,5584
29,570,District - Chikmagalur (16),Total,20-24,103307,50396,52911,25680,4548,2262,6047,2060,3987,9985
29,570,District - Chikmagalur (16),Total,Adolescent (10-19),205192,103923,101269,52499,9304,4626,5418,2296,3122,6251
29,570,District - Chikmagalur (16),Total,Youth (15-24),204999,101611,103388,51521,9032,4517,8988,3240,5748,15569
29,570,District - Chikmagalur (16),Rural,All Ages,898453,447545,450908,218406,40142,19627,270370,107359,163011,87526
29,570,District - Chikmagalur (16),Rural,10-14,80740,41391,39349,22666,4272,2116,2010,904,1106,644
29,570,District - Chikmagalur (16),Rural,15-19,78056,39713,38343,21586,3968,2001,2454,963,1491,5387
29,570,District - Chikmagalur (16),Rural,20-24,79749,39192,40557,21752,4037,2014,5142,1687,3455,9542
29,570,District - Chikmagalur (16),Rural,Adolescent (10-19),158796,81104,77692,44252,8240,4117,4464,1867,2597,6031
29,570,District - Chikmagalur (16),Rural,Youth (15-24),157805,78905,78900,43338,8005,4015,7596,2650,4946,14929
29,570,District - Chikmagalur (16),Urban,All Ages,239508,119077,120431,35245,4828,2363,49246,21006,28240,4511
29,570,District - Chikmagalur (16),Urban,10-14,22760,11317,11443,3992,548,255,467,212,255,23
29,570,District - Chikmagalur (16),Urban,15-19,23636,11502,12134,4255,516,254,487,217,270,197
29,570,District - Chikmagalur (16),Urban,20-24,23558,11204,12354,3928,511,248,905,373,532,443
29,570,District - Chikmagalur (16),Urban,Adolescent (10-19),46396,22819,23577,8247,1064,509,954,429,525,220
29,570,District - Chikmagalur (16),Urban,Youth (15-24),47194,22706,24488,8183,1027,502,1392,590,802,640
29,571,District - Tumkur (17),Total,All Ages,2678980,1350594,1328386,506901,209559,105265,865589,344570,521019,220018
29,571,District - Tumkur (17),Total,10-14,238259,124775,113484,49254,19019,9776,5016,2298,2718,1387
29,571,District - Tumkur (17),Total,15-19,247643,129870,117773,50752,19795,10443,6823,2903,3920,14387
29,571,District - Tumkur (17),Total,20-24,246216,126235,119981,48379,20133,10184,14334,5067,9267,25546
29,571,District - Tumkur (17),Total,Adolescent (10-19),485902,254645,231257,100006,38814,20219,11839,5201,6638,15774
29,571,District - Tumkur (17),Total,Youth (15-24),493859,256105,237754,99131,39928,20627,21157,7970,13187,39933
29,571,District - Tumkur (17),Rural,All Ages,2079902,1048710,1031192,429957,180024,90558,735464,288388,447076,214945
29,571,District - Tumkur (17),Rural,10-14,183324,96472,86852,41323,16310,8460,3998,1768,2230,1363
29,571,District - Tumkur (17),Rural,15-19,188376,99525,88851,42342,16860,8915,5378,2152,3226,14185
29,571,District - Tumkur (17),Rural,20-24,185233,95974,89259,40071,17000,8659,11547,3862,7685,25087
29,571,District - Tumkur (17),Rural,Adolescent (10-19),371700,195997,175703,83665,33170,17375,9376,3920,5456,15548
29,571,District - Tumkur (17),Rural,Youth (15-24),373609,195499,178110,82413,33860,17574,16925,6014,10911,39272
29,571,District - Tumkur (17),Urban,All Ages,599078,301884,297194,76944,29535,14707,130125,56182,73943,5073
29,571,District - Tumkur (17),Urban,10-14,54935,28303,26632,7931,2709,1316,1018,530,488,24
29,571,District - Tumkur (17),Urban,15-19,59267,30345,28922,8410,2935,1528,1445,751,694,202
29,571,District - Tumkur (17),Urban,20-24,60983,30261,30722,8308,3133,1525,2787,1205,1582,459
29,571,District - Tumkur (17),Urban,Adolescent (10-19),114202,58648,55554,16341,5644,2844,2463,1281,1182,226
29,571,District - Tumkur (17),Urban,Youth (15-24),120250,60606,59644,16718,6068,3053,4232,1956,2276,661
29,572,District - Bangalore (18),Total,All Ages,9621551,5022661,4598890,1198385,190239,99164,2109275,944620,1164655,77294
29,572,District - Bangalore (18),Total,10-14,728636,375422,353214,111014,15948,8195,28407,13602,14805,577
29,572,District - Bangalore (18),Total,15-19,774999,399402,375597,118052,17642,9029,33071,15606,17465,3461
29,572,District - Bangalore (18),Total,20-24,1094930,567855,527075,140285,24599,12524,64403,27091,37312,8721
29,572,District - Bangalore (18),Total,Adolescent (10-19),1503635,774824,728811,229066,33590,17224,61478,29208,32270,4038
29,572,District - Bangalore (18),Total,Youth (15-24),1869929,967257,902672,258337,42241,21553,97474,42697,54777,12182
29,572,District - Bangalore (18),Rural,All Ages,871607,464256,407351,199870,28415,14940,268748,115430,153318,35954
29,572,District - Bangalore (18),Rural,10-14,70856,36764,34092,18829,2574,1282,2620,1150,1470,229
29,572,District - Bangalore (18),Rural,15-19,78108,41241,36867,20094,2781,1402,3656,1608,2048,1735
29,572,District - Bangalore (18),Rural,20-24,112879,62330,50549,23255,3896,2016,8086,3269,4817,3603
29,572,District - Bangalore (18),Rural,Adolescent (10-19),148964,78005,70959,38923,5355,2684,6276,2758,3518,1964
29,572,District - Bangalore (18),Rural,Youth (15-24),190987,103571,87416,43349,6677,3418,11742,4877,6865,5338
29,572,District - Bangalore (18),Urban,All Ages,8749944,4558405,4191539,998515,161824,84224,1840527,829190,1011337,41340
29,572,District - Bangalore (18),Urban,10-14,657780,338658,319122,92185,13374,6913,25787,12452,13335,348
29,572,District - Bangalore (18),Urban,15-19,696891,358161,338730,97958,14861,7627,29415,13998,15417,1726
29,572,District - Bangalore (18),Urban,20-24,982051,505525,476526,117030,20703,10508,56317,23822,32495,5118
29,572,District - Bangalore (18),Urban,Adolescent (10-19),1354671,696819,657852,190143,28235,14540,55202,26450,28752,2074
29,572,District - Bangalore (18),Urban,Youth (15-24),1678942,863686,815256,214988,35564,18135,85732,37820,47912,6844
29,573,District - Mandya (19),Total,All Ages,1805769,905085,900684,265294,22402,11310,656120,266417,389703,147093
29,573,District - Mandya (19),Total,10-14,153314,79865,73449,23987,2067,1103,3451,1568,1883,874
29,573,District - Mandya (19),Total,15-19,162126,84088,78038,25704,2126,1086,4914,2200,2714,8019
29,573,District - Mandya (19),Total,20-24,170210,87021,83189,27576,2262,1127,10951,4285,6666,15375
29,573,District - Mandya (19),Total,Adolescent (10-19),315440,163953,151487,49691,4193,2189,8365,3768,4597,8893
29,573,District - Mandya (19),Total,Youth (15-24),332336,171109,161227,53280,4388,2213,15865,6485,9380,23394
29,573,District - Mandya (19),Rural,All Ages,1497407,751243,746164,221943,17361,8814,578118,233339,344779,141647
29,573,District - Mandya (19),Rural,10-14,125739,65972,59767,19832,1636,885,2896,1291,1605,853
29,573,District - Mandya (19),Rural,15-19,133771,69978,63793,21397,1660,877,4055,1771,2284,7821
29,573,District - Mandya (19),Rural,20-24,139712,72380,67332,22938,1697,878,9223,3533,5690,14965
29,573,District - Mandya (19),Rural,Adolescent (10-19),259510,135950,123560,41229,3296,1762,6951,3062,3889,8674
29,573,District - Mandya (19),Rural,Youth (15-24),273483,142358,131125,44335,3357,1755,13278,5304,7974,22786
29,573,District - Mandya (19),Urban,All Ages,308362,153842,154520,43351,5041,2496,78002,33078,44924,5446
29,573,District - Mandya (19),Urban,10-14,27575,13893,13682,4155,431,218,555,277,278,21
29,573,District - Mandya (19),Urban,15-19,28355,14110,14245,4307,466,209,859,429,430,198
29,573,District - Mandya (19),Urban,20-24,30498,14641,15857,4638,565,249,1728,752,976,410
29,573,District - Mandya (19),Urban,Adolescent (10-19),55930,28003,27927,8462,897,427,1414,706,708,219
29,573,District - Mandya (19),Urban,Youth (15-24),58853,28751,30102,8945,1031,458,2587,1181,1406,608
29,574,District - Hassan (20),Total,All Ages,1776421,883667,892754,345031,32329,15986,551165,214831,336334,107427
29,574,District - Hassan (20),Total,10-14,152557,77307,75250,33739,3026,1521,3252,1501,1751,601
29,574,District - Hassan (20),Total,15-19,154538,77843,76695,33857,2903,1470,4079,1695,2384,6427
29,574,District - Hassan (20),Total,20-24,165984,83519,82465,36055,3091,1500,9396,3228,6168,12289
29,574,District - Hassan (20),Total,Adolescent (10-19),307095,155150,151945,67596,5929,2991,7331,3196,4135,7028
29,574,District - Hassan (20),Total,Youth (15-24),320522,161362,159160,69912,5994,2970,13475,4923,8552,18716
29,574,District - Hassan (20),Rural,All Ages,1399658,695583,704075,298013,27896,13779,474087,182003,292084,104379
29,574,District - Hassan (20),Rural,10-14,117870,59751,58119,28701,2576,1288,2581,1180,1401,593
29,574,District - Hassan (20),Rural,15-19,120003,60761,59242,28813,2476,1250,3394,1354,2040,6314
29,574,District - Hassan (20),Rural,20-24,129022,65936,63086,30879,2636,1291,8112,2641,5471,11992
29,574,District - Hassan (20),Rural,Adolescent (10-19),237873,120512,117361,57514,5052,2538,5975,2534,3441,6907
29,574,District - Hassan (20),Rural,Youth (15-24),249025,126697,122328,59692,5112,2541,11506,3995,7511,18306
29,574,District - Hassan (20),Urban,All Ages,376763,188084,188679,47018,4433,2207,77078,32828,44250,3048
29,574,District - Hassan (20),Urban,10-14,34687,17556,17131,5038,450,233,671,321,350,8
29,574,District - Hassan (20),Urban,15-19,34535,17082,17453,5044,427,220,685,341,344,113
29,574,District - Hassan (20),Urban,20-24,36962,17583,19379,5176,455,209,1284,587,697,297
29,574,District - Hassan (20),Urban,Adolescent (10-19),69222,34638,34584,10082,877,453,1356,662,694,121
29,574,District - Hassan (20),Urban,Youth (15-24),71497,34665,36832,10220,882,429,1969,928,1041,410
29,575,District - Dakshina Kannada (21),Total,All Ages,2089649,1034714,1054935,148178,82268,40961,423326,170695,252631,24717
29,575,District - Dakshina Kannada (21),Total,10-14,175536,90131,85405,13496,6702,3362,2129,956,1173,70
29,575,District - Dakshina Kannada (21),Total,15-19,191035,96754,94281,13708,7365,3824,2273,986,1287,899
29,575,District - Dakshina Kannada (21),Total,20-24,210759,102561,108198,16484,8436,4116,3647,1489,2158,2085
29,575,District - Dakshina Kannada (21),Total,Adolescent (10-19),366571,186885,179686,27204,14067,7186,4402,1942,2460,969
29,575,District - Dakshina Kannada (21),Total,Youth (15-24),401794,199315,202479,30192,15801,7940,5920,2475,3445,2984
29,575,District - Dakshina Kannada (21),Rural,All Ages,1093563,541484,552079,102737,65844,32782,255247,100680,154567,21007
29,575,District - Dakshina Kannada (21),Rural,10-14,94407,48591,45816,9190,5179,2602,1109,495,614,64
29,575,District - Dakshina Kannada (21),Rural,15-19,97957,49827,48130,9319,5658,2945,1014,466,548,803
29,575,District - Dakshina Kannada (21),Rural,20-24,106449,51489,54960,11516,6653,3253,1644,650,994,1848
29,575,District - Dakshina Kannada (21),Rural,Adolescent (10-19),192364,98418,93946,18509,10837,5547,2123,961,1162,867
29,575,District - Dakshina Kannada (21),Rural,Youth (15-24),204406,101316,103090,20835,12311,6198,2658,1116,1542,2651
29,575,District - Dakshina Kannada (21),Urban,All Ages,996086,493230,502856,45441,16424,8179,168079,70015,98064,3710
29,575,District - Dakshina Kannada (21),Urban,10-14,81129,41540,39589,4306,1523,760,1020,461,559,6
29,575,District - Dakshina Kannada (21),Urban,15-19,93078,46927,46151,4389,1707,879,1259,520,739,96
29,575,District - Dakshina Kannada (21),Urban,20-24,104310,51072,53238,4968,1783,863,2003,839,1164,237
29,575,District - Dakshina Kannada (21),Urban,Adolescent (10-19),174207,88467,85740,8695,3230,1639,2279,981,1298,102
29,575,District - Dakshina Kannada (21),Urban,Youth (15-24),197388,97999,99389,9357,3490,1742,3262,1359,1903,333
29,576,District - Kodagu (22),Total,All Ages,554519,274608,279911,73584,58054,28510,141642,59306,82336,12546
29,576,District - Kodagu (22),Total,10-14,52578,26637,25941,7530,5892,2942,1527,696,831,121
29,576,District - Kodagu (22),Total,15-19,47341,23885,23456,6880,4877,2454,1678,747,931,674
29,576,District - Kodagu (22),Total,20-24,47975,23376,24599,7380,5343,2319,3550,1283,2267,1249
29,576,District - Kodagu (22),Total,Adolescent (10-19),99919,50522,49397,14410,10769,5396,3205,1443,1762,795
29,576,District - Kodagu (22),Total,Youth (15-24),95316,47261,48055,14260,10220,4773,5228,2030,3198,1923
29,576,District - Kodagu (22),Rural,All Ages,473531,234161,239370,64618,56298,27643,127470,53241,74229,12248
29,576,District - Kodagu (22),Rural,10-14,45012,22849,22163,6586,5709,2854,1389,630,759,121
29,576,District - Kodagu (22),Rural,15-19,39898,20164,19734,5875,4661,2354,1556,703,853,668
29,576,District - Kodagu (22),Rural,20-24,40616,19747,20869,6362,5158,2235,3313,1191,2122,1232
29,576,District - Kodagu (22),Rural,Adolescent (10-19),84910,43013,41897,12461,10370,5208,2945,1333,1612,789
29,576,District - Kodagu (22),Rural,Youth (15-24),80514,39911,40603,12237,9819,4589,4869,1894,2975,1900
29,576,District - Kodagu (22),Urban,All Ages,80988,40447,40541,8966,1756,867,14172,6065,8107,298
29,576,District - Kodagu (22),Urban,10-14,7566,3788,3778,944,183,88,138,66,72,0
29,576,District - Kodagu (22),Urban,15-19,7443,3721,3722,1005,216,100,122,44,78,6
29,576,District - Kodagu (22),Urban,20-24,7359,3629,3730,1018,185,84,237,92,145,17
29,576,District - Kodagu (22),Urban,Adolescent (10-19),15009,7509,7500,1949,399,188,260,110,150,6
29,576,District - Kodagu (22),Urban,Youth (15-24),14802,7350,7452,2023,401,184,359,136,223,23
29,577,District - Mysore (23),Total,All Ages,3001127,1511600,1489527,536643,334547,166697,1038947,447834,591113,208164
29,577,District - Mysore (23),Total,10-14,264355,134533,129822,50465,31793,16049,7572,3602,3970,1345
29,577,District - Mysore (23),Total,15-19,279357,142682,136675,54916,32894,16822,11758,5276,6482,12065
29,577,District - Mysore (23),Total,20-24,305388,154096,151292,58593,34738,17367,29146,11258,17888,23259
29,577,District - Mysore (23),Total,Adolescent (10-19),543712,277215,266497,105381,64687,32871,19330,8878,10452,13410
29,577,District - Mysore (23),Total,Youth (15-24),584745,296778,287967,113509,67632,34189,40904,16534,24370,35324
29,577,District - Mysore (23),Rural,All Ages,1755714,887500,868214,380388,257081,128281,761044,326766,434278,198403
29,577,District - Mysore (23),Rural,10-14,158948,81046,77902,36233,24887,12572,4642,2167,2475,1310
29,577,District - Mysore (23),Rural,15-19,164208,85247,78961,38748,25304,13055,8145,3540,4605,11691
29,577,District - Mysore (23),Rural,20-24,173079,89297,83782,40995,26180,13259,22115,8294,13821,22429
29,577,District - Mysore (23),Rural,Adolescent (10-19),323156,166293,156863,74981,50191,25627,12787,5707,7080,13001
29,577,District - Mysore (23),Rural,Youth (15-24),337287,174544,162743,79743,51484,26314,30260,11834,18426,34120
29,577,District - Mysore (23),Urban,All Ages,1245413,624100,621313,156255,77466,38416,277903,121068,156835,9761
29,577,District - Mysore (23),Urban,10-14,105407,53487,51920,14232,6906,3477,2930,1435,1495,35
29,577,District - Mysore (23),Urban,15-19,115149,57435,57714,16168,7590,3767,3613,1736,1877,374
29,577,District - Mysore (23),Urban,20-24,132309,64799,67510,17598,8558,4108,7031,2964,4067,830
29,577,District - Mysore (23),Urban,Adolescent (10-19),220556,110922,109634,30400,14496,7244,6543,3171,3372,409
29,577,District - Mysore (23),Urban,Youth (15-24),247458,122234,125224,33766,16148,7875,10644,4700,5944,1204
29,578,District - Chamarajanagar (24),Total,All Ages,1020791,512231,508560,259445,120219,59369,455512,199274,256238,154300
29,578,District - Chamarajanagar (24),Total,10-14,87397,44804,42593,23103,10806,5410,2892,1399,1493,1076
29,578,District - Chamarajanagar (24),Total,15-19,93805,48634,45171,25843,11618,5965,6282,2921,3361,9011
29,578,District - Chamarajanagar (24),Total,20-24,97330,49319,48011,27268,12045,6063,14747,6052,8695,15795
29,578,District - Chamarajanagar (24),Total,Adolescent (10-19),181202,93438,87764,48946,22424,11375,9174,4320,4854,10087
29,578,District - Chamarajanagar (24),Total,Youth (15-24),191135,97953,93182,53111,23663,12028,21029,8973,12056,24806
29,578,District - Chamarajanagar (24),Rural,All Ages,845817,424884,420933,221650,96434,47749,403557,176975,226582,148455
29,578,District - Chamarajanagar (24),Rural,10-14,71498,36670,34828,19559,8710,4303,2581,1243,1338,1052
29,578,District - Chamarajanagar (24),Rural,15-19,76524,39948,36576,21468,9370,4894,5733,2649,3084,8777
29,578,District - Chamarajanagar (24),Rural,20-24,80030,40967,39063,23130,9568,4847,13508,5545,7963,15318
29,578,District - Chamarajanagar (24),Rural,Adolescent (10-19),148022,76618,71404,41027,18080,9197,8314,3892,4422,9829
29,578,District - Chamarajanagar (24),Rural,Youth (15-24),156554,80915,75639,44598,18938,9741,19241,8194,11047,24095
29,578,District - Chamarajanagar (24),Urban,All Ages,174974,87347,87627,37795,23785,11620,51955,22299,29656,5845
29,578,District - Chamarajanagar (24),Urban,10-14,15899,8134,7765,3544,2096,1107,311,156,155,24
29,578,District - Chamarajanagar (24),Urban,15-19,17281,8686,8595,4375,2248,1071,549,272,277,234
29,578,District - Chamarajanagar (24),Urban,20-24,17300,8352,8948,4138,2477,1216,1239,507,732,477
29,578,District - Chamarajanagar (24),Urban,Adolescent (10-19),33180,16820,16360,7919,4344,2178,860,428,432,258
29,578,District - Chamarajanagar (24),Urban,Youth (15-24),34581,17038,17543,8513,4725,2287,1788,779,1009,711
29,579,District - Gulbarga (25),Total,All Ages,2566326,1301755,1264571,648782,65259,32830,1138958,473396,665562,284917
29,579,District - Gulbarga (25),Total,10-14,292225,150737,141488,77769,7808,3950,28539,12276,16263,6150
29,579,District - Gulbarga (25),Total,15-19,285139,149634,135505,72784,7292,3831,45393,19647,25746,28697
29,579,District - Gulbarga (25),Total,20-24,249997,131067,118930,61710,6255,3248,59984,22662,37322,37662
29,579,District - Gulbarga (25),Total,Adolescent (10-19),577364,300371,276993,150553,15100,7781,73932,31923,42009,34847
29,579,District - Gulbarga (25),Total,Youth (15-24),535136,280701,254435,134494,13547,7079,105377,42309,63068,66359
29,579,District - Gulbarga (25),Rural,All Ages,1730775,877144,853631,489697,50074,25232,873447,361794,511653,271689
29,579,District - Gulbarga (25),Rural,10-14,201664,103747,97917,59544,6136,3078,22271,9302,12969,5960
29,579,District - Gulbarga (25),Rural,15-19,192254,102475,89779,54045,5546,2952,36560,15562,20998,27698
29,579,District - Gulbarga (25),Rural,20-24,160712,86109,74603,44258,4599,2431,48115,17955,30160,36085
29,579,District - Gulbarga (25),Rural,Adolescent (10-19),393918,206222,187696,113589,11682,6030,58831,24864,33967,33658
29,579,District - Gulbarga (25),Rural,Youth (15-24),352966,188584,164382,98303,10145,5383,84675,33517,51158,63783
29,579,District - Gulbarga (25),Urban,All Ages,835551,424611,410940,159085,15185,7598,265511,111602,153909,13228
29,579,District - Gulbarga (25),Urban,10-14,90561,46990,43571,18225,1672,872,6268,2974,3294,190
29,579,District - Gulbarga (25),Urban,15-19,92885,47159,45726,18739,1746,879,8833,4085,4748,999
29,579,District - Gulbarga (25),Urban,20-24,89285,44958,44327,17452,1656,817,11869,4707,7162,1577
29,579,District - Gulbarga (25),Urban,Adolescent (10-19),183446,94149,89297,36964,3418,1751,15101,7059,8042,1189
29,579,District - Gulbarga (25),Urban,Youth (15-24),182170,92117,90053,36191,3402,1696,20702,8792,11910,2576
29,580,District - Yadgir (26),Total,All Ages,1174271,590329,583942,273315,146849,73564,664268,283578,380690,162706
29,580,District - Yadgir (26),Total,10-14,140904,72745,68159,34869,18213,9307,29679,11984,17695,8449
29,580,District - Yadgir (26),Total,15-19,125868,67723,58145,28945,16362,8907,38799,16793,22006,22625
29,580,District - Yadgir (26),Total,20-24,104956,54143,50813,22920,13032,6662,43740,16931,26809,22990
29,580,District - Yadgir (26),Total,Adolescent (10-19),266772,140468,126304,63814,34575,18214,68478,28777,39701,31074
29,580,District - Yadgir (26),Total,Youth (15-24),230824,121866,108958,51865,29394,15569,82539,33724,48815,45615
29,580,District - Yadgir (26),Rural,All Ages,953594,479078,474516,241721,128724,64574,579350,248080,331270,155723
29,580,District - Yadgir (26),Rural,10-14,115373,59548,55825,30924,15996,8180,26977,10771,16206,8175
29,580,District - Yadgir (26),Rural,15-19,101572,55203,46369,25154,14224,7788,35205,15179,20026,21788
29,580,District - Yadgir (26),Rural,20-24,83429,43218,40211,19862,11342,5829,39488,15272,24216,22102
29,580,District - Yadgir (26),Rural,Adolescent (10-19),216945,114751,102194,56078,30220,15968,62182,25950,36232,29963
29,580,District - Yadgir (26),Rural,Youth (15-24),185001,98421,86580,45016,25566,13617,74693,30451,44242,43890
29,580,District - Yadgir (26),Urban,All Ages,220677,111251,109426,31594,18125,8990,84918,35498,49420,6983
29,580,District - Yadgir (26),Urban,10-14,25531,13197,12334,3945,2217,1127,2702,1213,1489,274
29,580,District - Yadgir (26),Urban,15-19,24296,12520,11776,3791,2138,1119,3594,1614,1980,837
29,580,District - Yadgir (26),Urban,20-24,21527,10925,10602,3058,1690,833,4252,1659,2593,888
29,580,District - Yadgir (26),Urban,Adolescent (10-19),49827,25717,24110,7736,4355,2246,6296,2827,3469,1111
29,580,District - Yadgir (26),Urban,Youth (15-24),45823,23445,22378,6849,3828,1952,7846,3273,4573,1725
29,581,District - Kolar (27),Total,All Ages,1536401,776396,760005,465867,78875,39997,520182,212286,307896,142049
29,581,District - Kolar (27),Total,10-14,150701,76973,73728,47228,8516,4347,3933,1810,2123,1340
29,581,District - Kolar (27),Total,15-19,155377,80260,75117,48680,8504,4515,6129,2545,3584,9593
29,581,District - Kolar (27),Total,20-24,147972,75342,72630,45741,7257,3830,11658,3931,7727,15110
29,581,District - Kolar (27),Total,Adolescent (10-19),306078,157233,148845,95908,17020,8862,10062,4355,5707,10933
29,581,District - Kolar (27),Total,Youth (15-24),303349,155602,147747,94421,15761,8345,17787,6476,11311,24703
29,581,District - Kolar (27),Rural,All Ages,1056328,535431,520897,327424,72143,36448,406907,163646,243261,136030
29,581,District - Kolar (27),Rural,10-14,103293,52714,50579,34077,7737,3918,2751,1226,1525,1295
29,581,District - Kolar (27),Rural,15-19,106166,55271,50895,34497,7636,3975,4481,1774,2707,9297
29,581,District - Kolar (27),Rural,20-24,98333,51360,46973,31061,6537,3461,8704,2724,5980,14496
29,581,District - Kolar (27),Rural,Adolescent (10-19),209459,107985,101474,68574,15373,7893,7232,3000,4232,10592
29,581,District - Kolar (27),Rural,Youth (15-24),204499,106631,97868,65558,14173,7436,13185,4498,8687,23793
29,581,District - Kolar (27),Urban,All Ages,480073,240965,239108,138443,6732,3549,113275,48640,64635,6019
29,581,District - Kolar (27),Urban,10-14,47408,24259,23149,13151,779,429,1182,584,598,45
29,581,District - Kolar (27),Urban,15-19,49211,24989,24222,14183,868,540,1648,771,877,296
29,581,District - Kolar (27),Urban,20-24,49639,23982,25657,14680,720,369,2954,1207,1747,614
29,581,District - Kolar (27),Urban,Adolescent (10-19),96619,49248,47371,27334,1647,969,2830,1355,1475,341
29,581,District - Kolar (27),Urban,Youth (15-24),98850,48971,49879,28863,1588,909,4602,1978,2624,910
29,582,District - Chikkaballapura (28),Total,All Ages,1255104,636437,618667,312565,156487,79156,471882,194279,277603,154094
29,582,District - Chikkaballapura (28),Total,10-14,122425,63523,58902,33494,15911,8229,3865,1802,2063,1339
29,582,District - Chikkaballapura (28),Total,15-19,125465,66335,59130,32772,16201,8850,5549,2376,3173,10067
29,582,District - Chikkaballapura (28),Total,20-24,115758,59599,56159,28750,14050,7221,11328,3819,7509,16303
29,582,District - Chikkaballapura (28),Total,Adolescent (10-19),247890,129858,118032,66266,32112,17079,9414,4178,5236,11406
29,582,District - Chikkaballapura (28),Total,Youth (15-24),241223,125934,115289,61522,30251,16071,16877,6195,10682,26370
29,582,District - Chikkaballapura (28),Rural,All Ages,973985,494463,479522,272891,139201,70304,393754,160123,233631,148511
29,582,District - Chikkaballapura (28),Rural,10-14,93728,48899,44829,28741,14215,7397,2924,1372,1552,1282
29,582,District - Chikkaballapura (28),Rural,15-19,95631,51312,44319,27778,14081,7679,4044,1691,2353,9752
29,582,District - Chikkaballapura (28),Rural,20-24,87541,46012,41529,24455,12312,6373,8786,2754,6032,15774
29,582,District - Chikkaballapura (28),Rural,Adolescent (10-19),189359,100211,89148,56519,28296,15076,6968,3063,3905,11034
29,582,District - Chikkaballapura (28),Rural,Youth (15-24),183172,97324,85848,52233,26393,14052,12830,4445,8385,25526
29,582,District - Chikkaballapura (28),Urban,All Ages,281119,141974,139145,39674,17286,8852,78128,34156,43972,5583
29,582,District - Chikkaballapura (28),Urban,10-14,28697,14624,14073,4753,1696,832,941,430,511,57
29,582,District - Chikkaballapura (28),Urban,15-19,29834,15023,14811,4994,2120,1171,1505,685,820,315
29,582,District - Chikkaballapura (28),Urban,20-24,28217,13587,14630,4295,1738,848,2542,1065,1477,529
29,582,District - Chikkaballapura (28),Urban,Adolescent (10-19),58531,29647,28884,9747,3816,2003,2446,1115,1331,372
29,582,District - Chikkaballapura (28),Urban,Youth (15-24),58051,28610,29441,9289,3858,2019,4047,1750,2297,844
29,583,District - Bangalore Rural (29),Total,All Ages,990923,509172,481751,213700,52903,27147,302174,123861,178313,59390
29,583,District - Bangalore Rural (29),Total,10-14,87247,45316,41931,21010,5097,2663,2279,1110,1169,328
29,583,District - Bangalore Rural (29),Total,15-19,92094,47615,44479,21916,5111,2658,2256,1053,1203,3228
29,583,District - Bangalore Rural (29),Total,20-24,104190,53706,50484,22752,5645,2933,5126,1854,3272,6297
29,583,District - Bangalore Rural (29),Total,Adolescent (10-19),179341,92931,86410,42926,10208,5321,4535,2163,2372,3556
29,583,District - Bangalore Rural (29),Total,Youth (15-24),196284,101321,94963,44668,10756,5591,7382,2907,4475,9525
29,583,District - Bangalore Rural (29),Rural,All Ages,722179,371369,350810,181501,44412,22809,237547,95912,141635,56264
29,583,District - Bangalore Rural (29),Rural,10-14,63081,32735,30346,17574,4343,2251,1668,803,865,319
29,583,District - Bangalore Rural (29),Rural,15-19,66548,34767,31781,18366,4252,2222,1546,696,850,3110
29,583,District - Bangalore Rural (29),Rural,20-24,74879,39349,35530,19051,4693,2494,3681,1255,2426,6024
29,583,District - Bangalore Rural (29),Rural,Adolescent (10-19),129629,67502,62127,35940,8595,4473,3214,1499,1715,3429
29,583,District - Bangalore Rural (29),Rural,Youth (15-24),141427,74116,67311,37417,8945,4716,5227,1951,3276,9134
29,583,District - Bangalore Rural (29),Urban,All Ages,268744,137803,130941,32199,8491,4338,64627,27949,36678,3126
29,583,District - Bangalore Rural (29),Urban,10-14,24166,12581,11585,3436,754,412,611,307,304,9
29,583,District - Bangalore Rural (29),Urban,15-19,25546,12848,12698,3550,859,436,710,357,353,118
29,583,District - Bangalore Rural (29),Urban,20-24,29311,14357,14954,3701,952,439,1445,599,846,273
29,583,District - Bangalore Rural (29),Urban,Adolescent (10-19),49712,25429,24283,6986,1613,848,1321,664,657,127
29,583,District - Bangalore Rural (29),Urban,Youth (15-24),54857,27205,27652,7251,1811,875,2155,956,1199,391
29,584,District - Ramanagara (30),Total,All Ages,1082636,548008,534628,203819,22946,11619,407878,169547,238331,76408
29,584,District - Ramanagara (30),Total,10-14,93711,48629,45082,18720,2293,1197,2048,1047,1001,417
29,584,District - Ramanagara (30),Total,15-19,100539,52347,48192,20233,2129,1159,3508,1619,1889,3905
29,584,District - Ramanagara (30),Total,20-24,107167,56028,51139,21735,2071,1012,7982,3142,4840,7689
29,584,District - Ramanagara (30),Total,Adolescent (10-19),194250,100976,93274,38953,4422,2356,5556,2666,2890,4322
29,584,District - Ramanagara (30),Total,Youth (15-24),207706,108375,99331,41968,4200,2171,11490,4761,6729,11594
29,584,District - Ramanagara (30),Rural,All Ages,814877,412438,402439,164788,19163,9693,333566,136568,196998,74258
29,584,District - Ramanagara (30),Rural,10-14,67221,34895,32326,14676,1829,943,1418,716,702,408
29,584,District - Ramanagara (30),Rural,15-19,73180,38478,34702,16065,1750,948,2310,987,1323,3825
29,584,District - Ramanagara (30),Rural,20-24,78554,42112,36442,17222,1708,851,5552,2042,3510,7510
29,584,District - Ramanagara (30),Rural,Adolescent (10-19),140401,73373,67028,30741,3579,1891,3728,1703,2025,4233
29,584,District - Ramanagara (30),Rural,Youth (15-24),151734,80590,71144,33287,3458,1799,7862,3029,4833,11335
29,584,District - Ramanagara (30),Urban,All Ages,267759,135570,132189,39031,3783,1926,74312,32979,41333,2150
29,584,District - Ramanagara (30),Urban,10-14,26490,13734,12756,4044,464,254,630,331,299,9
29,584,District - Ramanagara (30),Urban,15-19,27359,13869,13490,4168,379,211,1198,632,566,80
29,584,District - Ramanagara (30),Urban,20-24,28613,13916,14697,4513,363,161,2430,1100,1330,179
29,584,District - Ramanagara (30),Urban,Adolescent (10-19),53849,27603,26246,8212,843,465,1828,963,865,89
29,584,District - Ramanagara (30),Urban,Youth (15-24),55972,27785,28187,8681,742,372,3628,1732,1896,259
30,0,State - GOA (30),Total,All Ages,1458545,739140,719405,25449,149275,72948,293058,123317,169741,10758
30,0,State - GOA (30),Total,10-14,110989,57417,53572,2058,12386,6395,2908,1327,1581,167
30,0,State - GOA (30),Total,15-19,113875,60075,53800,2213,11970,6054,3300,1571,1729,357
30,0,State - GOA (30),Total,20-24,130745,70616,60129,2558,12615,6368,6124,2811,3313,662
30,0,State - GOA (30),Total,Adolescent (10-19),224864,117492,107372,4271,24356,12449,6208,2898,3310,524
30,0,State - GOA (30),Total,Youth (15-24),244620,130691,113929,4771,24585,12422,9424,4382,5042,1019
30,0,State - GOA (30),Rural,All Ages,551731,275436,276295,9461,87639,43263,120460,48293,72167,8024
30,0,State - GOA (30),Rural,10-14,41666,21304,20362,736,7170,3679,926,425,501,157
30,0,State - GOA (30),Rural,15-19,42371,22000,20371,796,7070,3650,1086,526,560,309
30,0,State - GOA (30),Rural,20-24,47290,24590,22700,921,7495,3782,1889,831,1058,498
30,0,State - GOA (30),Rural,Adolescent (10-19),84037,43304,40733,1532,14240,7329,2012,951,1061,466
30,0,State - GOA (30),Rural,Youth (15-24),89661,46590,43071,1717,14565,7432,2975,1357,1618,807
30,0,State - GOA (30),Urban,All Ages,906814,463704,443110,15988,61636,29685,172598,75024,97574,2734
30,0,State - GOA (30),Urban,10-14,69323,36113,33210,1322,5216,2716,1982,902,1080,10
30,0,State - GOA (30),Urban,15-19,71504,38075,33429,1417,4900,2404,2214,1045,1169,48
30,0,State - GOA (30),Urban,20-24,83455,46026,37429,1637,5120,2586,4235,1980,2255,164
30,0,State - GOA (30),Urban,Adolescent (10-19),140827,74188,66639,2739,10116,5120,4196,1947,2249,58
30,0,State - GOA (30),Urban,Youth (15-24),154959,84101,70858,3054,10020,4990,6449,3025,3424,212
30,585,District - North Goa (01),Total,All Ages,818008,416677,401331,17606,56606,27824,154948,64939,90009,5243
30,585,District - North Goa (01),Total,10-14,60662,31413,29249,1387,4405,2240,1578,727,851,94
30,585,District - North Goa (01),Total,15-19,62122,32901,29221,1475,4163,2111,1752,843,909,158
30,585,District - North Goa (01),Total,20-24,72667,39675,32992,1701,4566,2346,3293,1597,1696,285
30,585,District - North Goa (01),Total,Adolescent (10-19),122784,64314,58470,2862,8568,4351,3330,1570,1760,252
30,585,District - North Goa (01),Total,Youth (15-24),134789,72576,62213,3176,8729,4457,5045,2440,2605,443
30,585,District - North Goa (01),Rural,All Ages,324927,163908,161019,7843,27694,13600,66300,26323,39977,3603
30,585,District - North Goa (01),Rural,10-14,24125,12513,11612,605,2152,1091,512,242,270,88
30,585,District - North Goa (01),Rural,15-19,24435,12738,11697,658,2062,1082,605,300,305,129
30,585,District - North Goa (01),Rural,20-24,27678,14470,13208,750,2205,1125,1072,494,578,184
30,585,District - North Goa (01),Rural,Adolescent (10-19),48560,25251,23309,1263,4214,2173,1117,542,575,217
30,585,District - North Goa (01),Rural,Youth (15-24),52113,27208,24905,1408,4267,2207,1677,794,883,313
30,585,District - North Goa (01),Urban,All Ages,493081,252769,240312,9763,28912,14224,88648,38616,50032,1640
30,585,District - North Goa (01),Urban,10-14,36537,18900,17637,782,2253,1149,1066,485,581,6
30,585,District - North Goa (01),Urban,15-19,37687,20163,17524,817,2101,1029,1147,543,604,29
30,585,District - North Goa (01),Urban,20-24,44989,25205,19784,951,2361,1221,2221,1103,1118,101
30,585,District - North Goa (01),Urban,Adolescent (10-19),74224,39063,35161,1599,4354,2178,2213,1028,1185,35
30,585,District - North Goa (01),Urban,Youth (15-24),82676,45368,37308,1768,4462,2250,3368,1646,1722,130
30,586,District - South Goa (02),Total,All Ages,640537,322463,318074,7843,92669,45124,138110,58378,79732,5515
30,586,District - South Goa (02),Total,10-14,50327,26004,24323,671,7981,4155,1330,600,730,73
30,586,District - South Goa (02),Total,15-19,51753,27174,24579,738,7807,3943,1548,728,820,199
30,586,District - South Goa (02),Total,20-24,58078,30941,27137,857,8049,4022,2831,1214,1617,377
30,586,District - South Goa (02),Total,Adolescent (10-19),102080,53178,48902,1409,15788,8098,2878,1328,1550,272
30,586,District - South Goa (02),Total,Youth (15-24),109831,58115,51716,1595,15856,7965,4379,1942,2437,576
30,586,District - South Goa (02),Rural,All Ages,226804,111528,115276,1618,59945,29663,54160,21970,32190,4421
30,586,District - South Goa (02),Rural,10-14,17541,8791,8750,131,5018,2588,414,183,231,69
30,586,District - South Goa (02),Rural,15-19,17936,9262,8674,138,5008,2568,481,226,255,180
30,586,District - South Goa (02),Rural,20-24,19612,10120,9492,171,5290,2657,817,337,480,314
30,586,District - South Goa (02),Rural,Adolescent (10-19),35477,18053,17424,269,10026,5156,895,409,486,249
30,586,District - South Goa (02),Rural,Youth (15-24),37548,19382,18166,309,10298,5225,1298,563,735,494
30,586,District - South Goa (02),Urban,All Ages,413733,210935,202798,6225,32724,15461,83950,36408,47542,1094
30,586,District - South Goa (02),Urban,10-14,32786,17213,15573,540,2963,1567,916,417,499,4
30,586,District - South Goa (02),Urban,15-19,33817,17912,15905,600,2799,1375,1067,502,565,19
30,586,District - South Goa (02),Urban,20-24,38466,20821,17645,686,2759,1365,2014,877,1137,63
30,586,District - South Goa (02),Urban,Adolescent (10-19),66603,35125,31478,1140,5762,2942,1983,919,1064,23
30,586,District - South Goa (02),Urban,Youth (15-24),72283,38733,33550,1286,5558,2740,3081,1379,1702,82
31,0,State - LAKSHADWEEP (31),Total,All Ages,64473,33123,31350,0,61120,30515,11920,5100,6820,0
31,0,State - LAKSHADWEEP (31),Total,10-14,5998,2854,3144,0,5845,2775,146,68,78,0
31,0,State - LAKSHADWEEP (31),Total,15-19,5624,2808,2816,0,5460,2699,82,41,41,0
31,0,State - LAKSHADWEEP (31),Total,20-24,5829,3071,2758,0,5434,2725,113,60,53,0
31,0,State - LAKSHADWEEP (31),Total,Adolescent (10-19),11622,5662,5960,0,11305,5474,228,109,119,0
31,0,State - LAKSHADWEEP (31),Total,Youth (15-24),11453,5879,5574,0,10894,5424,195,101,94,0
31,0,State - LAKSHADWEEP (31),Rural,All Ages,14141,7243,6898,0,13463,6752,2853,1294,1559,0
31,0,State - LAKSHADWEEP (31),Rural,10-14,1389,612,777,0,1351,591,39,20,19,0
31,0,State - LAKSHADWEEP (31),Rural,15-19,1147,525,622,0,1106,498,15,6,9,0
31,0,State - LAKSHADWEEP (31),Rural,20-24,1280,680,600,0,1188,600,28,15,13,0
31,0,State - LAKSHADWEEP (31),Rural,Adolescent (10-19),2536,1137,1399,0,2457,1089,54,26,28,0
31,0,State - LAKSHADWEEP (31),Rural,Youth (15-24),2427,1205,1222,0,2294,1098,43,21,22,0
31,0,State - LAKSHADWEEP (31),Urban,All Ages,50332,25880,24452,0,47657,23763,9067,3806,5261,0
31,0,State - LAKSHADWEEP (31),Urban,10-14,4609,2242,2367,0,4494,2184,107,48,59,0
31,0,State - LAKSHADWEEP (31),Urban,15-19,4477,2283,2194,0,4354,2201,67,35,32,0
31,0,State - LAKSHADWEEP (31),Urban,20-24,4549,2391,2158,0,4246,2125,85,45,40,0
31,0,State - LAKSHADWEEP (31),Urban,Adolescent (10-19),9086,4525,4561,0,8848,4385,174,83,91,0
31,0,State - LAKSHADWEEP (31),Urban,Youth (15-24),9026,4674,4352,0,8600,4326,152,80,72,0
31,587,District - Lakshadweep (01),Total,All Ages,64473,33123,31350,0,61120,30515,11920,5100,6820,0
31,587,District - Lakshadweep (01),Total,10-14,5998,2854,3144,0,5845,2775,146,68,78,0
31,587,District - Lakshadweep (01),Total,15-19,5624,2808,2816,0,5460,2699,82,41,41,0
31,587,District - Lakshadweep (01),Total,20-24,5829,3071,2758,0,5434,2725,113,60,53,0
31,587,District - Lakshadweep (01),Total,Adolescent (10-19),11622,5662,5960,0,11305,5474,228,109,119,0
31,587,District - Lakshadweep (01),Total,Youth (15-24),11453,5879,5574,0,10894,5424,195,101,94,0
31,587,District - Lakshadweep (01),Rural,All Ages,14141,7243,6898,0,13463,6752,2853,1294,1559,0
31,587,District - Lakshadweep (01),Rural,10-14,1389,612,777,0,1351,591,39,20,19,0
31,587,District - Lakshadweep (01),Rural,15-19,1147,525,622,0,1106,498,15,6,9,0
31,587,District - Lakshadweep (01),Rural,20-24,1280,680,600,0,1188,600,28,15,13,0
31,587,District - Lakshadweep (01),Rural,Adolescent (10-19),2536,1137,1399,0,2457,1089,54,26,28,0
31,587,District - Lakshadweep (01),Rural,Youth (15-24),2427,1205,1222,0,2294,1098,43,21,22,0
31,587,District - Lakshadweep (01),Urban,All Ages,50332,25880,24452,0,47657,23763,9067,3806,5261,0
31,587,District - Lakshadweep (01),Urban,10-14,4609,2242,2367,0,4494,2184,107,48,59,0
31,587,District - Lakshadweep (01),Urban,15-19,4477,2283,2194,0,4354,2201,67,35,32,0
31,587,District - Lakshadweep (01),Urban,20-24,4549,2391,2158,0,4246,2125,85,45,40,0
31,587,District - Lakshadweep (01),Urban,Adolescent (10-19),9086,4525,4561,0,8848,4385,174,83,91,0
31,587,District - Lakshadweep (01),Urban,Youth (15-24),9026,4674,4352,0,8600,4326,152,80,72,0
32,0,State - KERALA (32),Total,All Ages,33406061,16027412,17378649,3039573,484839,238203,5270237,2322509,2947728,919136
32,0,State - KERALA (32),Total,10-14,2822770,1438917,1383853,253155,47957,24317,32078,16383,15695,1299
32,0,State - KERALA (32),Total,15-19,2610552,1328299,1282253,227183,37887,19147,21418,10821,10597,12458
32,0,State - KERALA (32),Total,20-24,2665809,1298826,1366983,249532,42545,20186,29478,14375,15103,43986
32,0,State - KERALA (32),Total,Adolescent (10-19),5433322,2767216,2666106,480338,85844,43464,53496,27204,26292,13757
32,0,State - KERALA (32),Total,Youth (15-24),5276361,2627125,2649236,476715,80432,39333,50896,25196,25700,56444
32,0,State - KERALA (32),Rural,All Ages,17471135,8408054,9063081,1818281,433092,213208,2921815,1275624,1646191,760632
32,0,State - KERALA (32),Rural,10-14,1499338,762897,736441,155458,42853,21975,17801,9108,8693,1172
32,0,State - KERALA (32),Rural,15-19,1365813,696204,669609,138171,33661,17148,12087,6012,6075,11105
32,0,State - KERALA (32),Rural,20-24,1386061,680283,705778,151991,38233,18080,17484,8121,9363,38247
32,0,State - KERALA (32),Rural,Adolescent (10-19),2865151,1459101,1406050,293629,76514,39123,29888,15120,14768,12277
32,0,State - KERALA (32),Rural,Youth (15-24),2751874,1376487,1375387,290162,71894,35228,29571,14133,15438,49352
32,0,State - KERALA (32),Urban,All Ages,15934926,7619358,8315568,1221292,51747,24995,2348422,1046885,1301537,158504
32,0,State - KERALA (32),Urban,10-14,1323432,676020,647412,97697,5104,2342,14277,7275,7002,127
32,0,State - KERALA (32),Urban,15-19,1244739,632095,612644,89012,4226,1999,9331,4809,4522,1353
32,0,State - KERALA (32),Urban,20-24,1279748,618543,661205,97541,4312,2106,11994,6254,5740,5739
32,0,State - KERALA (32),Urban,Adolescent (10-19),2568171,1308115,1260056,186709,9330,4341,23608,12084,11524,1480
32,0,State - KERALA (32),Urban,Youth (15-24),2524487,1250638,1273849,186553,8538,4105,21325,11063,10262,7092
32,588,District - Kasaragod (01),Total,All Ages,1307375,628613,678762,53283,48857,23950,269883,112137,157746,27722
32,588,District - Kasaragod (01),Total,10-14,121871,62341,59530,5080,4806,2411,1762,904,858,80
32,588,District - Kasaragod (01),Total,15-19,114473,57765,56708,4604,4017,2028,960,444,516,503
32,588,District - Kasaragod (01),Total,20-24,117636,55642,61994,5433,4689,2282,1484,634,850,1665
32,588,District - Kasaragod (01),Total,Adolescent (10-19),236344,120106,116238,9684,8823,4439,2722,1348,1374,583
32,588,District - Kasaragod (01),Total,Youth (15-24),232109,113407,118702,10037,8706,4310,2444,1078,1366,2168
32,588,District - Kasaragod (01),Rural,All Ages,798328,387716,410612,34522,46094,22674,170296,70026,100270,21309
32,588,District - Kasaragod (01),Rural,10-14,74426,38008,36418,3395,4456,2276,1156,595,561,75
32,588,District - Kasaragod (01),Rural,15-19,69311,35237,34074,3024,3734,1933,570,258,312,430
32,588,District - Kasaragod (01),Rural,20-24,71161,34345,36816,3647,4435,2159,966,420,546,1409
32,588,District - Kasaragod (01),Rural,Adolescent (10-19),143737,73245,70492,6419,8190,4209,1726,853,873,505
32,588,District - Kasaragod (01),Rural,Youth (15-24),140472,69582,70890,6671,8169,4092,1536,678,858,1839
32,588,District - Kasaragod (01),Urban,All Ages,509047,240897,268150,18761,2763,1276,99587,42111,57476,6413
32,588,District - Kasaragod (01),Urban,10-14,47445,24333,23112,1685,350,135,606,309,297,5
32,588,District - Kasaragod (01),Urban,15-19,45162,22528,22634,1580,283,95,390,186,204,73
32,588,District - Kasaragod (01),Urban,20-24,46475,21297,25178,1786,254,123,518,214,304,256
32,588,District - Kasaragod (01),Urban,Adolescent (10-19),92607,46861,45746,3265,633,230,996,495,501,78
32,588,District - Kasaragod (01),Urban,Youth (15-24),91637,43825,47812,3366,537,218,908,400,508,329
32,589,District - Kannur (02),Total,All Ages,2523003,1181446,1341557,83350,41371,20141,384569,168490,216079,59228
32,589,District - Kannur (02),Total,10-14,207988,106226,101762,6323,3806,1961,3149,1625,1524,76
32,589,District - Kannur (02),Total,15-19,195500,99226,96274,5719,3099,1572,1566,800,766,510
32,589,District - Kannur (02),Total,20-24,199663,94983,104680,6682,3601,1676,2137,1100,1037,1971
32,589,District - Kannur (02),Total,Adolescent (10-19),403488,205452,198036,12042,6905,3533,4715,2425,2290,586
32,589,District - Kannur (02),Total,Youth (15-24),395163,194209,200954,12401,6700,3248,3703,1900,1803,2481
32,589,District - Kannur (02),Rural,All Ages,882017,425682,456335,23562,36302,17699,145050,62652,82398,39917
32,589,District - Kannur (02),Rural,10-14,74554,38207,36347,1991,3344,1702,1258,630,628,63
32,589,District - Kannur (02),Rural,15-19,68356,34990,33366,1776,2682,1375,622,332,290,435
32,589,District - Kannur (02),Rural,20-24,68881,34344,34537,1964,3146,1469,945,507,438,1546
32,589,District - Kannur (02),Rural,Adolescent (10-19),142910,73197,69713,3767,6026,3077,1880,962,918,498
32,589,District - Kannur (02),Rural,Youth (15-24),137237,69334,67903,3740,5828,2844,1567,839,728,1981
32,589,District - Kannur (02),Urban,All Ages,1640986,755764,885222,59788,5069,2442,239519,105838,133681,19311
32,589,District - Kannur (02),Urban,10-14,133434,68019,65415,4332,462,259,1891,995,896,13
32,589,District - Kannur (02),Urban,15-19,127144,64236,62908,3943,417,197,944,468,476,75
32,589,District - Kannur (02),Urban,20-24,130782,60639,70143,4718,455,207,1192,593,599,425
32,589,District - Kannur (02),Urban,Adolescent (10-19),260578,132255,128323,8275,879,456,2835,1463,1372,88
32,589,District - Kannur (02),Urban,Youth (15-24),257926,124875,133051,8661,872,404,2136,1061,1075,500
32,590,District - Wayanad (03),Total,All Ages,817420,401684,415736,32578,151443,74476,171835,73548,98287,69133
32,590,District - Wayanad (03),Total,10-14,77418,39481,37937,3162,16724,8610,1259,644,615,194
32,590,District - Wayanad (03),Total,15-19,63919,32424,31495,2640,11955,5965,936,437,499,2096
32,590,District - Wayanad (03),Total,20-24,66417,31936,34481,2615,13700,6357,1824,674,1150,5595
32,590,District - Wayanad (03),Total,Adolescent (10-19),141337,71905,69432,5802,28679,14575,2195,1081,1114,2290
32,590,District - Wayanad (03),Total,Youth (15-24),130336,64360,65976,5255,25655,12322,2760,1111,1649,7691
32,590,District - Wayanad (03),Rural,All Ages,785840,386283,399557,30378,148215,73011,165770,70916,94854,68262
32,590,District - Wayanad (03),Rural,10-14,74468,38044,36424,2953,16300,8470,1225,627,598,192
32,590,District - Wayanad (03),Rural,15-19,61480,31186,30294,2467,11663,5828,901,424,477,2065
32,590,District - Wayanad (03),Rural,20-24,63802,30722,33080,2438,13408,6227,1760,643,1117,5546
32,590,District - Wayanad (03),Rural,Adolescent (10-19),135948,69230,66718,5420,27963,14298,2126,1051,1075,2257
32,590,District - Wayanad (03),Rural,Youth (15-24),125282,61908,63374,4905,25071,12055,2661,1067,1594,7611
32,590,District - Wayanad (03),Urban,All Ages,31580,15401,16179,2200,3228,1465,6065,2632,3433,871
32,590,District - Wayanad (03),Urban,10-14,2950,1437,1513,209,424,140,34,17,17,2
32,590,District - Wayanad (03),Urban,15-19,2439,1238,1201,173,292,137,35,13,22,31
32,590,District - Wayanad (03),Urban,20-24,2615,1214,1401,177,292,130,64,31,33,49
32,590,District - Wayanad (03),Urban,Adolescent (10-19),5389,2675,2714,382,716,277,69,30,39,33
32,590,District - Wayanad (03),Urban,Youth (15-24),5054,2452,2602,350,584,267,99,44,55,80
32,591,District - Kozhikode (04),Total,All Ages,3086293,1470942,1615351,199191,15228,7429,470850,204003,266847,37555
32,591,District - Kozhikode (04),Total,10-14,266107,136111,129996,16188,1391,695,2885,1469,1416,25
32,591,District - Kozhikode (04),Total,15-19,245547,125167,120380,14025,1142,617,1660,828,832,305
32,591,District - Kozhikode (04),Total,20-24,246515,116838,129677,14904,1291,608,1879,937,942,1435
32,591,District - Kozhikode (04),Total,Adolescent (10-19),511654,261278,250376,30213,2533,1312,4545,2297,2248,330
32,591,District - Kozhikode (04),Total,Youth (15-24),492062,242005,250057,28929,2433,1225,3539,1765,1774,1740
32,591,District - Kozhikode (04),Rural,All Ages,1013721,484784,528937,75490,9555,4700,164343,70388,93955,21881
32,591,District - Kozhikode (04),Rural,10-14,89460,45746,43714,6429,818,428,1029,529,500,17
32,591,District - Kozhikode (04),Rural,15-19,82117,42037,40080,5349,683,369,565,283,282,198
32,591,District - Kozhikode (04),Rural,20-24,81059,38966,42093,5736,794,363,681,330,351,912
32,591,District - Kozhikode (04),Rural,Adolescent (10-19),171577,87783,83794,11778,1501,797,1594,812,782,215
32,591,District - Kozhikode (04),Rural,Youth (15-24),163176,81003,82173,11085,1477,732,1246,613,633,1110
32,591,District - Kozhikode (04),Urban,All Ages,2072572,986158,1086414,123701,5673,2729,306507,133615,172892,15674
32,591,District - Kozhikode (04),Urban,10-14,176647,90365,86282,9759,573,267,1856,940,916,8
32,591,District - Kozhikode (04),Urban,15-19,163430,83130,80300,8676,459,248,1095,545,550,107
32,591,District - Kozhikode (04),Urban,20-24,165456,77872,87584,9168,497,245,1198,607,591,523
32,591,District - Kozhikode (04),Urban,Adolescent (10-19),340077,173495,166582,18435,1032,515,2951,1485,1466,115
32,591,District - Kozhikode (04),Urban,Youth (15-24),328886,161002,167884,17844,956,493,2293,1152,1141,630
32,592,District - Malappuram (05),Total,All Ages,4112920,1960328,2152592,308266,22990,11272,801605,362924,438681,81841
32,592,District - Malappuram (05),Total,10-14,424031,216411,207620,29091,2375,1230,4718,2491,2227,144
32,592,District - Malappuram (05),Total,15-19,393009,198452,194557,26033,1951,1014,2986,1588,1398,1451
32,592,District - Malappuram (05),Total,20-24,406877,194357,212520,29990,2090,986,3904,1936,1968,6505
32,592,District - Malappuram (05),Total,Adolescent (10-19),817040,414863,402177,55124,4326,2244,7704,4079,3625,1595
32,592,District - Malappuram (05),Total,Youth (15-24),799886,392809,407077,56023,4041,2000,6890,3524,3366,7956
32,592,District - Malappuram (05),Rural,All Ages,2295709,1095308,1200401,192270,18247,8927,457201,206577,250624,61030
32,592,District - Malappuram (05),Rural,10-14,239151,121917,117234,18846,1821,955,2750,1464,1286,121
32,592,District - Malappuram (05),Rural,15-19,216968,109506,107462,16611,1561,799,1727,915,812,1137
32,592,District - Malappuram (05),Rural,20-24,224543,107212,117331,19053,1668,796,2147,1044,1103,4945
32,592,District - Malappuram (05),Rural,Adolescent (10-19),456119,231423,224696,35457,3382,1754,4477,2379,2098,1258
32,592,District - Malappuram (05),Rural,Youth (15-24),441511,216718,224793,35664,3229,1595,3874,1959,1915,6082
32,592,District - Malappuram (05),Urban,All Ages,1817211,865020,952191,115996,4743,2345,344404,156347,188057,20811
32,592,District - Malappuram (05),Urban,10-14,184880,94494,90386,10245,554,275,1968,1027,941,23
32,592,District - Malappuram (05),Urban,15-19,176041,88946,87095,9422,390,215,1259,673,586,314
32,592,District - Malappuram (05),Urban,20-24,182334,87145,95189,10937,422,190,1757,892,865,1560
32,592,District - Malappuram (05),Urban,Adolescent (10-19),360921,183440,177481,19667,944,490,3227,1700,1527,337
32,592,District - Malappuram (05),Urban,Youth (15-24),358375,176091,182284,20359,812,405,3016,1565,1451,1874
32,593,District - Palakkad (06),Total,All Ages,2809934,1359478,1450456,403833,48972,24314,570442,236878,333564,195394
32,593,District - Palakkad (06),Total,10-14,244128,123988,120140,36969,5155,2580,2790,1451,1339,243
32,593,District - Palakkad (06),Total,15-19,228471,115748,112723,33519,3858,2068,2030,981,1049,2751
32,593,District - Palakkad (06),Total,20-24,246144,119819,126325,38450,4452,2009,3373,1464,1909,9872
32,593,District - Palakkad (06),Total,Adolescent (10-19),472599,239736,232863,70488,9013,4648,4820,2432,2388,2994
32,593,District - Palakkad (06),Total,Youth (15-24),474615,235567,239048,71969,8310,4077,5403,2445,2958,12623
32,593,District - Palakkad (06),Rural,All Ages,2133124,1031466,1101658,322951,47023,23317,454229,187611,266618,180457
32,593,District - Palakkad (06),Rural,10-14,187475,95020,92455,29934,4862,2436,2177,1137,1040,234
32,593,District - Palakkad (06),Rural,15-19,174381,88645,85736,26846,3701,1991,1596,760,836,2602
32,593,District - Palakkad (06),Rural,20-24,187845,91589,96256,30760,4309,1937,2690,1146,1544,9301
32,593,District - Palakkad (06),Rural,Adolescent (10-19),361856,183665,178191,56780,8563,4427,3773,1897,1876,2836
32,593,District - Palakkad (06),Rural,Youth (15-24),362226,180234,181992,57606,8010,3928,4286,1906,2380,11903
32,593,District - Palakkad (06),Urban,All Ages,676810,328012,348798,80882,1949,997,116213,49267,66946,14937
32,593,District - Palakkad (06),Urban,10-14,56653,28968,27685,7035,293,144,613,314,299,9
32,593,District - Palakkad (06),Urban,15-19,54090,27103,26987,6673,157,77,434,221,213,149
32,593,District - Palakkad (06),Urban,20-24,58299,28230,30069,7690,143,72,683,318,365,571
32,593,District - Palakkad (06),Urban,Adolescent (10-19),110743,56071,54672,13708,450,221,1047,535,512,158
32,593,District - Palakkad (06),Urban,Youth (15-24),112389,55333,57056,14363,300,149,1117,539,578,720
32,594,District - Thrissur (07),Total,All Ages,3121200,1480763,1640437,324350,9430,4362,442652,198502,244150,54538
32,594,District - Thrissur (07),Total,10-14,250700,127773,122927,25489,1040,475,2080,1052,1028,35
32,594,District - Thrissur (07),Total,15-19,239833,121875,117958,22994,746,306,1723,884,839,303
32,594,District - Thrissur (07),Total,20-24,239355,116293,123062,25416,685,356,1982,1118,864,1427
32,594,District - Thrissur (07),Total,Adolescent (10-19),490533,249648,240885,48483,1786,781,3803,1936,1867,338
32,594,District - Thrissur (07),Total,Youth (15-24),479188,238168,241020,48410,1431,662,3705,2002,1703,1730
32,594,District - Thrissur (07),Rural,All Ages,1024794,488303,536491,121839,5859,2718,159323,69683,89640,32181
32,594,District - Thrissur (07),Rural,10-14,82431,41913,40518,9765,669,324,667,344,323,20
32,594,District - Thrissur (07),Rural,15-19,77733,39622,38111,8753,482,173,531,263,268,169
32,594,District - Thrissur (07),Rural,20-24,77464,38022,39442,9683,433,224,636,334,302,820
32,594,District - Thrissur (07),Rural,Adolescent (10-19),160164,81535,78629,18518,1151,497,1198,607,591,189
32,594,District - Thrissur (07),Rural,Youth (15-24),155197,77644,77553,18436,915,397,1167,597,570,989
32,594,District - Thrissur (07),Urban,All Ages,2096406,992460,1103946,202511,3571,1644,283329,128819,154510,22357
32,594,District - Thrissur (07),Urban,10-14,168269,85860,82409,15724,371,151,1413,708,705,15
32,594,District - Thrissur (07),Urban,15-19,162100,82253,79847,14241,264,133,1192,621,571,134
32,594,District - Thrissur (07),Urban,20-24,161891,78271,83620,15733,252,132,1346,784,562,607
32,594,District - Thrissur (07),Urban,Adolescent (10-19),330369,168113,162256,29965,635,284,2605,1329,1276,149
32,594,District - Thrissur (07),Urban,Youth (15-24),323991,160524,163467,29974,516,265,2538,1405,1133,741
32,595,District - Ernakulam (08),Total,All Ages,3282388,1619557,1662831,268411,16559,8349,426712,193834,232878,49419
32,595,District - Ernakulam (08),Total,10-14,252209,128742,123467,20388,1405,734,2298,1171,1127,30
32,595,District - Ernakulam (08),Total,15-19,229573,118577,110996,18023,1119,553,1765,946,819,305
32,595,District - Ernakulam (08),Total,20-24,235855,121109,114746,19262,1365,685,2491,1440,1051,1241
32,595,District - Ernakulam (08),Total,Adolescent (10-19),481782,247319,234463,38411,2524,1287,4063,2117,1946,335
32,595,District - Ernakulam (08),Total,Youth (15-24),465428,239686,225742,37285,2484,1238,4256,2386,1870,1546
32,595,District - Ernakulam (08),Rural,All Ages,1048025,518510,529515,102403,8324,4225,139617,62540,77077,36217
32,595,District - Ernakulam (08),Rural,10-14,80772,41068,39704,7851,799,415,730,367,363,26
32,595,District - Ernakulam (08),Rural,15-19,73160,38027,35133,6946,571,291,536,277,259,201
32,595,District - Ernakulam (08),Rural,20-24,72376,37765,34611,7256,679,331,851,504,347,855
32,595,District - Ernakulam (08),Rural,Adolescent (10-19),153932,79095,74837,14797,1370,706,1266,644,622,227
32,595,District - Ernakulam (08),Rural,Youth (15-24),145536,75792,69744,14202,1250,622,1387,781,606,1056
32,595,District - Ernakulam (08),Urban,All Ages,2234363,1101047,1133316,166008,8235,4124,287095,131294,155801,13202
32,595,District - Ernakulam (08),Urban,10-14,171437,87674,83763,12537,606,319,1568,804,764,4
32,595,District - Ernakulam (08),Urban,15-19,156413,80550,75863,11077,548,262,1229,669,560,104
32,595,District - Ernakulam (08),Urban,20-24,163479,83344,80135,12006,686,354,1640,936,704,386
32,595,District - Ernakulam (08),Urban,Adolescent (10-19),327850,168224,159626,23614,1154,581,2797,1473,1324,108
32,595,District - Ernakulam (08),Urban,Youth (15-24),319892,163894,155998,23083,1234,616,2869,1605,1264,490
32,596,District - Idukki (09),Total,All Ages,1108974,552808,556166,145486,55815,27995,185964,80927,105037,112391
32,596,District - Idukki (09),Total,10-14,91858,46763,45095,12478,4748,2452,1176,576,600,213
32,596,District - Idukki (09),Total,15-19,79704,40943,38761,11626,4354,2224,1089,461,628,2194
32,596,District - Idukki (09),Total,20-24,81667,41758,39909,12424,4938,2410,2006,727,1279,6554
32,596,District - Idukki (09),Total,Adolescent (10-19),171562,87706,83856,24104,9102,4676,2265,1037,1228,2407
32,596,District - Idukki (09),Total,Youth (15-24),161371,82701,78670,24050,9292,4634,3095,1188,1907,8748
32,596,District - Idukki (09),Rural,All Ages,1056929,527245,529684,143340,55243,27735,178718,77603,101115,111410
32,596,District - Idukki (09),Rural,10-14,87544,44584,42960,12330,4695,2432,1139,564,575,211
32,596,District - Idukki (09),Rural,15-19,75829,38990,36839,11465,4288,2208,1069,448,621,2190
32,596,District - Idukki (09),Rural,20-24,77806,39782,38024,12250,4896,2391,1950,686,1264,6523
32,596,District - Idukki (09),Rural,Adolescent (10-19),163373,83574,79799,23795,8983,4640,2208,1012,1196,2401
32,596,District - Idukki (09),Rural,Youth (15-24),153635,78772,74863,23715,9184,4599,3019,1134,1885,8713
32,596,District - Idukki (09),Urban,All Ages,52045,25563,26482,2146,572,260,7246,3324,3922,981
32,596,District - Idukki (09),Urban,10-14,4314,2179,2135,148,53,20,37,12,25,2
32,596,District - Idukki (09),Urban,15-19,3875,1953,1922,161,66,16,20,13,7,4
32,596,District - Idukki (09),Urban,20-24,3861,1976,1885,174,42,19,56,41,15,31
32,596,District - Idukki (09),Urban,Adolescent (10-19),8189,4132,4057,309,119,36,57,25,32,6
32,596,District - Idukki (09),Urban,Youth (15-24),7736,3929,3807,335,108,35,76,54,22,35
32,597,District - Kottayam (10),Total,All Ages,1974551,968289,1006262,153909,21972,10974,224753,106697,118056,44783
32,597,District - Kottayam (10),Total,10-14,155915,79113,76802,12518,1792,905,1555,804,751,37
32,597,District - Kottayam (10),Total,15-19,138696,72099,66597,10686,1502,802,1103,568,535,219
32,597,District - Kottayam (10),Total,20-24,129329,68170,61159,10957,1604,861,1297,761,536,1049
32,597,District - Kottayam (10),Total,Adolescent (10-19),294611,151212,143399,23204,3294,1707,2658,1372,1286,256
32,597,District - Kottayam (10),Total,Youth (15-24),268025,140269,127756,21643,3106,1663,2400,1329,1071,1268
32,597,District - Kottayam (10),Rural,All Ages,1409158,692673,716485,119360,19698,9850,162383,77222,85161,38839
32,597,District - Kottayam (10),Rural,10-14,110645,56121,54524,9553,1563,795,1104,567,537,33
32,597,District - Kottayam (10),Rural,15-19,96909,50522,46387,8189,1324,702,832,443,389,191
32,597,District - Kottayam (10),Rural,20-24,90309,47903,42406,8395,1401,746,939,575,364,939
32,597,District - Kottayam (10),Rural,Adolescent (10-19),207554,106643,100911,17742,2887,1497,1936,1010,926,224
32,597,District - Kottayam (10),Rural,Youth (15-24),187218,98425,88793,16584,2725,1448,1771,1018,753,1130
32,597,District - Kottayam (10),Urban,All Ages,565393,275616,289777,34549,2274,1124,62370,29475,32895,5944
32,597,District - Kottayam (10),Urban,10-14,45270,22992,22278,2965,229,110,451,237,214,4
32,597,District - Kottayam (10),Urban,15-19,41787,21577,20210,2497,178,100,271,125,146,28
32,597,District - Kottayam (10),Urban,20-24,39020,20267,18753,2562,203,115,358,186,172,110
32,597,District - Kottayam (10),Urban,Adolescent (10-19),87057,44569,42488,5462,407,210,722,362,360,32
32,597,District - Kottayam (10),Urban,Youth (15-24),80807,41844,38963,5059,381,215,629,311,318,138
32,598,District - Alappuzha (11),Total,All Ages,2127789,1013142,1114647,201211,6574,3175,274992,122590,152402,39491
32,598,District - Alappuzha (11),Total,10-14,165547,84279,81268,15296,547,263,1743,874,869,38
32,598,District - Alappuzha (11),Total,15-19,147508,75552,71956,13340,473,236,1105,592,513,229
32,598,District - Alappuzha (11),Total,20-24,146758,72479,74279,14165,491,254,1249,625,624,802
32,598,District - Alappuzha (11),Total,Adolescent (10-19),313055,159831,153224,28636,1020,499,2848,1466,1382,267
32,598,District - Alappuzha (11),Total,Youth (15-24),294266,148031,146235,27505,964,490,2354,1217,1137,1031
32,598,District - Alappuzha (11),Rural,All Ages,979643,464713,514930,111931,2961,1440,127173,57300,69873,29796
32,598,District - Alappuzha (11),Rural,10-14,75794,38585,37209,8407,226,116,821,425,396,33
32,598,District - Alappuzha (11),Rural,15-19,67440,34562,32878,7337,226,121,529,287,242,179
32,598,District - Alappuzha (11),Rural,20-24,66024,32797,33227,7843,243,130,578,299,279,611
32,598,District - Alappuzha (11),Rural,Adolescent (10-19),143234,73147,70087,15744,452,237,1350,712,638,212
32,598,District - Alappuzha (11),Rural,Youth (15-24),133464,67359,66105,15180,469,251,1107,586,521,790
32,598,District - Alappuzha (11),Urban,All Ages,1148146,548429,599717,89280,3613,1735,147819,65290,82529,9695
32,598,District - Alappuzha (11),Urban,10-14,89753,45694,44059,6889,321,147,922,449,473,5
32,598,District - Alappuzha (11),Urban,15-19,80068,40990,39078,6003,247,115,576,305,271,50
32,598,District - Alappuzha (11),Urban,20-24,80734,39682,41052,6322,248,124,671,326,345,191
32,598,District - Alappuzha (11),Urban,Adolescent (10-19),169821,86684,83137,12892,568,262,1498,754,744,55
32,598,District - Alappuzha (11),Urban,Youth (15-24),160802,80672,80130,12325,495,239,1247,631,616,241
32,599,District - Pathanamthitta (12),Total,All Ages,1197412,561716,635696,164465,8108,3947,134859,62535,72324,35216
32,599,District - Pathanamthitta (12),Total,10-14,89315,45295,44020,12994,726,387,951,490,461,33
32,599,District - Pathanamthitta (12),Total,15-19,84509,43388,41121,11265,605,329,681,376,305,222
32,599,District - Pathanamthitta (12),Total,20-24,82770,41860,40910,12326,608,274,827,414,413,1091
32,599,District - Pathanamthitta (12),Total,Adolescent (10-19),173824,88683,85141,24259,1331,716,1632,866,766,255
32,599,District - Pathanamthitta (12),Total,Youth (15-24),167279,85248,82031,23591,1213,603,1508,790,718,1313
32,599,District - Pathanamthitta (12),Rural,All Ages,1065799,499820,565979,151844,7663,3732,120448,55798,64650,33523
32,599,District - Pathanamthitta (12),Rural,10-14,79409,40300,39109,11996,694,369,855,445,410,32
32,599,District - Pathanamthitta (12),Rural,15-19,75162,38609,36553,10388,565,311,597,329,268,214
32,599,District - Pathanamthitta (12),Rural,20-24,73313,37182,36131,11362,571,255,727,357,370,1045
32,599,District - Pathanamthitta (12),Rural,Adolescent (10-19),154571,78909,75662,22384,1259,680,1452,774,678,246
32,599,District - Pathanamthitta (12),Rural,Youth (15-24),148475,75791,72684,21750,1136,566,1324,686,638,1259
32,599,District - Pathanamthitta (12),Urban,All Ages,131613,61896,69717,12621,445,215,14411,6737,7674,1693
32,599,District - Pathanamthitta (12),Urban,10-14,9906,4995,4911,998,32,18,96,45,51,1
32,599,District - Pathanamthitta (12),Urban,15-19,9347,4779,4568,877,40,18,84,47,37,8
32,599,District - Pathanamthitta (12),Urban,20-24,9457,4678,4779,964,37,19,100,57,43,46
32,599,District - Pathanamthitta (12),Urban,Adolescent (10-19),19253,9774,9479,1875,72,36,180,92,88,9
32,599,District - Pathanamthitta (12),Urban,Youth (15-24),18804,9457,9347,1841,77,37,184,104,80,54
32,600,District - Kollam (13),Total,All Ages,2635375,1246968,1388407,328263,10761,5195,395102,172623,222479,56640
32,600,District - Kollam (13),Total,10-14,212437,108388,104049,26560,1033,538,2316,1183,1133,76
32,600,District - Kollam (13),Total,15-19,194497,98395,96102,23202,769,382,1577,803,774,644
32,600,District - Kollam (13),Total,20-24,199854,95208,104646,25647,844,374,2065,1021,1044,2321
32,600,District - Kollam (13),Total,Adolescent (10-19),406934,206783,200151,49762,1802,920,3893,1986,1907,720
32,600,District - Kollam (13),Total,Youth (15-24),394351,193603,200748,48849,1613,756,3642,1824,1818,2965
32,600,District - Kollam (13),Rural,All Ages,1448217,680687,767530,208474,7886,3821,214855,93300,121555,45472
32,600,District - Kollam (13),Rural,10-14,116022,59014,57008,16856,827,432,1220,614,606,68
32,600,District - Kollam (13),Rural,15-19,105616,53387,52229,14675,554,284,839,406,433,536
32,600,District - Kollam (13),Rural,20-24,107485,51140,56345,16253,603,273,1119,531,588,1897
32,600,District - Kollam (13),Rural,Adolescent (10-19),221638,112401,109237,31531,1381,716,2059,1020,1039,604
32,600,District - Kollam (13),Rural,Youth (15-24),213101,104527,108574,30928,1157,557,1958,937,1021,2433
32,600,District - Kollam (13),Urban,All Ages,1187158,566281,620877,119789,2875,1374,180247,79323,100924,11168
32,600,District - Kollam (13),Urban,10-14,96415,49374,47041,9704,206,106,1096,569,527,8
32,600,District - Kollam (13),Urban,15-19,88881,45008,43873,8527,215,98,738,397,341,108
32,600,District - Kollam (13),Urban,20-24,92369,44068,48301,9394,241,101,946,490,456,424
32,600,District - Kollam (13),Urban,Adolescent (10-19),185296,94382,90914,18231,421,204,1834,966,868,116
32,600,District - Kollam (13),Urban,Youth (15-24),181250,89076,92174,17921,456,199,1684,887,797,532
32,601,District - Thiruvananthapuram (14),Total,All Ages,3301427,1581678,1719749,372977,26759,12624,516019,226821,289198,55785
32,601,District - Thiruvananthapuram (14),Total,10-14,263246,134006,129240,30619,2409,1076,3396,1649,1747,75
32,601,District - Thiruvananthapuram (14),Total,15-19,255313,128688,126625,29507,2297,1051,2237,1113,1124,726
32,601,District - Thiruvananthapuram (14),Total,20-24,266969,128374,138595,31261,2187,1054,2960,1524,1436,2458
32,601,District - Thiruvananthapuram (14),Total,Adolescent (10-19),518559,262694,255865,60126,4706,2127,5633,2762,2871,801
32,601,District - Thiruvananthapuram (14),Total,Youth (15-24),522282,257062,265220,60768,4484,2105,5197,2637,2560,3184
32,601,District - Thiruvananthapuram (14),Rural,All Ages,1529831,724864,804967,179917,20022,9359,262409,114008,148401,40338
32,601,District - Thiruvananthapuram (14),Rural,10-14,127187,64370,62817,15152,1779,825,1670,800,870,47
32,601,District - Thiruvananthapuram (14),Rural,15-19,121351,60884,60467,14345,1627,763,1173,587,586,558
32,601,District - Thiruvananthapuram (14),Rural,20-24,123993,58514,65479,15351,1647,779,1495,745,750,1898
32,601,District - Thiruvananthapuram (14),Rural,Adolescent (10-19),248538,125254,123284,29497,3406,1588,2843,1387,1456,605
32,601,District - Thiruvananthapuram (14),Rural,Youth (15-24),245344,119398,125946,29696,3274,1542,2668,1332,1336,2456
32,601,District - Thiruvananthapuram (14),Urban,All Ages,1771596,856814,914782,193060,6737,3265,253610,112813,140797,15447
32,601,District - Thiruvananthapuram (14),Urban,10-14,136059,69636,66423,15467,630,251,1726,849,877,28
32,601,District - Thiruvananthapuram (14),Urban,15-19,133962,67804,66158,15162,670,288,1064,526,538,168
32,601,District - Thiruvananthapuram (14),Urban,20-24,142976,69860,73116,15910,540,275,1465,779,686,560
32,601,District - Thiruvananthapuram (14),Urban,Adolescent (10-19),270021,137440,132581,30629,1300,539,2790,1375,1415,196
32,601,District - Thiruvananthapuram (14),Urban,Youth (15-24),276938,137664,139274,31072,1210,563,2529,1305,1224,728
33,0,State - TAMIL NADU (33),Total,All Ages,72147030,36137975,36009055,14438445,794697,401068,20309523,8097484,12212039,7234101
33,0,State - TAMIL NADU (33),Total,10-14,6177547,3188990,2988557,1383936,82935,42988,129395,61503,67892,30489
33,0,State - TAMIL NADU (33),Total,15-19,6253792,3229838,3023954,1377146,72360,37918,156247,66585,89662,267967
33,0,State - TAMIL NADU (33),Total,20-24,6411543,3154804,3256739,1394901,72277,34659,339466,114708,224758,580000
33,0,State - TAMIL NADU (33),Total,Adolescent (10-19),12431339,6418828,6012511,2761082,155295,80906,285642,128088,157554,298456
33,0,State - TAMIL NADU (33),Total,Youth (15-24),12665335,6384642,6280693,2772047,144637,72577,495713,181293,314420,847967
33,0,State - TAMIL NADU (33),Rural,All Ages,37229590,18679065,18550525,9475475,660280,333178,12727395,5013226,7714169,6252943
33,0,State - TAMIL NADU (33),Rural,10-14,3325160,1726166,1598994,924268,68588,35415,75551,35551,40000,27726
33,0,State - TAMIL NADU (33),Rural,15-19,3373098,1765233,1607865,912987,59642,31380,99966,41504,58462,240028
33,0,State - TAMIL NADU (33),Rural,20-24,3315234,1658770,1656464,901740,59594,28666,225615,72828,152787,516134
33,0,State - TAMIL NADU (33),Rural,Adolescent (10-19),6698258,3491399,3206859,1837255,128230,66795,175517,77055,98462,267754
33,0,State - TAMIL NADU (33),Rural,Youth (15-24),6688332,3424003,3264329,1814727,119236,60046,325581,114332,211249,756162
33,0,State - TAMIL NADU (33),Urban,All Ages,34917440,17458910,17458530,4962970,134417,67890,7582128,3084258,4497870,981158
33,0,State - TAMIL NADU (33),Urban,10-14,2852387,1462824,1389563,459668,14347,7573,53844,25952,27892,2763
33,0,State - TAMIL NADU (33),Urban,15-19,2880694,1464605,1416089,464159,12718,6538,56281,25081,31200,27939
33,0,State - TAMIL NADU (33),Urban,20-24,3096309,1496034,1600275,493161,12683,5993,113851,41880,71971,63866
33,0,State - TAMIL NADU (33),Urban,Adolescent (10-19),5733081,2927429,2805652,923827,27065,14111,110125,51033,59092,30702
33,0,State - TAMIL NADU (33),Urban,Youth (15-24),5977003,2960639,3016364,957320,25401,12531,170132,66961,103171,91805
33,602,District - Thiruvallur (01),Total,All Ages,3728104,1876062,1852042,821646,47243,23692,936383,380351,556032,173150
33,602,District - Thiruvallur (01),Total,10-14,306328,157389,148939,74855,4726,2410,6972,3309,3663,760
33,602,District - Thiruvallur (01),Total,15-19,312064,160935,151129,78011,4024,2072,7968,3401,4567,6523
33,602,District - Thiruvallur (01),Total,20-24,352453,171058,181395,85246,4488,2041,17507,5871,11636,14422
33,602,District - Thiruvallur (01),Total,Adolescent (10-19),618392,318324,300068,152866,8750,4482,14940,6710,8230,7283
33,602,District - Thiruvallur (01),Total,Youth (15-24),664517,331993,332524,163257,8512,4113,25475,9272,16203,20945
33,602,District - Thiruvallur (01),Rural,All Ages,1299709,650462,649247,451999,35044,17521,440009,174263,265746,160079
33,602,District - Thiruvallur (01),Rural,10-14,116404,59735,56669,43267,3602,1826,2992,1409,1583,710
33,602,District - Thiruvallur (01),Rural,15-19,121988,63573,58415,45350,2997,1570,4069,1737,2332,5894
33,602,District - Thiruvallur (01),Rural,20-24,126236,62487,63749,46681,3190,1412,9357,3003,6354,13318
33,602,District - Thiruvallur (01),Rural,Adolescent (10-19),238392,123308,115084,88617,6599,3396,7061,3146,3915,6604
33,602,District - Thiruvallur (01),Rural,Youth (15-24),248224,126060,122164,92031,6187,2982,13426,4740,8686,19212
33,602,District - Thiruvallur (01),Urban,All Ages,2428395,1225600,1202795,369647,12199,6171,496374,206088,290286,13071
33,602,District - Thiruvallur (01),Urban,10-14,189924,97654,92270,31588,1124,584,3980,1900,2080,50
33,602,District - Thiruvallur (01),Urban,15-19,190076,97362,92714,32661,1027,502,3899,1664,2235,629
33,602,District - Thiruvallur (01),Urban,20-24,226217,108571,117646,38565,1298,629,8150,2868,5282,1104
33,602,District - Thiruvallur (01),Urban,Adolescent (10-19),380000,195016,184984,64249,2151,1086,7879,3564,4315,679
33,602,District - Thiruvallur (01),Urban,Youth (15-24),416293,205933,210360,71226,2325,1131,12049,4532,7517,1733
33,603,District - Chennai (02),Total,All Ages,4646732,2335844,2310888,779667,10061,5207,870456,367765,502691,10251
33,603,District - Chennai (02),Total,10-14,347550,177999,169551,66965,781,410,7928,3627,4301,71
33,603,District - Chennai (02),Total,15-19,365046,186453,178593,70899,832,424,8615,3845,4770,842
33,603,District - Chennai (02),Total,20-24,432978,210171,222807,82477,1026,537,18086,7281,10805,1189
33,603,District - Chennai (02),Total,Adolescent (10-19),712596,364452,348144,137864,1613,834,16543,7472,9071,913
33,603,District - Chennai (02),Total,Youth (15-24),798024,396624,401400,153376,1858,961,26701,11126,15575,2031
33,603,District - Chennai (02),Rural,All Ages,0,0,0,0,0,0,0,0,0,0
33,603,District - Chennai (02),Rural,10-14,0,0,0,0,0,0,0,0,0,0
33,603,District - Chennai (02),Rural,15-19,0,0,0,0,0,0,0,0,0,0
33,603,District - Chennai (02),Rural,20-24,0,0,0,0,0,0,0,0,0,0
33,603,District - Chennai (02),Rural,Adolescent (10-19),0,0,0,0,0,0,0,0,0,0
33,603,District - Chennai (02),Rural,Youth (15-24),0,0,0,0,0,0,0,0,0,0
33,603,District - Chennai (02),Urban,All Ages,4646732,2335844,2310888,779667,10061,5207,870456,367765,502691,10251
33,603,District - Chennai (02),Urban,10-14,347550,177999,169551,66965,781,410,7928,3627,4301,71
33,603,District - Chennai (02),Urban,15-19,365046,186453,178593,70899,832,424,8615,3845,4770,842
33,603,District - Chennai (02),Urban,20-24,432978,210171,222807,82477,1026,537,18086,7281,10805,1189
33,603,District - Chennai (02),Urban,Adolescent (10-19),712596,364452,348144,137864,1613,834,16543,7472,9071,913
33,603,District - Chennai (02),Urban,Youth (15-24),798024,396624,401400,153376,1858,961,26701,11126,15575,2031
33,604,District - Kancheepuram (03),Total,All Ages,3998252,2012958,1985294,948081,41210,20605,984870,401497,583373,162494
33,604,District - Kancheepuram (03),Total,10-14,317654,162541,155113,86943,4414,2281,6964,3335,3629,590
33,604,District - Kancheepuram (03),Total,15-19,345993,178669,167324,96254,3673,1880,7464,3186,4278,5423
33,604,District - Kancheepuram (03),Total,20-24,391229,190782,200447,102355,3827,1777,17101,6037,11064,12520
33,604,District - Kancheepuram (03),Total,Adolescent (10-19),663647,341210,322437,183197,8087,4161,14428,6521,7907,6013
33,604,District - Kancheepuram (03),Total,Youth (15-24),737222,369451,367771,198609,7500,3657,24565,9223,15342,17943
33,604,District - Kancheepuram (03),Rural,All Ages,1459916,734979,724937,550997,27057,13486,471538,187985,283553,144527
33,604,District - Kancheepuram (03),Rural,10-14,125500,64214,61286,51893,2981,1520,2972,1486,1486,537
33,604,District - Kancheepuram (03),Rural,15-19,147512,76733,70779,58761,2378,1220,3567,1542,2025,4699
33,604,District - Kancheepuram (03),Rural,20-24,151317,75720,75597,59352,2377,1063,8865,3124,5741,11122
33,604,District - Kancheepuram (03),Rural,Adolescent (10-19),273012,140947,132065,110654,5359,2740,6539,3028,3511,5236
33,604,District - Kancheepuram (03),Rural,Youth (15-24),298829,152453,146376,118113,4755,2283,12432,4666,7766,15821
33,604,District - Kancheepuram (03),Urban,All Ages,2538336,1277979,1260357,397084,14153,7119,513332,213512,299820,17967
33,604,District - Kancheepuram (03),Urban,10-14,192154,98327,93827,35050,1433,761,3992,1849,2143,53
33,604,District - Kancheepuram (03),Urban,15-19,198481,101936,96545,37493,1295,660,3897,1644,2253,724
33,604,District - Kancheepuram (03),Urban,20-24,239912,115062,124850,43003,1450,714,8236,2913,5323,1398
33,604,District - Kancheepuram (03),Urban,Adolescent (10-19),390635,200263,190372,72543,2728,1421,7889,3493,4396,777
33,604,District - Kancheepuram (03),Urban,Youth (15-24),438393,216998,221395,80496,2745,1374,12133,4557,7576,2122
33,605,District - Vellore (04),Total,All Ages,3936331,1961688,1974643,860212,72955,36663,1162403,457333,705070,254999
33,605,District - Vellore (04),Total,10-14,350916,179361,171555,80410,7830,4136,9079,4251,4828,987
33,605,District - Vellore (04),Total,15-19,370795,190054,180741,84799,6767,3540,11505,4803,6702,9958
33,605,District - Vellore (04),Total,20-24,382266,188311,193955,88431,6590,3014,22479,7547,14932,21487
33,605,District - Vellore (04),Total,Adolescent (10-19),721711,369415,352296,165209,14597,7676,20584,9054,11530,10945
33,605,District - Vellore (04),Total,Youth (15-24),753061,378365,374696,173230,13357,6554,33984,12350,21634,31445
33,605,District - Vellore (04),Rural,All Ages,2234344,1117101,1117243,547724,65015,32675,751413,292794,458619,233168
33,605,District - Vellore (04),Rural,10-14,202368,104369,97999,51584,7050,3725,5046,2292,2754,926
33,605,District - Vellore (04),Rural,15-19,208992,108399,100593,53679,5974,3114,6751,2688,4063,9245
33,605,District - Vellore (04),Rural,20-24,211517,105204,106313,55391,5828,2660,13809,4386,9423,19903
33,605,District - Vellore (04),Rural,Adolescent (10-19),411360,212768,198592,105263,13024,6839,11797,4980,6817,10171
33,605,District - Vellore (04),Rural,Youth (15-24),420509,213603,206906,109070,11802,5774,20560,7074,13486,29148
33,605,District - Vellore (04),Urban,All Ages,1701987,844587,857400,312488,7940,3988,410990,164539,246451,21831
33,605,District - Vellore (04),Urban,10-14,148548,74992,73556,28826,780,411,4033,1959,2074,61
33,605,District - Vellore (04),Urban,15-19,161803,81655,80148,31120,793,426,4754,2115,2639,713
33,605,District - Vellore (04),Urban,20-24,170749,83107,87642,33040,762,354,8670,3161,5509,1584
33,605,District - Vellore (04),Urban,Adolescent (10-19),310351,156647,153704,59946,1573,837,8787,4074,4713,774
33,605,District - Vellore (04),Urban,Youth (15-24),332552,164762,167790,64160,1555,780,13424,5276,8148,2297
33,606,District - Tiruvannamalai (05),Total,All Ages,2464875,1235889,1228986,565329,90954,45956,838062,326086,511976,351310
33,606,District - Tiruvannamalai (05),Total,10-14,214083,110061,104022,53079,9808,5083,5988,2794,3194,1963
33,606,District - Tiruvannamalai (05),Total,15-19,226033,116447,109586,57072,8856,4706,8291,3346,4945,18682
33,606,District - Tiruvannamalai (05),Total,20-24,232301,116351,115950,58494,8536,4147,17501,5590,11911,37501
33,606,District - Tiruvannamalai (05),Total,Adolescent (10-19),440116,226508,213608,110151,18664,9789,14279,6140,8139,20645
33,606,District - Tiruvannamalai (05),Total,Youth (15-24),458334,232798,225536,115566,17392,8853,25792,8936,16856,56183
33,606,District - Tiruvannamalai (05),Rural,All Ages,1969930,989726,980204,493925,86775,43864,716832,279061,437771,335138
33,606,District - Tiruvannamalai (05),Rural,10-14,172053,88561,83492,46285,9403,4867,5025,2307,2718,1905
33,606,District - Tiruvannamalai (05),Rural,15-19,183153,94877,88276,49911,8493,4527,7234,2881,4353,17997
33,606,District - Tiruvannamalai (05),Rural,20-24,186664,94434,92230,50922,8131,3954,15305,4831,10474,36000
33,606,District - Tiruvannamalai (05),Rural,Adolescent (10-19),355206,183438,171768,96196,17896,9394,12259,5188,7071,19902
33,606,District - Tiruvannamalai (05),Rural,Youth (15-24),369817,189311,180506,100833,16624,8481,22539,7712,14827,53997
33,606,District - Tiruvannamalai (05),Urban,All Ages,494945,246163,248782,71404,4179,2092,121230,47025,74205,16172
33,606,District - Tiruvannamalai (05),Urban,10-14,42030,21500,20530,6794,405,216,963,487,476,58
33,606,District - Tiruvannamalai (05),Urban,15-19,42880,21570,21310,7161,363,179,1057,465,592,685
33,606,District - Tiruvannamalai (05),Urban,20-24,45637,21917,23720,7572,405,193,2196,759,1437,1501
33,606,District - Tiruvannamalai (05),Urban,Adolescent (10-19),84910,43070,41840,13955,768,395,2020,952,1068,743
33,606,District - Tiruvannamalai (05),Urban,Youth (15-24),88517,43487,45030,14733,768,372,3253,1224,2029,2186
33,607,District - Viluppuram (06),Total,All Ages,3458873,1740819,1718054,1015716,74859,37570,1263097,506340,756757,537581
33,607,District - Viluppuram (06),Total,10-14,317333,162594,154739,102515,8276,4254,9352,4076,5276,3043
33,607,District - Viluppuram (06),Total,15-19,320972,165120,155852,103773,6868,3584,14951,5578,9373,28423
33,607,District - Viluppuram (06),Total,20-24,324432,162030,162402,102370,6842,3197,32782,9944,22838,57120
33,607,District - Viluppuram (06),Total,Adolescent (10-19),638305,327714,310591,206288,15144,7838,24303,9654,14649,31466
33,607,District - Viluppuram (06),Total,Youth (15-24),645404,327150,318254,206143,13710,6781,47733,15522,32211,85543
33,607,District - Viluppuram (06),Rural,All Ages,2939785,1481475,1458310,924896,71370,35789,1135842,455858,679984,521528
33,607,District - Viluppuram (06),Rural,10-14,271000,138709,132291,93102,7562,3850,8309,3606,4703,2995
33,607,District - Viluppuram (06),Rural,15-19,275979,142162,133817,94647,6450,3350,13902,5144,8758,27790
33,607,District - Viluppuram (06),Rural,20-24,277531,139678,137853,93128,6570,3075,30623,9303,21320,55707
33,607,District - Viluppuram (06),Rural,Adolescent (10-19),546979,280871,266108,187749,14012,7200,22211,8750,13461,30785
33,607,District - Viluppuram (06),Rural,Youth (15-24),553510,281840,271670,187775,13020,6425,44525,14447,30078,83497
33,607,District - Viluppuram (06),Urban,All Ages,519088,259344,259744,90820,3489,1781,127255,50482,76773,16053
33,607,District - Viluppuram (06),Urban,10-14,46333,23885,22448,9413,714,404,1043,470,573,48
33,607,District - Viluppuram (06),Urban,15-19,44993,22958,22035,9126,418,234,1049,434,615,633
33,607,District - Viluppuram (06),Urban,20-24,46901,22352,24549,9242,272,122,2159,641,1518,1413
33,607,District - Viluppuram (06),Urban,Adolescent (10-19),91326,46843,44483,18539,1132,638,2092,904,1188,681
33,607,District - Viluppuram (06),Urban,Youth (15-24),91894,45310,46584,18368,690,356,3208,1075,2133,2046
33,608,District - Salem (07),Total,All Ages,3482056,1781571,1700485,580512,119369,60489,1196494,496464,700030,396158
33,608,District - Salem (07),Total,10-14,308080,166549,141531,56970,11458,5955,6559,3316,3243,1384
33,608,District - Salem (07),Total,15-19,301579,164090,137489,53995,10589,5582,11096,5257,5839,13522
33,608,District - Salem (07),Total,20-24,304269,157656,146613,54892,10972,5492,26633,10564,16069,29786
33,608,District - Salem (07),Total,Adolescent (10-19),609659,330639,279020,110965,22047,11537,17655,8573,9082,14906
33,608,District - Salem (07),Total,Youth (15-24),605848,321746,284102,108887,21561,11074,37729,15821,21908,43308
33,608,District - Salem (07),Rural,All Ages,1707934,883274,824660,318693,110233,55806,699173,292739,406434,322439
33,608,District - Salem (07),Rural,10-14,154772,85698,69074,31470,10275,5339,3459,1759,1700,1109
33,608,District - Salem (07),Rural,15-19,150185,84248,65937,29660,9721,5119,6465,2958,3507,11325
33,608,District - Salem (07),Rural,20-24,148901,78919,69982,29673,10226,5128,16143,6132,10011,24990
33,608,District - Salem (07),Rural,Adolescent (10-19),304957,169946,135011,61130,19996,10458,9924,4717,5207,12434
33,608,District - Salem (07),Rural,Youth (15-24),299086,163167,135919,59333,19947,10247,22608,9090,13518,36315
33,608,District - Salem (07),Urban,All Ages,1774122,898297,875825,261819,9136,4683,497321,203725,293596,73719
33,608,District - Salem (07),Urban,10-14,153308,80851,72457,25500,1183,616,3100,1557,1543,275
33,608,District - Salem (07),Urban,15-19,151394,79842,71552,24335,868,463,4631,2299,2332,2197
33,608,District - Salem (07),Urban,20-24,155368,78737,76631,25219,746,364,10490,4432,6058,4796
33,608,District - Salem (07),Urban,Adolescent (10-19),304702,160693,144009,49835,2051,1079,7731,3856,3875,2472
33,608,District - Salem (07),Urban,Youth (15-24),306762,158579,148183,49554,1614,827,15121,6731,8390,6993
33,609,District - Namakkal (08),Total,All Ages,1726601,869280,857321,345392,57059,29383,550470,215968,334502,228614
33,609,District - Namakkal (08),Total,10-14,140651,75427,65224,31102,5811,3088,2742,1321,1421,681
33,609,District - Namakkal (08),Total,15-19,166288,89242,77046,30556,5324,2862,3672,1639,2033,5728
33,609,District - Namakkal (08),Total,20-24,142437,70328,72109,28977,5092,2516,8524,3034,5490,13317
33,609,District - Namakkal (08),Total,Adolescent (10-19),306939,164669,142270,61658,11135,5950,6414,2960,3454,6409
33,609,District - Namakkal (08),Total,Youth (15-24),308725,159570,149155,59533,10416,5378,12196,4673,7523,19045
33,609,District - Namakkal (08),Rural,All Ages,1030476,520684,509792,244098,55326,28491,358683,140609,218074,187204
33,609,District - Namakkal (08),Rural,10-14,84335,45930,38405,21876,5464,2881,1796,867,929,610
33,609,District - Namakkal (08),Rural,15-19,105818,58237,47581,21413,4978,2696,2360,1012,1348,4840
33,609,District - Namakkal (08),Rural,20-24,85412,41953,43459,20015,4961,2464,5410,1839,3571,11233
33,609,District - Namakkal (08),Rural,Adolescent (10-19),190153,104167,85986,43289,10442,5577,4156,1879,2277,5450
33,609,District - Namakkal (08),Rural,Youth (15-24),191230,100190,91040,41428,9939,5160,7770,2851,4919,16073
33,609,District - Namakkal (08),Urban,All Ages,696125,348596,347529,101294,1733,892,191787,75359,116428,41410
33,609,District - Namakkal (08),Urban,10-14,56316,29497,26819,9226,347,207,946,454,492,71
33,609,District - Namakkal (08),Urban,15-19,60470,31005,29465,9143,346,166,1312,627,685,888
33,609,District - Namakkal (08),Urban,20-24,57025,28375,28650,8962,131,52,3114,1195,1919,2084
33,609,District - Namakkal (08),Urban,Adolescent (10-19),116786,60502,56284,18369,693,373,2258,1081,1177,959
33,609,District - Namakkal (08),Urban,Youth (15-24),117495,59380,58115,18105,477,218,4426,1822,2604,2972
33,610,District - Erode (09),Total,All Ages,2251744,1129868,1121876,369483,21880,11024,759082,301568,457514,331414
33,610,District - Erode (09),Total,10-14,173177,89812,83365,31962,2105,1094,3725,1680,2045,1179
33,610,District - Erode (09),Total,15-19,174035,92235,81800,29107,1911,1017,5134,2179,2955,8794
33,610,District - Erode (09),Total,20-24,178901,88437,90464,31739,1970,947,12477,4221,8256,19896
33,610,District - Erode (09),Total,Adolescent (10-19),347212,182047,165165,61069,4016,2111,8859,3859,5000,9973
33,610,District - Erode (09),Total,Youth (15-24),352936,180672,172264,60846,3881,1964,17611,6400,11211,28690
33,610,District - Erode (09),Rural,All Ages,1093768,552393,541375,215316,20025,10068,438722,176419,262303,240649
33,610,District - Erode (09),Rural,10-14,84407,44002,40405,18491,1962,1010,2280,990,1290,954
33,610,District - Erode (09),Rural,15-19,84963,46463,38500,16470,1755,929,3431,1403,2028,6669
33,610,District - Erode (09),Rural,20-24,86612,43831,42781,18310,1781,847,8322,2797,5525,15049
33,610,District - Erode (09),Rural,Adolescent (10-19),169370,90465,78905,34961,3717,1939,5711,2393,3318,7623
33,610,District - Erode (09),Rural,Youth (15-24),171575,90294,81281,34780,3536,1776,11753,4200,7553,21718
33,610,District - Erode (09),Urban,All Ages,1157976,577475,580501,154167,1855,956,320360,125149,195211,90765
33,610,District - Erode (09),Urban,10-14,88770,45810,42960,13471,143,84,1445,690,755,225
33,610,District - Erode (09),Urban,15-19,89072,45772,43300,12637,156,88,1703,776,927,2125
33,610,District - Erode (09),Urban,20-24,92289,44606,47683,13429,189,100,4155,1424,2731,4847
33,610,District - Erode (09),Urban,Adolescent (10-19),177842,91582,86260,26108,299,172,3148,1466,1682,2350
33,610,District - Erode (09),Urban,Youth (15-24),181361,90378,90983,26066,345,188,5858,2200,3658,6972
33,611,District - The Nilgiris (10),Total,All Ages,735394,360143,375251,235878,32813,16091,165747,60696,105051,71738
33,611,District - The Nilgiris (10),Total,10-14,65413,32873,32540,22384,3422,1710,1061,482,579,193
33,611,District - The Nilgiris (10),Total,15-19,61415,31311,30104,20912,2889,1432,1166,453,713,1791
33,611,District - The Nilgiris (10),Total,20-24,62158,31109,31049,20387,3108,1463,2222,723,1499,5019
33,611,District - The Nilgiris (10),Total,Adolescent (10-19),126828,64184,62644,43296,6311,3142,2227,935,1292,1984
33,611,District - The Nilgiris (10),Total,Youth (15-24),123573,62420,61153,41299,5997,2895,3388,1176,2212,6810
33,611,District - The Nilgiris (10),Rural,All Ages,299739,145909,153830,86753,22752,11167,77784,27446,50338,45982
33,611,District - The Nilgiris (10),Rural,10-14,25959,13025,12934,8261,2411,1222,514,235,279,151
33,611,District - The Nilgiris (10),Rural,15-19,23961,12232,11729,7652,2009,1000,585,233,352,1245
33,611,District - The Nilgiris (10),Rural,20-24,24495,12118,12377,7411,2144,1034,1146,374,772,3317
33,611,District - The Nilgiris (10),Rural,Adolescent (10-19),49920,25257,24663,15913,4420,2222,1099,468,631,1396
33,611,District - The Nilgiris (10),Rural,Youth (15-24),48456,24350,24106,15063,4153,2034,1731,607,1124,4562
33,611,District - The Nilgiris (10),Urban,All Ages,435655,214234,221421,149125,10061,4924,87963,33250,54713,25756
33,611,District - The Nilgiris (10),Urban,10-14,39454,19848,19606,14123,1011,488,547,247,300,42
33,611,District - The Nilgiris (10),Urban,15-19,37454,19079,18375,13260,880,432,581,220,361,546
33,611,District - The Nilgiris (10),Urban,20-24,37663,18991,18672,12976,964,429,1076,349,727,1702
33,611,District - The Nilgiris (10),Urban,Adolescent (10-19),76908,38927,37981,27383,1891,920,1128,467,661,588
33,611,District - The Nilgiris (10),Urban,Youth (15-24),75117,38070,37047,26236,1844,861,1657,569,1088,2248
33,612,District - Dindigul (11),Total,All Ages,2159775,1080938,1078837,452376,8064,4095,677941,264758,413183,388725
33,612,District - Dindigul (11),Total,10-14,188024,97325,90699,42295,947,495,3806,1849,1957,2135
33,612,District - Dindigul (11),Total,15-19,182413,93640,88773,40355,738,400,4740,1954,2786,15589
33,612,District - Dindigul (11),Total,20-24,183483,90175,93308,42462,705,338,10861,3336,7525,32859
33,612,District - Dindigul (11),Total,Adolescent (10-19),370437,190965,179472,82650,1685,895,8546,3803,4743,17724
33,612,District - Dindigul (11),Total,Youth (15-24),365896,183815,182081,82817,1443,738,15601,5290,10311,48448
33,612,District - Dindigul (11),Rural,All Ages,1351735,678605,673130,310601,4521,2294,481464,186869,294595,330708
33,612,District - Dindigul (11),Rural,10-14,117697,61059,56638,28510,485,254,2666,1304,1362,1961
33,612,District - Dindigul (11),Rural,15-19,114318,59059,55259,27272,395,209,3444,1391,2053,13816
33,612,District - Dindigul (11),Rural,20-24,115778,57519,58259,28963,384,173,8098,2365,5733,28601
33,612,District - Dindigul (11),Rural,Adolescent (10-19),232015,120118,111897,55782,880,463,6110,2695,3415,15777
33,612,District - Dindigul (11),Rural,Youth (15-24),230096,116578,113518,56235,779,382,11542,3756,7786,42417
33,612,District - Dindigul (11),Urban,All Ages,808040,402333,405707,141775,3543,1801,196477,77889,118588,58017
33,612,District - Dindigul (11),Urban,10-14,70327,36266,34061,13785,462,241,1140,545,595,174
33,612,District - Dindigul (11),Urban,15-19,68095,34581,33514,13083,343,191,1296,563,733,1773
33,612,District - Dindigul (11),Urban,20-24,67705,32656,35049,13499,321,165,2763,971,1792,4258
33,612,District - Dindigul (11),Urban,Adolescent (10-19),138422,70847,67575,26868,805,432,2436,1108,1328,1947
33,612,District - Dindigul (11),Urban,Youth (15-24),135800,67237,68563,26582,664,356,4059,1534,2525,6031
33,613,District - Karur (12),Total,All Ages,1064493,528184,536309,221385,575,297,337449,126458,210991,182639
33,613,District - Karur (12),Total,10-14,88664,46318,42346,19935,51,26,1526,670,856,651
33,613,District - Karur (12),Total,15-19,83873,43552,40321,18018,52,27,1984,759,1225,5696
33,613,District - Karur (12),Total,20-24,85577,41990,43587,18656,43,21,4922,1516,3406,12773
33,613,District - Karur (12),Total,Adolescent (10-19),172537,89870,82667,37953,103,53,3510,1429,2081,6347
33,613,District - Karur (12),Total,Youth (15-24),169450,85542,83908,36674,95,48,6906,2275,4631,18469
33,613,District - Karur (12),Rural,All Ages,629976,312628,317348,152799,191,101,235842,88197,147645,156261
33,613,District - Karur (12),Rural,10-14,53414,28078,25336,13808,19,9,1092,471,621,593
33,613,District - Karur (12),Rural,15-19,50006,26288,23718,12374,16,9,1526,562,964,5072
33,613,District - Karur (12),Rural,20-24,50293,25137,25156,12821,20,11,3932,1197,2735,11179
33,613,District - Karur (12),Rural,Adolescent (10-19),103420,54366,49054,26182,35,18,2618,1033,1585,5665
33,613,District - Karur (12),Rural,Youth (15-24),100299,51425,48874,25195,36,20,5458,1759,3699,16251
33,613,District - Karur (12),Urban,All Ages,434517,215556,218961,68586,384,196,101607,38261,63346,26378
33,613,District - Karur (12),Urban,10-14,35250,18240,17010,6127,32,17,434,199,235,58
33,613,District - Karur (12),Urban,15-19,33867,17264,16603,5644,36,18,458,197,261,624
33,613,District - Karur (12),Urban,20-24,35284,16853,18431,5835,23,10,990,319,671,1594
33,613,District - Karur (12),Urban,Adolescent (10-19),69117,35504,33613,11771,68,35,892,396,496,682
33,613,District - Karur (12),Urban,Youth (15-24),69151,34117,35034,11479,59,28,1448,516,932,2218
33,614,District - Tiruchirappalli (13),Total,All Ages,2722290,1352284,1370006,466561,18198,9414,683309,264519,418790,319720
33,614,District - Tiruchirappalli (13),Total,10-14,232986,119847,113139,43863,1964,1015,3753,1832,1921,1121
33,614,District - Tiruchirappalli (13),Total,15-19,235528,120019,115509,43130,2012,1058,3757,1601,2156,11011
33,614,District - Tiruchirappalli (13),Total,20-24,236377,117106,119271,43668,1760,920,8158,2596,5562,24001
33,614,District - Tiruchirappalli (13),Total,Adolescent (10-19),468514,239866,228648,86993,3976,2073,7510,3433,4077,12132
33,614,District - Tiruchirappalli (13),Total,Youth (15-24),471905,237125,234780,86798,3772,1978,11915,4197,7718,35012
33,614,District - Tiruchirappalli (13),Rural,All Ages,1384257,688552,695705,287702,13784,7171,434015,164319,269696,285888
33,614,District - Tiruchirappalli (13),Rural,10-14,124625,64605,60020,27328,1548,809,1893,897,996,1052
33,614,District - Tiruchirappalli (13),Rural,15-19,120746,62828,57918,25812,1484,782,2245,907,1338,10097
33,614,District - Tiruchirappalli (13),Rural,20-24,116571,58248,58323,25656,1257,663,5371,1575,3796,21944
33,614,District - Tiruchirappalli (13),Rural,Adolescent (10-19),245371,127433,117938,53140,3032,1591,4138,1804,2334,11149
33,614,District - Tiruchirappalli (13),Rural,Youth (15-24),237317,121076,116241,51468,2741,1445,7616,2482,5134,32041
33,614,District - Tiruchirappalli (13),Urban,All Ages,1338033,663732,674301,178859,4414,2243,249294,100200,149094,33832
33,614,District - Tiruchirappalli (13),Urban,10-14,108361,55242,53119,16535,416,206,1860,935,925,69
33,614,District - Tiruchirappalli (13),Urban,15-19,114782,57191,57591,17318,528,276,1512,694,818,914
33,614,District - Tiruchirappalli (13),Urban,20-24,119806,58858,60948,18012,503,257,2787,1021,1766,2057
33,614,District - Tiruchirappalli (13),Urban,Adolescent (10-19),223143,112433,110710,33853,944,482,3372,1629,1743,983
33,614,District - Tiruchirappalli (13),Urban,Youth (15-24),234588,116049,118539,35330,1031,533,4299,1715,2584,2971
33,615,District - Perambalur (14),Total,All Ages,565223,282157,283066,175289,2584,1292,189400,74146,115254,91135
33,615,District - Perambalur (14),Total,10-14,52829,27807,25022,17513,312,167,1155,578,577,523
33,615,District - Perambalur (14),Total,15-19,53147,28198,24949,16159,261,128,1238,511,727,3778
33,615,District - Perambalur (14),Total,20-24,48089,23080,25009,15205,220,101,2646,784,1862,8125
33,615,District - Perambalur (14),Total,Adolescent (10-19),105976,56005,49971,33672,573,295,2393,1089,1304,4301
33,615,District - Perambalur (14),Total,Youth (15-24),101236,51278,49958,31364,481,229,3884,1295,2589,11903
33,615,District - Perambalur (14),Rural,All Ages,468060,233926,234134,150504,2156,1086,166344,64820,101524,81524
33,615,District - Perambalur (14),Rural,10-14,44067,23349,20718,15154,255,137,975,494,481,504
33,615,District - Perambalur (14),Rural,15-19,44836,24007,20829,13989,214,108,1118,449,669,3527
33,615,District - Perambalur (14),Rural,20-24,39794,19162,20632,13116,180,84,2421,703,1718,7426
33,615,District - Perambalur (14),Rural,Adolescent (10-19),88903,47356,41547,29143,469,245,2093,943,1150,4031
33,615,District - Perambalur (14),Rural,Youth (15-24),84630,43169,41461,27105,394,192,3539,1152,2387,10953
33,615,District - Perambalur (14),Urban,All Ages,97163,48231,48932,24785,428,206,23056,9326,13730,9611
33,615,District - Perambalur (14),Urban,10-14,8762,4458,4304,2359,57,30,180,84,96,19
33,615,District - Perambalur (14),Urban,15-19,8311,4191,4120,2170,47,20,120,62,58,251
33,615,District - Perambalur (14),Urban,20-24,8295,3918,4377,2089,40,17,225,81,144,699
33,615,District - Perambalur (14),Urban,Adolescent (10-19),17073,8649,8424,4529,104,50,300,146,154,270
33,615,District - Perambalur (14),Urban,Youth (15-24),16606,8109,8497,4259,87,37,345,143,202,950
33,616,District - Ariyalur (15),Total,All Ages,754894,374703,380191,176230,10722,5274,274290,105121,169169,106252
33,616,District - Ariyalur (15),Total,10-14,68924,35488,33436,18701,1184,612,1777,875,902,517
33,616,District - Ariyalur (15),Total,15-19,65215,33465,31750,16348,959,471,1973,777,1196,4293
33,616,District - Ariyalur (15),Total,20-24,61482,30236,31246,14893,815,376,4194,1210,2984,8985
33,616,District - Ariyalur (15),Total,Adolescent (10-19),134139,68953,65186,35049,2143,1083,3750,1652,2098,4810
33,616,District - Ariyalur (15),Total,Youth (15-24),126697,63701,62996,31241,1774,847,6167,1987,4180,13278
33,616,District - Ariyalur (15),Rural,All Ages,671100,333253,337847,163770,9946,4897,251687,96182,155505,102649
33,616,District - Ariyalur (15),Rural,10-14,61231,31578,29653,17393,1101,571,1579,768,811,511
33,616,District - Ariyalur (15),Rural,15-19,58079,29936,28143,15213,888,435,1804,714,1090,4197
33,616,District - Ariyalur (15),Rural,20-24,54492,26823,27669,13783,771,359,3867,1084,2783,8725
33,616,District - Ariyalur (15),Rural,Adolescent (10-19),119310,61514,57796,32606,1989,1006,3383,1482,1901,4708
33,616,District - Ariyalur (15),Rural,Youth (15-24),112571,56759,55812,28996,1659,794,5671,1798,3873,12922
33,616,District - Ariyalur (15),Urban,All Ages,83794,41450,42344,12460,776,377,22603,8939,13664,3603
33,616,District - Ariyalur (15),Urban,10-14,7693,3910,3783,1308,83,41,198,107,91,6
33,616,District - Ariyalur (15),Urban,15-19,7136,3529,3607,1135,71,36,169,63,106,96
33,616,District - Ariyalur (15),Urban,20-24,6990,3413,3577,1110,44,17,327,126,201,260
33,616,District - Ariyalur (15),Urban,Adolescent (10-19),14829,7439,7390,2443,154,77,367,170,197,102
33,616,District - Ariyalur (15),Urban,Youth (15-24),14126,6942,7184,2245,115,53,496,189,307,356
33,617,District - Cuddalore (16),Total,All Ages,2605914,1311697,1294217,763944,15702,7943,790633,311375,479258,325599
33,617,District - Cuddalore (16),Total,10-14,235807,120776,115031,80014,1779,912,5573,2568,3005,1561
33,617,District - Cuddalore (16),Total,15-19,239392,122347,117045,76792,1437,781,6120,2353,3767,12564
33,617,District - Cuddalore (16),Total,20-24,236176,116581,119595,71640,1312,634,13400,3850,9550,28232
33,617,District - Cuddalore (16),Total,Adolescent (10-19),475199,243123,232076,156806,3216,1693,11693,4921,6772,14125
33,617,District - Cuddalore (16),Total,Youth (15-24),475568,238928,236640,148432,2749,1415,19520,6203,13317,40796
33,617,District - Cuddalore (16),Rural,All Ages,1720725,868861,851864,609922,9923,4974,594680,233978,360702,293788
33,617,District - Cuddalore (16),Rural,10-14,158234,81141,77093,63814,1119,561,4011,1843,2168,1454
33,617,District - Cuddalore (16),Rural,15-19,158528,81270,77258,60741,869,466,4623,1754,2869,11501
33,617,District - Cuddalore (16),Rural,20-24,154796,76772,78024,55582,797,396,10494,2866,7628,25856
33,617,District - Cuddalore (16),Rural,Adolescent (10-19),316762,162411,154351,124555,1988,1027,8634,3597,5037,12955
33,617,District - Cuddalore (16),Rural,Youth (15-24),313324,158042,155282,116323,1666,862,15117,4620,10497,37357
33,617,District - Cuddalore (16),Urban,All Ages,885189,442836,442353,154022,5779,2969,195953,77397,118556,31811
33,617,District - Cuddalore (16),Urban,10-14,77573,39635,37938,16200,660,351,1562,725,837,107
33,617,District - Cuddalore (16),Urban,15-19,80864,41077,39787,16051,568,315,1497,599,898,1063
33,617,District - Cuddalore (16),Urban,20-24,81380,39809,41571,16058,515,238,2906,984,1922,2376
33,617,District - Cuddalore (16),Urban,Adolescent (10-19),158437,80712,77725,32251,1228,666,3059,1324,1735,1170
33,617,District - Cuddalore (16),Urban,Youth (15-24),162244,80886,81358,32109,1083,553,4403,1583,2820,3439
33,618,District - Nagapattinam (17),Total,All Ages,1616450,798127,818323,509767,3756,1847,403442,157211,246231,216353
33,618,District - Nagapattinam (17),Total,10-14,146847,73895,72952,54223,430,217,2596,1284,1312,635
33,618,District - Nagapattinam (17),Total,15-19,150388,75955,74433,53438,353,179,2501,1146,1355,7420
33,618,District - Nagapattinam (17),Total,20-24,144723,70426,74297,48649,319,141,4194,1590,2604,16785
33,618,District - Nagapattinam (17),Total,Adolescent (10-19),297235,149850,147385,107661,783,396,5097,2430,2667,8055
33,618,District - Nagapattinam (17),Total,Youth (15-24),295111,146381,148730,102087,672,320,6695,2736,3959,24205
33,618,District - Nagapattinam (17),Rural,All Ages,1251826,619369,632457,459236,2210,1090,330040,128099,201941,205530
33,618,District - Nagapattinam (17),Rural,10-14,114064,57764,56300,48314,272,132,2057,1027,1030,603
33,618,District - Nagapattinam (17),Rural,15-19,117638,59650,57988,47853,202,98,1997,900,1097,7069
33,618,District - Nagapattinam (17),Rural,20-24,113381,55330,58051,43871,159,70,3371,1285,2086,15979
33,618,District - Nagapattinam (17),Rural,Adolescent (10-19),231702,117414,114288,96167,474,230,4054,1927,2127,7672
33,618,District - Nagapattinam (17),Rural,Youth (15-24),231019,114980,116039,91724,361,168,5368,2185,3183,23048
33,618,District - Nagapattinam (17),Urban,All Ages,364624,178758,185866,50531,1546,757,73402,29112,44290,10823
33,618,District - Nagapattinam (17),Urban,10-14,32783,16131,16652,5909,158,85,539,257,282,32
33,618,District - Nagapattinam (17),Urban,15-19,32750,16305,16445,5585,151,81,504,246,258,351
33,618,District - Nagapattinam (17),Urban,20-24,31342,15096,16246,4778,160,71,823,305,518,806
33,618,District - Nagapattinam (17),Urban,Adolescent (10-19),65533,32436,33097,11494,309,166,1043,503,540,383
33,618,District - Nagapattinam (17),Urban,Youth (15-24),64092,31401,32691,10363,311,152,1327,551,776,1157
33,619,District - Thiruvarur (18),Total,All Ages,1264277,626693,637584,430927,3034,1466,317806,123608,194198,200126
33,619,District - Thiruvarur (18),Total,10-14,110601,56079,54522,44095,340,155,3505,1723,1782,853
33,619,District - Thiruvarur (18),Total,15-19,114032,57306,56726,44361,269,131,2098,907,1191,6951
33,619,District - Thiruvarur (18),Total,20-24,111843,54600,57243,41549,292,126,3372,1209,2163,15678
33,619,District - Thiruvarur (18),Total,Adolescent (10-19),224633,113385,111248,88456,609,286,5603,2630,2973,7804
33,619,District - Thiruvarur (18),Total,Youth (15-24),225875,111906,113969,85910,561,257,5470,2116,3354,22629
33,619,District - Thiruvarur (18),Rural,All Ages,1006482,499954,506528,388740,939,461,268595,103679,164916,189268
33,619,District - Thiruvarur (18),Rural,10-14,88681,45030,43651,39892,101,51,2889,1400,1489,829
33,619,District - Thiruvarur (18),Rural,15-19,92307,46491,45816,39990,78,39,1716,746,970,6657
33,619,District - Thiruvarur (18),Rural,20-24,89869,44054,45815,37253,83,34,2786,953,1833,14881
33,619,District - Thiruvarur (18),Rural,Adolescent (10-19),180988,91521,89467,79882,179,90,4605,2146,2459,7486
33,619,District - Thiruvarur (18),Rural,Youth (15-24),182176,90545,91631,77243,161,73,4502,1699,2803,21538
33,619,District - Thiruvarur (18),Urban,All Ages,257795,126739,131056,42187,2095,1005,49211,19929,29282,10858
33,619,District - Thiruvarur (18),Urban,10-14,21920,11049,10871,4203,239,104,616,323,293,24
33,619,District - Thiruvarur (18),Urban,15-19,21725,10815,10910,4371,191,92,382,161,221,294
33,619,District - Thiruvarur (18),Urban,20-24,21974,10546,11428,4296,209,92,586,256,330,797
33,619,District - Thiruvarur (18),Urban,Adolescent (10-19),43645,21864,21781,8574,430,196,998,484,514,318
33,619,District - Thiruvarur (18),Urban,Youth (15-24),43699,21361,22338,8667,400,184,968,417,551,1091
33,620,District - Thanjavur (19),Total,All Ages,2405890,1182416,1223474,455062,3561,1739,614892,238152,376740,327673
33,620,District - Thanjavur (19),Total,10-14,211614,107954,103660,47225,399,210,3841,1851,1990,1135
33,620,District - Thanjavur (19),Total,15-19,215061,109179,105882,46384,352,164,3870,1738,2132,11581
33,620,District - Thanjavur (19),Total,20-24,207211,100942,106269,44077,274,126,6892,2461,4431,24675
33,620,District - Thanjavur (19),Total,Adolescent (10-19),426675,217133,209542,93609,751,374,7711,3589,4122,12716
33,620,District - Thanjavur (19),Total,Youth (15-24),422272,210121,212151,90461,626,290,10762,4199,6563,36256
33,620,District - Thanjavur (19),Rural,All Ages,1554531,765177,789354,371394,1340,665,449545,171999,277546,298107
33,620,District - Thanjavur (19),Rural,10-14,139746,71375,68371,38442,149,74,2579,1244,1335,1076
33,620,District - Thanjavur (19),Rural,15-19,140531,72291,68240,37306,129,60,2685,1208,1477,10709
33,620,District - Thanjavur (19),Rural,20-24,135029,66549,68480,35633,94,47,5143,1790,3353,22530
33,620,District - Thanjavur (19),Rural,Adolescent (10-19),280277,143666,136611,75748,278,134,5264,2452,2812,11785
33,620,District - Thanjavur (19),Rural,Youth (15-24),275560,138840,136720,72939,223,107,7828,2998,4830,33239
33,620,District - Thanjavur (19),Urban,All Ages,851359,417239,434120,83668,2221,1074,165347,66153,99194,29566
33,620,District - Thanjavur (19),Urban,10-14,71868,36579,35289,8783,250,136,1262,607,655,59
33,620,District - Thanjavur (19),Urban,15-19,74530,36888,37642,9078,223,104,1185,530,655,872
33,620,District - Thanjavur (19),Urban,20-24,72182,34393,37789,8444,180,79,1749,671,1078,2145
33,620,District - Thanjavur (19),Urban,Adolescent (10-19),146398,73467,72931,17861,473,240,2447,1137,1310,931
33,620,District - Thanjavur (19),Urban,Youth (15-24),146712,71281,75431,17522,403,183,2934,1201,1733,3017
33,621,District - Pudukkottai (20),Total,All Ages,1618345,803188,815157,284804,1283,647,507800,194412,313388,234344
33,621,District - Pudukkottai (20),Total,10-14,148042,76358,71684,27713,139,73,2301,1131,1170,1090
33,621,District - Pudukkottai (20),Total,15-19,143662,73331,70331,26516,112,55,2596,988,1608,10671
33,621,District - Pudukkottai (20),Total,20-24,135603,65659,69944,25490,112,48,5737,1684,4053,21136
33,621,District - Pudukkottai (20),Total,Adolescent (10-19),291704,149689,142015,54229,251,128,4897,2119,2778,11761
33,621,District - Pudukkottai (20),Total,Youth (15-24),279265,138990,140275,52006,224,103,8333,2672,5661,31807
33,621,District - Pudukkottai (20),Rural,All Ages,1301991,645505,656486,246531,835,416,442308,168447,273861,226981
33,621,District - Pudukkottai (20),Rural,10-14,120303,61968,58335,23999,94,47,1950,957,993,1076
33,621,District - Pudukkottai (20),Rural,15-19,116068,59200,56868,22650,72,36,2240,857,1383,10407
33,621,District - Pudukkottai (20),Rural,20-24,108661,52871,55790,21797,64,26,5067,1454,3613,20580
33,621,District - Pudukkottai (20),Rural,Adolescent (10-19),236371,121168,115203,46649,166,83,4190,1814,2376,11483
33,621,District - Pudukkottai (20),Rural,Youth (15-24),224729,112071,112658,44447,136,62,7307,2311,4996,30987
33,621,District - Pudukkottai (20),Urban,All Ages,316354,157683,158671,38273,448,231,65492,25965,39527,7363
33,621,District - Pudukkottai (20),Urban,10-14,27739,14390,13349,3714,45,26,351,174,177,14
33,621,District - Pudukkottai (20),Urban,15-19,27594,14131,13463,3866,40,19,356,131,225,264
33,621,District - Pudukkottai (20),Urban,20-24,26942,12788,14154,3693,48,22,670,230,440,556
33,621,District - Pudukkottai (20),Urban,Adolescent (10-19),55333,28521,26812,7580,85,45,707,305,402,278
33,621,District - Pudukkottai (20),Urban,Youth (15-24),54536,26919,27617,7559,88,41,1026,361,665,820
33,622,District - Sivaganga (21),Total,All Ages,1339101,668672,670429,227746,790,394,379357,142368,236989,122166
33,622,District - Sivaganga (21),Total,10-14,116999,60084,56915,21639,81,44,2087,996,1091,366
33,622,District - Sivaganga (21),Total,15-19,115327,59511,55816,20973,60,28,1968,783,1185,3972
33,622,District - Sivaganga (21),Total,20-24,112910,55914,56996,20493,71,28,4018,1171,2847,9763
33,622,District - Sivaganga (21),Total,Adolescent (10-19),232326,119595,112731,42612,141,72,4055,1779,2276,4338
33,622,District - Sivaganga (21),Total,Youth (15-24),228237,115425,112812,41466,131,56,5986,1954,4032,13735
33,622,District - Sivaganga (21),Rural,All Ages,926256,462210,464046,184829,491,236,297211,109303,187908,117677
33,622,District - Sivaganga (21),Rural,10-14,80708,41402,39306,17399,50,27,1405,648,757,354
33,622,District - Sivaganga (21),Rural,15-19,80740,41823,38917,16703,39,17,1416,541,875,3883
33,622,District - Sivaganga (21),Rural,20-24,79084,39511,39573,16551,52,21,3235,898,2337,9496
33,622,District - Sivaganga (21),Rural,Adolescent (10-19),161448,83225,78223,34102,89,44,2821,1189,1632,4237
33,622,District - Sivaganga (21),Rural,Youth (15-24),159824,81334,78490,33254,91,38,4651,1439,3212,13379
33,622,District - Sivaganga (21),Urban,All Ages,412845,206462,206383,42917,299,158,82146,33065,49081,4489
33,622,District - Sivaganga (21),Urban,10-14,36291,18682,17609,4240,31,17,682,348,334,12
33,622,District - Sivaganga (21),Urban,15-19,34587,17688,16899,4270,21,11,552,242,310,89
33,622,District - Sivaganga (21),Urban,20-24,33826,16403,17423,3942,19,7,783,273,510,267
33,622,District - Sivaganga (21),Urban,Adolescent (10-19),70878,36370,34508,8510,52,28,1234,590,644,101
33,622,District - Sivaganga (21),Urban,Youth (15-24),68413,34091,34322,8212,40,18,1335,515,820,356
33,623,District - Madurai (22),Total,All Ages,3038252,1526475,1511777,408976,11096,5622,764822,302665,462157,287731
33,623,District - Madurai (22),Total,10-14,263409,137531,125878,39964,1118,568,4524,2208,2316,1274
33,623,District - Madurai (22),Total,15-19,260006,134073,125933,39410,1015,532,5457,2352,3105,10870
33,623,District - Madurai (22),Total,20-24,263146,129177,133969,39671,1055,525,12021,3800,8221,23576
33,623,District - Madurai (22),Total,Adolescent (10-19),523415,271604,251811,79374,2133,1100,9981,4560,5421,12144
33,623,District - Madurai (22),Total,Youth (15-24),523152,263250,259902,79081,2070,1057,17478,6152,11326,34446
33,623,District - Madurai (22),Rural,All Ages,1191451,601247,590204,257852,4866,2487,403361,154788,248573,258473
33,623,District - Madurai (22),Rural,10-14,109527,57670,51857,25684,420,222,2052,1004,1048,1178
33,623,District - Madurai (22),Rural,15-19,107486,57410,50076,24785,387,217,2934,1243,1691,9918
33,623,District - Madurai (22),Rural,20-24,106044,54109,51935,24701,451,229,7229,2128,5101,21613
33,623,District - Madurai (22),Rural,Adolescent (10-19),217013,115080,101933,50469,807,439,4986,2247,2739,11096
33,623,District - Madurai (22),Rural,Youth (15-24),213530,111519,102011,49486,838,446,10163,3371,6792,31531
33,623,District - Madurai (22),Urban,All Ages,1846801,925228,921573,151124,6230,3135,361461,147877,213584,29258
33,623,District - Madurai (22),Urban,10-14,153882,79861,74021,14280,698,346,2472,1204,1268,96
33,623,District - Madurai (22),Urban,15-19,152520,76663,75857,14625,628,315,2523,1109,1414,952
33,623,District - Madurai (22),Urban,20-24,157102,75068,82034,14970,604,296,4792,1672,3120,1963
33,623,District - Madurai (22),Urban,Adolescent (10-19),306402,156524,149878,28905,1326,661,4995,2313,2682,1048
33,623,District - Madurai (22),Urban,Youth (15-24),309622,151731,157891,29595,1232,611,7315,2781,4534,2915
33,624,District - Theni (23),Total,All Ages,1245899,625683,620216,258200,1835,954,375819,146280,229539,275585
33,624,District - Theni (23),Total,10-14,112665,59463,53202,26112,226,115,2311,1122,1189,1049
33,624,District - Theni (23),Total,15-19,110035,58280,51755,25220,173,95,2544,1188,1356,8588
33,624,District - Theni (23),Total,20-24,106324,53064,53260,24819,156,71,5689,1863,3826,20130
33,624,District - Theni (23),Total,Adolescent (10-19),222700,117743,104957,51332,399,210,4855,2310,2545,9637
33,624,District - Theni (23),Total,Youth (15-24),216359,111344,105015,50039,329,166,8233,3051,5182,28718
33,624,District - Theni (23),Rural,All Ages,575418,290880,284538,143589,1377,714,198768,77310,121458,167906
33,624,District - Theni (23),Rural,10-14,52522,28254,24268,14263,157,74,1157,551,606,729
33,624,District - Theni (23),Rural,15-19,51914,28051,23863,13938,136,71,1352,630,722,5647
33,624,District - Theni (23),Rural,20-24,49702,25255,24447,13688,132,60,3312,1071,2241,13076
33,624,District - Theni (23),Rural,Adolescent (10-19),104436,56305,48131,28201,293,145,2509,1181,1328,6376
33,624,District - Theni (23),Rural,Youth (15-24),101616,53306,48310,27626,268,131,4664,1701,2963,18723
33,624,District - Theni (23),Urban,All Ages,670481,334803,335678,114611,458,240,177051,68970,108081,107679
33,624,District - Theni (23),Urban,10-14,60143,31209,28934,11849,69,41,1154,571,583,320
33,624,District - Theni (23),Urban,15-19,58121,30229,27892,11282,37,24,1192,558,634,2941
33,624,District - Theni (23),Urban,20-24,56622,27809,28813,11131,24,11,2377,792,1585,7054
33,624,District - Theni (23),Urban,Adolescent (10-19),118264,61438,56826,23131,106,65,2346,1129,1217,3261
33,624,District - Theni (23),Urban,Youth (15-24),114743,58038,56705,22413,61,35,3569,1350,2219,9995
33,625,District - Virudhunagar (24),Total,All Ages,1942288,967709,974579,399831,2294,1182,543500,207334,336166,168174
33,625,District - Virudhunagar (24),Total,10-14,172194,88038,84156,39420,213,117,3140,1559,1581,680
33,625,District - Virudhunagar (24),Total,15-19,173671,89296,84375,38258,206,114,3849,1628,2221,4808
33,625,District - Virudhunagar (24),Total,20-24,171700,84472,87228,38670,218,105,9088,2750,6338,11089
33,625,District - Virudhunagar (24),Total,Adolescent (10-19),345865,177334,168531,77678,419,231,6989,3187,3802,5488
33,625,District - Virudhunagar (24),Total,Youth (15-24),345371,173768,171603,76928,424,219,12937,4378,8559,15897
33,625,District - Virudhunagar (24),Rural,All Ages,962062,480360,481702,263206,1078,541,308843,116624,192219,139360
33,625,District - Virudhunagar (24),Rural,10-14,86857,44633,42224,25850,95,51,1659,799,860,551
33,625,District - Virudhunagar (24),Rural,15-19,90051,46734,43317,24847,94,50,2324,959,1365,4012
33,625,District - Virudhunagar (24),Rural,20-24,87899,43573,44326,25439,97,44,5725,1657,4068,9411
33,625,District - Virudhunagar (24),Rural,Adolescent (10-19),176908,91367,85541,50697,189,101,3983,1758,2225,4563
33,625,District - Virudhunagar (24),Rural,Youth (15-24),177950,90307,87643,50286,191,94,8049,2616,5433,13423
33,625,District - Virudhunagar (24),Urban,All Ages,980226,487349,492877,136625,1216,641,234657,90710,143947,28814
33,625,District - Virudhunagar (24),Urban,10-14,85337,43405,41932,13570,118,66,1481,760,721,129
33,625,District - Virudhunagar (24),Urban,15-19,83620,42562,41058,13411,112,64,1525,669,856,796
33,625,District - Virudhunagar (24),Urban,20-24,83801,40899,42902,13231,121,61,3363,1093,2270,1678
33,625,District - Virudhunagar (24),Urban,Adolescent (10-19),168957,85967,82990,26981,230,130,3006,1429,1577,925
33,625,District - Virudhunagar (24),Urban,Youth (15-24),167421,83461,83960,26642,233,125,4888,1762,3126,2474
33,626,District - Ramanathapuram (25),Total,All Ages,1353445,682658,670787,249008,1105,559,374499,146171,228328,103592
33,626,District - Ramanathapuram (25),Total,10-14,123990,63918,60072,24838,140,68,2028,935,1093,404
33,626,District - Ramanathapuram (25),Total,15-19,126052,64767,61285,24625,105,63,2131,944,1187,3794
33,626,District - Ramanathapuram (25),Total,20-24,123511,61357,62154,23312,111,48,4309,1454,2855,9058
33,626,District - Ramanathapuram (25),Total,Adolescent (10-19),250042,128685,121357,49463,245,131,4159,1879,2280,4198
33,626,District - Ramanathapuram (25),Total,Youth (15-24),249563,126124,123439,47937,216,111,6440,2398,4042,12852
33,626,District - Ramanathapuram (25),Rural,All Ages,942746,474508,468238,205328,501,244,290827,111730,179097,98339
33,626,District - Ramanathapuram (25),Rural,10-14,85995,44337,41658,19866,68,31,1454,656,798,385
33,626,District - Ramanathapuram (25),Rural,15-19,87831,45269,42562,19694,46,25,1593,706,887,3619
33,626,District - Ramanathapuram (25),Rural,20-24,85969,43142,42827,19143,43,24,3369,1106,2263,8691
33,626,District - Ramanathapuram (25),Rural,Adolescent (10-19),173826,89606,84220,39560,114,56,3047,1362,1685,4004
33,626,District - Ramanathapuram (25),Rural,Youth (15-24),173800,88411,85389,38837,89,49,4962,1812,3150,12310
33,626,District - Ramanathapuram (25),Urban,All Ages,410699,208150,202549,43680,604,315,83672,34441,49231,5253
33,626,District - Ramanathapuram (25),Urban,10-14,37995,19581,18414,4972,72,37,574,279,295,19
33,626,District - Ramanathapuram (25),Urban,15-19,38221,19498,18723,4931,59,38,538,238,300,175
33,626,District - Ramanathapuram (25),Urban,20-24,37542,18215,19327,4169,68,24,940,348,592,367
33,626,District - Ramanathapuram (25),Urban,Adolescent (10-19),76216,39079,37137,9903,131,75,1112,517,595,194
33,626,District - Ramanathapuram (25),Urban,Youth (15-24),75763,37713,38050,9100,127,62,1478,586,892,542
33,627,District - Thoothukkudi (26),Total,All Ages,1750176,865021,885155,347895,4911,2466,400479,161915,238564,161418
33,627,District - Thoothukkudi (26),Total,10-14,156521,80031,76490,33128,533,273,2357,1174,1183,521
33,627,District - Thoothukkudi (26),Total,15-19,151939,76599,75340,31875,496,267,2249,1011,1238,5045
33,627,District - Thoothukkudi (26),Total,20-24,151330,74026,77304,33340,462,210,4480,1567,2913,12171
33,627,District - Thoothukkudi (26),Total,Adolescent (10-19),308460,156630,151830,65003,1029,540,4606,2185,2421,5566
33,627,District - Thoothukkudi (26),Total,Youth (15-24),303269,150625,152644,65215,958,477,6729,2578,4151,17216
33,627,District - Thoothukkudi (26),Rural,All Ages,873374,430361,443013,230895,1264,620,230688,90622,140066,145494
33,627,District - Thoothukkudi (26),Rural,10-14,78720,40229,38491,21641,148,77,1240,604,636,474
33,627,District - Thoothukkudi (26),Rural,15-19,77774,39452,38322,21080,114,64,1266,569,697,4600
33,627,District - Thoothukkudi (26),Rural,20-24,77206,38559,38647,22155,120,56,2749,944,1805,11071
33,627,District - Thoothukkudi (26),Rural,Adolescent (10-19),156494,79681,76813,42721,262,141,2506,1173,1333,5074
33,627,District - Thoothukkudi (26),Rural,Youth (15-24),154980,78011,76969,43235,234,120,4015,1513,2502,15671
33,627,District - Thoothukkudi (26),Urban,All Ages,876802,434660,442142,117000,3647,1846,169791,71293,98498,15924
33,627,District - Thoothukkudi (26),Urban,10-14,77801,39802,37999,11487,385,196,1117,570,547,47
33,627,District - Thoothukkudi (26),Urban,15-19,74165,37147,37018,10795,382,203,983,442,541,445
33,627,District - Thoothukkudi (26),Urban,20-24,74124,35467,38657,11185,342,154,1731,623,1108,1100
33,627,District - Thoothukkudi (26),Urban,Adolescent (10-19),151966,76949,75017,22282,767,399,2100,1012,1088,492
33,627,District - Thoothukkudi (26),Urban,Youth (15-24),148289,72614,75675,21980,724,357,2714,1065,1649,1545
33,628,District - Tirunelveli (27),Total,All Ages,3077233,1520912,1556321,569714,10270,5109,803776,310202,493574,321083
33,628,District - Tirunelveli (27),Total,10-14,271801,139133,132668,52694,1013,529,4425,2157,2268,935
33,628,District - Tirunelveli (27),Total,15-19,269329,137028,132301,51349,930,465,4396,1916,2480,10265
33,628,District - Tirunelveli (27),Total,20-24,264635,129792,134843,52477,992,444,9338,3111,6227,24302
33,628,District - Tirunelveli (27),Total,Adolescent (10-19),541130,276161,264969,104043,1943,994,8821,4073,4748,11200
33,628,District - Tirunelveli (27),Total,Youth (15-24),533964,266820,267144,103826,1922,909,13734,5027,8707,34567
33,628,District - Tirunelveli (27),Rural,All Ages,1557004,768728,788276,345247,3822,1923,456892,175749,281143,239121
33,628,District - Tirunelveli (27),Rural,10-14,140247,71859,68388,31708,354,186,2291,1102,1189,754
33,628,District - Tirunelveli (27),Rural,15-19,138564,71069,67495,30894,308,162,2503,1047,1456,8014
33,628,District - Tirunelveli (27),Rural,20-24,136119,67368,68751,31855,383,175,5700,1911,3789,18730
33,628,District - Tirunelveli (27),Rural,Adolescent (10-19),278811,142928,135883,62602,662,348,4794,2149,2645,8768
33,628,District - Tirunelveli (27),Rural,Youth (15-24),274683,138437,136246,62749,691,337,8203,2958,5245,26744
33,628,District - Tirunelveli (27),Urban,All Ages,1520229,752184,768045,224467,6448,3186,346884,134453,212431,81962
33,628,District - Tirunelveli (27),Urban,10-14,131554,67274,64280,20986,659,343,2134,1055,1079,181
33,628,District - Tirunelveli (27),Urban,15-19,130765,65959,64806,20455,622,303,1893,869,1024,2251
33,628,District - Tirunelveli (27),Urban,20-24,128516,62424,66092,20622,609,269,3638,1200,2438,5572
33,628,District - Tirunelveli (27),Urban,Adolescent (10-19),262319,133233,129086,41441,1281,646,4027,1924,2103,2432
33,628,District - Tirunelveli (27),Urban,Youth (15-24),259281,128383,130898,41077,1231,572,5531,2069,3462,7823
33,629,District - Kanniyakumari (28),Total,All Ages,1870374,926345,944029,74249,7282,3554,321636,145804,175832,51350
33,629,District - Kanniyakumari (28),Total,10-14,152553,77303,75250,6234,655,332,1961,921,1040,94
33,629,District - Kanniyakumari (28),Total,15-19,147984,75230,72754,6185,626,316,1339,618,721,798
33,629,District - Kanniyakumari (28),Total,20-24,155169,75556,79613,6592,620,270,1813,779,1034,2425
33,629,District - Kanniyakumari (28),Total,Adolescent (10-19),300537,152533,148004,12419,1281,648,3300,1539,1761,892
33,629,District - Kanniyakumari (28),Total,Youth (15-24),303153,150786,152367,12777,1246,586,3152,1397,1755,3223
33,629,District - Kanniyakumari (28),Rural,All Ages,330572,164938,165634,18972,3741,1808,61192,28506,32686,13102
33,629,District - Kanniyakumari (28),Rural,10-14,27293,13865,13428,1547,320,156,317,145,172,26
33,629,District - Kanniyakumari (28),Rural,15-19,26604,13628,12976,1610,316,165,249,117,132,240
33,629,District - Kanniyakumari (28),Rural,20-24,28045,13818,14227,1777,320,136,356,156,200,597
33,629,District - Kanniyakumari (28),Rural,Adolescent (10-19),53897,27493,26404,3157,636,321,566,262,304,266
33,629,District - Kanniyakumari (28),Rural,Youth (15-24),54649,27446,27203,3387,636,301,605,273,332,837
33,629,District - Kanniyakumari (28),Urban,All Ages,1539802,761407,778395,55277,3541,1746,260444,117298,143146,38248
33,629,District - Kanniyakumari (28),Urban,10-14,125260,63438,61822,4687,335,176,1644,776,868,68
33,629,District - Kanniyakumari (28),Urban,15-19,121380,61602,59778,4575,310,151,1090,501,589,558
33,629,District - Kanniyakumari (28),Urban,20-24,127124,61738,65386,4815,300,134,1457,623,834,1828
33,629,District - Kanniyakumari (28),Urban,Adolescent (10-19),246640,125040,121600,9262,645,327,2734,1277,1457,626
33,629,District - Kanniyakumari (28),Urban,Youth (15-24),248504,123340,125164,9390,610,285,2547,1124,1423,2386
33,630,District - Dharmapuri (29),Total,All Ages,1506843,774303,732540,245392,63044,32130,589134,246704,342430,217062
33,630,District - Dharmapuri (29),Total,10-14,147444,80099,67345,25466,6979,3626,3373,1716,1657,1034
33,630,District - Dharmapuri (29),Total,15-19,140167,78059,62108,23927,5727,3085,4946,2322,2624,8002
33,630,District - Dharmapuri (29),Total,20-24,134973,70001,64972,23467,5357,2652,12395,4359,8036,18984
33,630,District - Dharmapuri (29),Total,Adolescent (10-19),287611,158158,129453,49393,12706,6711,8319,4038,4281,9036
33,630,District - Dharmapuri (29),Total,Youth (15-24),275140,148060,127080,47394,11084,5737,17341,6681,10660,26986
33,630,District - Dharmapuri (29),Rural,All Ages,1245931,643215,602716,207187,60385,30730,518146,217916,300230,204652
33,630,District - Dharmapuri (29),Rural,10-14,123029,67392,55637,21583,6676,3451,2725,1376,1349,986
33,630,District - Dharmapuri (29),Rural,15-19,116819,65870,50949,20340,5442,2937,4294,1996,2298,7580
33,630,District - Dharmapuri (29),Rural,20-24,112109,58954,53155,19897,5159,2558,11171,3892,7279,18033
33,630,District - Dharmapuri (29),Rural,Adolescent (10-19),239848,133262,106586,41923,12118,6388,7019,3372,3647,8566
33,630,District - Dharmapuri (29),Rural,Youth (15-24),228928,124824,104104,40237,10601,5495,15465,5888,9577,25613
33,630,District - Dharmapuri (29),Urban,All Ages,260912,131088,129824,38205,2659,1400,70988,28788,42200,12410
33,630,District - Dharmapuri (29),Urban,10-14,24415,12707,11708,3883,303,175,648,340,308,48
33,630,District - Dharmapuri (29),Urban,15-19,23348,12189,11159,3587,285,148,652,326,326,422
33,630,District - Dharmapuri (29),Urban,20-24,22864,11047,11817,3570,198,94,1224,467,757,951
33,630,District - Dharmapuri (29),Urban,Adolescent (10-19),47763,24896,22867,7470,588,323,1300,666,634,470
33,630,District - Dharmapuri (29),Urban,Youth (15-24),46212,23236,22976,7157,483,242,1876,793,1083,1373
33,631,District - Krishnagiri (30),Total,All Ages,1879809,960232,919577,267386,22388,11419,691851,293170,398681,197369
33,631,District - Krishnagiri (30),Total,10-14,183912,96150,87762,28174,2549,1298,5614,2595,3019,1736
33,631,District - Krishnagiri (30),Total,15-19,179439,95949,83490,28112,1929,1035,8244,3708,4536,11498
33,631,District - Krishnagiri (30),Total,20-24,178359,89753,88606,27228,1794,905,17972,6369,11603,20294
33,631,District - Krishnagiri (30),Total,Adolescent (10-19),363351,192099,171252,56286,4478,2333,13858,6303,7555,13234
33,631,District - Krishnagiri (30),Total,Youth (15-24),357798,185702,172096,55340,3723,1940,26216,10077,16139,31792
33,631,District - Krishnagiri (30),Rural,All Ages,1451446,742444,709002,217822,21041,10720,586187,247726,338461,191241
33,631,District - Krishnagiri (30),Rural,10-14,143830,75489,68341,22953,2394,1217,4656,2115,2541,1704
33,631,District - Krishnagiri (30),Rural,15-19,141556,76536,65020,22895,1823,981,7202,3204,3998,11240
33,631,District - Krishnagiri (30),Rural,20-24,137399,70179,67220,21902,1686,851,15634,5445,10189,19791
33,631,District - Krishnagiri (30),Rural,Adolescent (10-19),285386,152025,133361,45848,4217,2198,11858,5319,6539,12944
33,631,District - Krishnagiri (30),Rural,Youth (15-24),278955,146715,132240,44797,3509,1832,22836,8649,14187,31031
33,631,District - Krishnagiri (30),Urban,All Ages,428363,217788,210575,49564,1347,699,105664,45444,60220,6128
33,631,District - Krishnagiri (30),Urban,10-14,40082,20661,19421,5221,155,81,958,480,478,32
33,631,District - Krishnagiri (30),Urban,15-19,37883,19413,18470,5217,106,54,1042,504,538,258
33,631,District - Krishnagiri (30),Urban,20-24,40960,19574,21386,5326,108,54,2338,924,1414,503
33,631,District - Krishnagiri (30),Urban,Adolescent (10-19),77965,40074,37891,10438,261,135,2000,984,1016,290
33,631,District - Krishnagiri (30),Urban,Youth (15-24),78843,38987,39856,10543,214,108,3380,1428,1952,761
33,632,District - Coimbatore (31),Total,All Ages,3458045,1729297,1728748,535911,28342,14245,822138,334507,487631,201351
33,632,District - Coimbatore (31),Total,10-14,260540,133207,127333,47463,2682,1409,4042,1996,2046,619
33,632,District - Coimbatore (31),Total,15-19,259970,132046,127924,46811,2215,1138,4367,1908,2459,5310
33,632,District - Coimbatore (31),Total,20-24,283417,135379,148038,48912,2539,1190,9668,3399,6269,10685
33,632,District - Coimbatore (31),Total,Adolescent (10-19),520510,265253,255257,94274,4897,2547,8409,3904,4505,5929
33,632,District - Coimbatore (31),Total,Youth (15-24),543387,267425,275962,95723,4754,2328,14035,5307,8728,15995
33,632,District - Coimbatore (31),Rural,All Ages,839105,419032,420073,187055,19622,9815,284140,113314,170826,140412
33,632,District - Coimbatore (31),Rural,10-14,64514,33020,31494,17191,1788,914,1137,551,586,452
33,632,District - Coimbatore (31),Rural,15-19,64679,33635,31044,15969,1567,791,1336,601,735,3867
33,632,District - Coimbatore (31),Rural,20-24,65602,32218,33384,16072,1834,876,3540,1202,2338,7621
33,632,District - Coimbatore (31),Rural,Adolescent (10-19),129193,66655,62538,33160,3355,1705,2473,1152,1321,4319
33,632,District - Coimbatore (31),Rural,Youth (15-24),130281,65853,64428,32041,3401,1667,4876,1803,3073,11488
33,632,District - Coimbatore (31),Urban,All Ages,2618940,1310265,1308675,348856,8720,4430,537998,221193,316805,60939
33,632,District - Coimbatore (31),Urban,10-14,196026,100187,95839,30272,894,495,2905,1445,1460,167
33,632,District - Coimbatore (31),Urban,15-19,195291,98411,96880,30842,648,347,3031,1307,1724,1443
33,632,District - Coimbatore (31),Urban,20-24,217815,103161,114654,32840,705,314,6128,2197,3931,3064
33,632,District - Coimbatore (31),Urban,Adolescent (10-19),391317,198598,192719,61114,1542,842,5936,2752,3184,1610
33,632,District - Coimbatore (31),Urban,Youth (15-24),413106,201572,211534,63682,1353,661,9159,3504,5655,4507
33,633,District - Tiruppur (32),Total,All Ages,2479052,1246159,1232893,395876,5458,2740,718486,286536,431950,216945
33,633,District - Tiruppur (32),Total,10-14,189996,97580,92416,36042,570,306,3330,1572,1758,705
33,633,District - Tiruppur (32),Total,15-19,192942,97452,95490,33522,600,287,4018,1786,2232,5777
33,633,District - Tiruppur (32),Total,20-24,212081,99285,112796,34263,599,249,8987,3038,5949,12017
33,633,District - Tiruppur (32),Total,Adolescent (10-19),382938,195032,187906,69564,1170,593,7348,3358,3990,6482
33,633,District - Tiruppur (32),Total,Youth (15-24),405023,196737,208286,67785,1199,536,13005,4824,8181,17794
33,633,District - Tiruppur (32),Rural,All Ages,957941,479309,478632,237893,2650,1318,346624,135875,210749,175748
33,633,District - Tiruppur (32),Rural,10-14,73058,37826,35232,21700,265,124,1374,644,730,577
33,633,District - Tiruppur (32),Rural,15-19,73472,37812,35660,19489,268,133,1735,805,930,4652
33,633,District - Tiruppur (32),Rural,20-24,72707,35275,37432,19202,300,136,4065,1357,2708,9664
33,633,District - Tiruppur (32),Rural,Adolescent (10-19),146530,75638,70892,41189,533,257,3109,1449,1660,5229
33,633,District - Tiruppur (32),Rural,Youth (15-24),146179,73087,73092,38691,568,269,5800,2162,3638,14316
33,633,District - Tiruppur (32),Urban,All Ages,1521111,766850,754261,157983,2808,1422,371862,150661,221201,41197
33,633,District - Tiruppur (32),Urban,10-14,116938,59754,57184,14342,305,182,1956,928,1028,128
33,633,District - Tiruppur (32),Urban,15-19,119470,59640,59830,14033,332,154,2283,981,1302,1125
33,633,District - Tiruppur (32),Urban,20-24,139374,64010,75364,15061,299,113,4922,1681,3241,2353
33,633,District - Tiruppur (32),Urban,Adolescent (10-19),236408,119394,117014,28375,637,336,4239,1909,2330,1253
33,633,District - Tiruppur (32),Urban,Youth (15-24),258844,123650,135194,29094,631,267,7205,2662,4543,3478
34,0,State - PUDUCHERRY (34),Total,All Ages,1247953,612511,635442,196325,0,0,290644,115133,175511,50607
34,0,State - PUDUCHERRY (34),Total,10-14,105726,53936,51790,19105,0,0,2337,1199,1138,141
34,0,State - PUDUCHERRY (34),Total,15-19,102316,52231,50085,17930,0,0,1740,803,937,937
34,0,State - PUDUCHERRY (34),Total,20-24,108819,51287,57532,18916,0,0,3563,1356,2207,2944
34,0,State - PUDUCHERRY (34),Total,Adolescent (10-19),208042,106167,101875,37035,0,0,4077,2002,2075,1078
34,0,State - PUDUCHERRY (34),Total,Youth (15-24),211135,103518,107617,36846,0,0,5303,2159,3144,3881
34,0,State - PUDUCHERRY (34),Rural,All Ages,395200,194907,200293,110425,0,0,114318,44417,69901,42434
34,0,State - PUDUCHERRY (34),Rural,10-14,35351,17972,17379,10933,0,0,907,434,473,130
34,0,State - PUDUCHERRY (34),Rural,15-19,34019,17394,16625,10296,0,0,600,263,337,756
34,0,State - PUDUCHERRY (34),Rural,20-24,36272,17155,19117,10693,0,0,1286,457,829,2404
34,0,State - PUDUCHERRY (34),Rural,Adolescent (10-19),69370,35366,34004,21229,0,0,1507,697,810,886
34,0,State - PUDUCHERRY (34),Rural,Youth (15-24),70291,34549,35742,20989,0,0,1886,720,1166,3160
34,0,State - PUDUCHERRY (34),Urban,All Ages,852753,417604,435149,85900,0,0,176326,70716,105610,8173
34,0,State - PUDUCHERRY (34),Urban,10-14,70375,35964,34411,8172,0,0,1430,765,665,11
34,0,State - PUDUCHERRY (34),Urban,15-19,68297,34837,33460,7634,0,0,1140,540,600,181
34,0,State - PUDUCHERRY (34),Urban,20-24,72547,34132,38415,8223,0,0,2277,899,1378,540
34,0,State - PUDUCHERRY (34),Urban,Adolescent (10-19),138672,70801,67871,15806,0,0,2570,1305,1265,192
34,0,State - PUDUCHERRY (34),Urban,Youth (15-24),140844,68969,71875,15857,0,0,3417,1439,1978,721
34,634,District - Yanam (01),Total,All Ages,55626,27301,28325,8427,0,0,16352,7382,8970,2956
34,634,District - Yanam (01),Total,10-14,5733,2889,2844,833,0,0,136,68,68,4
34,634,District - Yanam (01),Total,15-19,5528,2765,2763,848,0,0,257,109,148,100
34,634,District - Yanam (01),Total,20-24,5662,2509,3153,903,0,0,588,236,352,275
34,634,District - Yanam (01),Total,Adolescent (10-19),11261,5654,5607,1681,0,0,393,177,216,104
34,634,District - Yanam (01),Total,Youth (15-24),11190,5274,5916,1751,0,0,845,345,500,375
34,634,District - Yanam (01),Rural,All Ages,0,0,0,0,0,0,0,0,0,0
34,634,District - Yanam (01),Rural,10-14,0,0,0,0,0,0,0,0,0,0
34,634,District - Yanam (01),Rural,15-19,0,0,0,0,0,0,0,0,0,0
34,634,District - Yanam (01),Rural,20-24,0,0,0,0,0,0,0,0,0,0
34,634,District - Yanam (01),Rural,Adolescent (10-19),0,0,0,0,0,0,0,0,0,0
34,634,District - Yanam (01),Rural,Youth (15-24),0,0,0,0,0,0,0,0,0,0
34,634,District - Yanam (01),Urban,All Ages,55626,27301,28325,8427,0,0,16352,7382,8970,2956
34,634,District - Yanam (01),Urban,10-14,5733,2889,2844,833,0,0,136,68,68,4
34,634,District - Yanam (01),Urban,15-19,5528,2765,2763,848,0,0,257,109,148,100
34,634,District - Yanam (01),Urban,20-24,5662,2509,3153,903,0,0,588,236,352,275
34,634,District - Yanam (01),Urban,Adolescent (10-19),11261,5654,5607,1681,0,0,393,177,216,104
34,634,District - Yanam (01),Urban,Youth (15-24),11190,5274,5916,1751,0,0,845,345,500,375
34,635,District - Puducherry (02),Total,All Ages,950289,468258,482031,152406,0,0,223640,87312,136328,38854
34,635,District - Puducherry (02),Total,10-14,79015,40443,38572,14757,0,0,1775,898,877,119
34,635,District - Puducherry (02),Total,15-19,76370,38958,37412,13698,0,0,1214,560,654,662
34,635,District - Puducherry (02),Total,20-24,82560,38958,43602,14589,0,0,2522,935,1587,2209
34,635,District - Puducherry (02),Total,Adolescent (10-19),155385,79401,75984,28455,0,0,2989,1458,1531,781
34,635,District - Puducherry (02),Total,Youth (15-24),158930,77916,81014,28287,0,0,3736,1495,2241,2871
34,635,District - Puducherry (02),Rural,All Ages,293080,144769,148311,85624,0,0,89299,34495,54804,35087
34,635,District - Puducherry (02),Rural,10-14,26256,13436,12820,8547,0,0,671,315,356,113
34,635,District - Puducherry (02),Rural,15-19,25152,12881,12271,7975,0,0,468,198,270,622
34,635,District - Puducherry (02),Rural,20-24,27276,12835,14441,8322,0,0,1046,360,686,2032
34,635,District - Puducherry (02),Rural,Adolescent (10-19),51408,26317,25091,16522,0,0,1139,513,626,735
34,635,District - Puducherry (02),Rural,Youth (15-24),52428,25716,26712,16297,0,0,1514,558,956,2654
34,635,District - Puducherry (02),Urban,All Ages,657209,323489,333720,66782,0,0,134341,52817,81524,3767
34,635,District - Puducherry (02),Urban,10-14,52759,27007,25752,6210,0,0,1104,583,521,6
34,635,District - Puducherry (02),Urban,15-19,51218,26077,25141,5723,0,0,746,362,384,40
34,635,District - Puducherry (02),Urban,20-24,55284,26123,29161,6267,0,0,1476,575,901,177
34,635,District - Puducherry (02),Urban,Adolescent (10-19),103977,53084,50893,11933,0,0,1850,945,905,46
34,635,District - Puducherry (02),Urban,Youth (15-24),106502,52200,54302,11990,0,0,2222,937,1285,217
34,636,District - Mahe (03),Total,All Ages,41816,19143,22673,144,0,0,5346,2533,2813,57
34,636,District - Mahe (03),Total,10-14,3525,1823,1702,10,0,0,46,28,18,0
34,636,District - Mahe (03),Total,15-19,3194,1658,1536,7,0,0,16,11,5,2
34,636,District - Mahe (03),Total,20-24,3313,1529,1784,11,0,0,21,11,10,2
34,636,District - Mahe (03),Total,Adolescent (10-19),6719,3481,3238,17,0,0,62,39,23,2
34,636,District - Mahe (03),Total,Youth (15-24),6507,3187,3320,18,0,0,37,22,15,4
34,636,District - Mahe (03),Rural,All Ages,0,0,0,0,0,0,0,0,0,0
34,636,District - Mahe (03),Rural,10-14,0,0,0,0,0,0,0,0,0,0
34,636,District - Mahe (03),Rural,15-19,0,0,0,0,0,0,0,0,0,0
34,636,District - Mahe (03),Rural,20-24,0,0,0,0,0,0,0,0,0,0
34,636,District - Mahe (03),Rural,Adolescent (10-19),0,0,0,0,0,0,0,0,0,0
34,636,District - Mahe (03),Rural,Youth (15-24),0,0,0,0,0,0,0,0,0,0
34,636,District - Mahe (03),Urban,All Ages,41816,19143,22673,144,0,0,5346,2533,2813,57
34,636,District - Mahe (03),Urban,10-14,3525,1823,1702,10,0,0,46,28,18,0
34,636,District - Mahe (03),Urban,15-19,3194,1658,1536,7,0,0,16,11,5,2
34,636,District - Mahe (03),Urban,20-24,3313,1529,1784,11,0,0,21,11,10,2
34,636,District - Mahe (03),Urban,Adolescent (10-19),6719,3481,3238,17,0,0,62,39,23,2
34,636,District - Mahe (03),Urban,Youth (15-24),6507,3187,3320,18,0,0,37,22,15,4
34,637,District - Karaikal (04),Total,All Ages,200222,97809,102413,35348,0,0,45306,17906,27400,8740
34,637,District - Karaikal (04),Total,10-14,17453,8781,8672,3505,0,0,380,205,175,18
34,637,District - Karaikal (04),Total,15-19,17224,8850,8374,3377,0,0,253,123,130,173
34,637,District - Karaikal (04),Total,20-24,17284,8291,8993,3413,0,0,432,174,258,458
34,637,District - Karaikal (04),Total,Adolescent (10-19),34677,17631,17046,6882,0,0,633,328,305,191
34,637,District - Karaikal (04),Total,Youth (15-24),34508,17141,17367,6790,0,0,685,297,388,631
34,637,District - Karaikal (04),Rural,All Ages,102120,50138,51982,24801,0,0,25019,9922,15097,7347
34,637,District - Karaikal (04),Rural,10-14,9095,4536,4559,2386,0,0,236,119,117,17
34,637,District - Karaikal (04),Rural,15-19,8867,4513,4354,2321,0,0,132,65,67,134
34,637,District - Karaikal (04),Rural,20-24,8996,4320,4676,2371,0,0,240,97,143,372
34,637,District - Karaikal (04),Rural,Adolescent (10-19),17962,9049,8913,4707,0,0,368,184,184,151
34,637,District - Karaikal (04),Rural,Youth (15-24),17863,8833,9030,4692,0,0,372,162,210,506
34,637,District - Karaikal (04),Urban,All Ages,98102,47671,50431,10547,0,0,20287,7984,12303,1393
34,637,District - Karaikal (04),Urban,10-14,8358,4245,4113,1119,0,0,144,86,58,1
34,637,District - Karaikal (04),Urban,15-19,8357,4337,4020,1056,0,0,121,58,63,39
34,637,District - Karaikal (04),Urban,20-24,8288,3971,4317,1042,0,0,192,77,115,86
34,637,District - Karaikal (04),Urban,Adolescent (10-19),16715,8582,8133,2175,0,0,265,144,121,40
34,637,District - Karaikal (04),Urban,Youth (15-24),16645,8308,8337,2098,0,0,313,135,178,125
35,0,State - ANDAMAN & NICOBAR ISLANDS (35),Total,All Ages,380581,202871,177710,0,28530,14731,86300,38494,47806,2680
35,0,State - ANDAMAN & NICOBAR ISLANDS (35),Total,10-14,33467,17118,16349,0,2304,1209,724,378,346,26
35,0,State - ANDAMAN & NICOBAR ISLANDS (35),Total,15-19,33026,17266,15760,0,2426,1270,692,344,348,73
35,0,State - ANDAMAN & NICOBAR ISLANDS (35),Total,20-24,37115,19528,17587,0,2593,1319,1650,735,915,231
35,0,State - ANDAMAN & NICOBAR ISLANDS (35),Total,Adolescent (10-19),66493,34384,32109,0,4730,2479,1416,722,694,99
35,0,State - ANDAMAN & NICOBAR ISLANDS (35),Total,Youth (15-24),70141,36794,33347,0,5019,2589,2342,1079,1263,304
35,0,State - ANDAMAN & NICOBAR ISLANDS (35),Rural,All Ages,237093,126287,110806,0,26715,13837,59068,26327,32741,2562
35,0,State - ANDAMAN & NICOBAR ISLANDS (35),Rural,10-14,21226,10731,10495,0,2110,1124,514,262,252,26
35,0,State - ANDAMAN & NICOBAR ISLANDS (35),Rural,15-19,20369,10644,9725,0,2256,1194,460,218,242,70
35,0,State - ANDAMAN & NICOBAR ISLANDS (35),Rural,20-24,22540,11654,10886,0,2328,1203,1127,487,640,221
35,0,State - ANDAMAN & NICOBAR ISLANDS (35),Rural,Adolescent (10-19),41595,21375,20220,0,4366,2318,974,480,494,96
35,0,State - ANDAMAN & NICOBAR ISLANDS (35),Rural,Youth (15-24),42909,22298,20611,0,4584,2397,1587,705,882,291
35,0,State - ANDAMAN & NICOBAR ISLANDS (35),Urban,All Ages,143488,76584,66904,0,1815,894,27232,12167,15065,118
35,0,State - ANDAMAN & NICOBAR ISLANDS (35),Urban,10-14,12241,6387,5854,0,194,85,210,116,94,0
35,0,State - ANDAMAN & NICOBAR ISLANDS (35),Urban,15-19,12657,6622,6035,0,170,76,232,126,106,3
35,0,State - ANDAMAN & NICOBAR ISLANDS (35),Urban,20-24,14575,7874,6701,0,265,116,523,248,275,10
35,0,State - ANDAMAN & NICOBAR ISLANDS (35),Urban,Adolescent (10-19),24898,13009,11889,0,364,161,442,242,200,3
35,0,State - ANDAMAN & NICOBAR ISLANDS (35),Urban,Youth (15-24),27232,14496,12736,0,435,192,755,374,381,13
35,638,District - Nicobars (01),Total,All Ages,36842,20727,16115,0,23681,12198,11510,5330,6180,103
35,638,District - Nicobars (01),Total,10-14,2684,1369,1315,0,1860,985,142,76,66,0
35,638,District - Nicobars (01),Total,15-19,2773,1536,1237,0,1956,1033,102,52,50,3
35,638,District - Nicobars (01),Total,20-24,3544,2143,1401,0,2043,1055,310,179,131,7
35,638,District - Nicobars (01),Total,Adolescent (10-19),5457,2905,2552,0,3816,2018,244,128,116,3
35,638,District - Nicobars (01),Total,Youth (15-24),6317,3679,2638,0,3999,2088,412,231,181,10
35,638,District - Nicobars (01),Rural,All Ages,36842,20727,16115,0,23681,12198,11510,5330,6180,103
35,638,District - Nicobars (01),Rural,10-14,2684,1369,1315,0,1860,985,142,76,66,0
35,638,District - Nicobars (01),Rural,15-19,2773,1536,1237,0,1956,1033,102,52,50,3
35,638,District - Nicobars (01),Rural,20-24,3544,2143,1401,0,2043,1055,310,179,131,7
35,638,District - Nicobars (01),Rural,Adolescent (10-19),5457,2905,2552,0,3816,2018,244,128,116,3
35,638,District - Nicobars (01),Rural,Youth (15-24),6317,3679,2638,0,3999,2088,412,231,181,10
35,638,District - Nicobars (01),Urban,All Ages,0,0,0,0,0,0,0,0,0,0
35,638,District - Nicobars (01),Urban,10-14,0,0,0,0,0,0,0,0,0,0
35,638,District - Nicobars (01),Urban,15-19,0,0,0,0,0,0,0,0,0,0
35,638,District - Nicobars (01),Urban,20-24,0,0,0,0,0,0,0,0,0,0
35,638,District - Nicobars (01),Urban,Adolescent (10-19),0,0,0,0,0,0,0,0,0,0
35,638,District - Nicobars (01),Urban,Youth (15-24),0,0,0,0,0,0,0,0,0,0
35,639,District - North  & Middle Andaman (02),Total,All Ages,105597,54861,50736,0,758,415,26914,11675,15239,873
35,639,District - North  & Middle Andaman (02),Total,10-14,10495,5325,5170,0,75,38,242,122,120,5
35,639,District - North  & Middle Andaman (02),Total,15-19,9374,4845,4529,0,92,44,206,84,122,19
35,639,District - North  & Middle Andaman (02),Total,20-24,9386,4504,4882,0,67,29,484,149,335,74
35,639,District - North  & Middle Andaman (02),Total,Adolescent (10-19),19869,10170,9699,0,167,82,448,206,242,24
35,639,District - North  & Middle Andaman (02),Total,Youth (15-24),18760,9349,9411,0,159,73,690,233,457,93
35,639,District - North  & Middle Andaman (02),Rural,All Ages,102856,53457,49399,0,748,410,26235,11401,14834,870
35,639,District - North  & Middle Andaman (02),Rural,10-14,10302,5217,5085,0,74,37,240,122,118,5
35,639,District - North  & Middle Andaman (02),Rural,15-19,9133,4717,4416,0,91,43,201,80,121,19
35,639,District - North  & Middle Andaman (02),Rural,20-24,9083,4357,4726,0,64,28,471,144,327,74
35,639,District - North  & Middle Andaman (02),Rural,Adolescent (10-19),19435,9934,9501,0,165,80,441,202,239,24
35,639,District - North  & Middle Andaman (02),Rural,Youth (15-24),18216,9074,9142,0,155,71,672,224,448,93
35,639,District - North  & Middle Andaman (02),Urban,All Ages,2741,1404,1337,0,10,5,679,274,405,3
35,639,District - North  & Middle Andaman (02),Urban,10-14,193,108,85,0,1,1,2,0,2,0
35,639,District - North  & Middle Andaman (02),Urban,15-19,241,128,113,0,1,1,5,4,1,0
35,639,District - North  & Middle Andaman (02),Urban,20-24,303,147,156,0,3,1,13,5,8,0
35,639,District - North  & Middle Andaman (02),Urban,Adolescent (10-19),434,236,198,0,2,2,7,4,3,0
35,639,District - North  & Middle Andaman (02),Urban,Youth (15-24),544,275,269,0,4,2,18,9,9,0
35,640,District - South Andaman (03),Total,All Ages,238142,127283,110859,0,4091,2118,47876,21489,26387,1704
35,640,District - South Andaman (03),Total,10-14,20288,10424,9864,0,369,186,340,180,160,21
35,640,District - South Andaman (03),Total,15-19,20879,10885,9994,0,378,193,384,208,176,51
35,640,District - South Andaman (03),Total,20-24,24185,12881,11304,0,483,235,856,407,449,150
35,640,District - South Andaman (03),Total,Adolescent (10-19),41167,21309,19858,0,747,379,724,388,336,72
35,640,District - South Andaman (03),Total,Youth (15-24),45064,23766,21298,0,861,428,1240,615,625,201
35,640,District - South Andaman (03),Rural,All Ages,97395,52103,45292,0,2286,1229,21323,9596,11727,1589
35,640,District - South Andaman (03),Rural,10-14,8240,4145,4095,0,176,102,132,64,68,21
35,640,District - South Andaman (03),Rural,15-19,8463,4391,4072,0,209,118,157,86,71,48
35,640,District - South Andaman (03),Rural,20-24,9913,5154,4759,0,221,120,346,164,182,140
35,640,District - South Andaman (03),Rural,Adolescent (10-19),16703,8536,8167,0,385,220,289,150,139,69
35,640,District - South Andaman (03),Rural,Youth (15-24),18376,9545,8831,0,430,238,503,250,253,188
35,640,District - South Andaman (03),Urban,All Ages,140747,75180,65567,0,1805,889,26553,11893,14660,115
35,640,District - South Andaman (03),Urban,10-14,12048,6279,5769,0,193,84,208,116,92,0
35,640,District - South Andaman (03),Urban,15-19,12416,6494,5922,0,169,75,227,122,105,3
35,640,District - South Andaman (03),Urban,20-24,14272,7727,6545,0,262,115,510,243,267,10
35,640,District - South Andaman (03),Urban,Adolescent (10-19),24464,12773,11691,0,362,159,435,238,197,3
35,640,District - South Andaman (03),Urban,Youth (15-24),26688,14221,12467,0,431,190,737,365,372,13
